"dota"
{
"DOTA_Accept"	"Accepter"
"DOTA_Cancel"	"Annuller"
"DOTA_Console"	"Konsol"
"DOTA_Create"	"Opret"
"DOTA_Decline"	"Afslå"
"DOTA_Error"	"Fejl"
"DOTA_Join"	"Tilslut"
"DOTA_Leave"	"Forlad"
"DOTA_New"	"Ny"
"DOTA_Ok"	"OK"
"DOTA_Sale"	"Udsalg"
"DOTA_Close"	"Luk"
"DOTA_Continue"	"Fortsæt"
"DOTA_Add"	"Tilføj"
"DOTA_Edit"	"Rediger"
"DOTA_Enable"	"Slå til"
"DOTA_Disable"	"Slå fra"
"DOTA_Refresh"	"Opdater"
"DOTA_Loading"	"Indlæser"
"DOTA_None"	"Ingen"
"DOTA_Customize"	"Tilpas"
"DOTA_AcceptChanges"	"Accepter ændringer"
"dota_team_radiant"	"Radiant"
"dota_team_dire"	"Dire"
"Unknown"	"Ukendt"
"UI_Yes"	"Ja"
"UI_No"	"Nej"
"UI_File_Filter_Any"	"Alle filer (*.*)"
"DOTA_MainMenu_Heroes"	"Helte"
"DOTA_MainMenu_Watch"	"Se på"
"DOTA_MainMenu_Learn"	"Lær"
"DOTA_MainMenu_Mods"	"Tilpassede spil"
"DOTA_TabName_GlobalItems"	"Globale genstande"
"DOTA_TabName_Treasury"	"Skatkammer"
"DOTA_TabName_Armory"	"Arsenal"
"DOTA_ConfirmQuit"	"Bekræft afslutning"
"DOTA_ConfirmQuitDesc"	"Ønsker du virkelig at afslutte Dota 2?"
"DOTA_ConfirmQuitDescUnsafe"	"At forlade et spil, før det er overstået, kan ødelægget spillet for andre spillere. Ønsker du virkelig at afslutte Dota 2?"
"DOTA_InvalidPersonaName"	"[ukendt]"
"DOTA_Friends_WindowTitle"	"VENNER"
"DOTA_FriendsCategory_ReadyToPlay"	"I åbne spil <font color='#63C290'><b></b>({d:friend_count})</font>"
"DOTA_FriendsCategory_PlayingDota"	"I Dota <font color='#ACEBA9'>({d:friend_count})</font>"
"DOTA_FriendsCategory_Online"	"Online <font color='#6a9dcc'>({d:friend_count})</font>"
"DOTA_FriendsCategory_Pending"	"Afventende <font color='#eeee82'>({d:friend_count})</font>"
"DOTA_FriendsCategory_Offline"	"Offline <font color='#676666'>({d:friend_count})</font>"
"DOTA_Friends_Empty"	"Din venneliste er på nuværende tidspunkt tom"
"DOTA_FriendsMenu_Tooltip_NoneReady"	"Venner"
"DOTA_UserName"	"{g:dota_persona:user_account_id}"
"DOTA_UserNamePro"	"{g:dota_persona_pro:user_account_id}"
"DOTA_UserNickname"	"{g:dota_persona_nickname:user_account_id}"
"DOTA_UserRichPresence"	"{s:user_rich_presence}"
"DOTA_ProfileCard_StatTitle_SoloRank"	"Solo-MMR"
"DOTA_ProfileCard_StatTitle_PartyRank"	"Gruppe-MMR"
"DOTA_ProfileCard_StatTitle_Wins"	"Sejre"
"DOTA_ProfileCard_StatTitle_Commends"	"Anbefalinger"
"DOTA_ProfileCard_StatTitle_GamesPlayed"	"Kampe"
"DOTA_ProfileCard_StatTitle_FirstMatchDate"	"Første kamp"
"DOTA_ProfileCard_StatValue_Int"	"{d:stat_value}"
"DOTA_ProfileCard_StatValue_Date"	"{t:s:stat_value}"
"DOTA_ProfileCard_StatValue_String"	"{s:stat_value}"
"DOTA_ProfileCard_SlotTab_Trophies"	"Trofæer"
"DOTA_ProfileCard_SlotTab_Items"	"Arsenal"
"DOTA_ProfileCard_SlotTab_Heroes"	"Helte"
"DOTA_ProfileCard_SlotTab_Emoticons"	"Emotikoner"
"DOTA_ProfileCard_NoTrophies"	"Ingen trofæer er tilgængelige."
"DOTA_ProfileCard_NoItems"	"Ingen genstande er tilgængelige."
"DOTA_ProfileCard_HeroOnly"	"Kun helt"
"DOTA_ProfileCard_HeroShowWins"	"Vis sejre"
"DOTA_ProfileCard_HeroShowWinsAndLosses"	"Vis sejre/nederlag"
"DOTA_ProfileCard_ItemSearchPrefix"	"Søg efter:"
"DOTA_ProfileCard_ItemSearchPlaceholder"	"Genstande efter navn"
"DOTA_ProfileCard_ItemArmoryLink"	"Vis hele arsenal"
"DOTA_HeroTooltip_HeroName"	"{s:hero_name}"
"DOTA_HeroTooltip_HeroRecord"	"{s:hero_wins_string}, {s:hero_losses_string}"
"DOTA_ProfileCard_HeroSearchPlaceholder"	"Søg efter heltenavn"
"DOTA_Wins_Singular"	"1 sejr"
"DOTA_Wins_Plural"	"{d:hero_wins} sejre"
"DOTA_Losses_Singular"	"1 nederlag"
"DOTA_Losses_Plural"	"{d:hero_losses} nederlag"
"DOTA_Profile_TotalGames"	"Spil i alt"
"DOTA_Profile_Solo_MMR"	"Solo-MMR"
"DOTA_Profile_Team_MMR"	"Hold-MMR"
"DOTA_Profile_Party_MMR"	"Gruppe-MMR"
"DOTA_Profile_VictoryCount"	"Sejre"
"DOTA_Profile_ProfilePage"	"Profil"
"DOTA_Profile_TrophyPage"	"Trofæer"
"DOTA_Profile_RecentGamesPage"	"Nylige spil"
"DOTA_Profile_HeroPage"	"Helte"
"DOTA_Profile_PlayStyle"	"Spilstil"
"DOTA_Profile_MostRecent"	"Seneste {s:num_style_games} spil"
"DOTA_Profile_RecentActivity"	"Nylig aktivitet"
"DOTA_Profile_Fighting"	"Kæmpende"
"DOTA_Profile_Fighting_TooltipTitle"	"Kæmpende"
"DOTA_Profile_Fighting_Tooltip"	"Spillere der kæmper i mange kampe mod fjendtlige helte."
"DOTA_Profile_Farming"	"Farmende"
"DOTA_Profile_Farming_TooltipTitle"	"Farmende"
"DOTA_Profile_Farming_Tooltip"	"Spillere der farmer guld af at dræbe enheder."
"DOTA_Profile_Supporting"	"Supportende"
"DOTA_Profile_Supporting_TooltipTitle"	"Supportende"
"DOTA_Profile_Supporting_Tooltip"	"Spillere der støtter deres hold med heling, wards og genstande."
"DOTA_Profile_Pushing"	"Pushende"
"DOTA_Profile_Pushing_TooltipTitle"	"Pushende"
"DOTA_Profile_Pushing_Tooltip"	"Spillere der pusher tårne og hjælper med at skabe pusterum."
"DOTA_Profile_Versatility"	"Alsidighed"
"DOTA_Profile_Versatility_TooltipTitle"	"Alsidighed"
"DOTA_Profile_Versatility_Tooltip"	"Spillere der er alsidige og spiller mange forskellige helte."
"DOTA_Profile_Tooltip_Value"	"{s:CurrentStatValue}"
"DOTA_Profile_Tooltip_Comparison"	"{s:CurrentComparisonValue}"
"DOTA_Profile_StatsCompare"	"Sammenlign med mine statistikker"
"DOTA_Profile_Self"	"Mig"
"DOTA_Profile_GPM"	"Gns. GPM"
"DOTA_Profile_XPM"	"Gns. XPM"
"DOTA_Profile_LH"	"Gns. last hits"
"DOTA_Profile_Rampages"	"Gået amok"
"DOTA_Profile_TripleKills"	"Tredobbelte drab"
"DOTA_Profile_FirstBlood"	"First Blood-drab"
"DOTA_Profile_FirstBled"	"Første blødninger"
"DOTA_Profile_CourierKills"	"Kurérer dræbt"
"DOTA_Profile_Aegises"	"Aegises stjålet"
"DOTA_Profile_CheeseEaten"	"Oste spist"
"DOTA_Profile_CreepStack"	"Camps stablet"
"DOTA_Profile_GPMValue"	"{s:GPM}"
"DOTA_Profile_XPMValue"	"{s:XPM}"
"DOTA_Profile_LHValue"	"{s:LH}"
"DOTA_Profile_RampagesValue"	"{d:Rampages}"
"DOTA_Profile_TripleKillsValue"	"{d:TripleKills}"
"DOTA_Profile_FirstBloodValue"	"{d:FirstBlood}"
"DOTA_Profile_FirstBledValue"	"{d:FirstBled}"
"DOTA_Profile_CourierKillsValue"	"{d:CourierKills}"
"DOTA_Profile_AegisesValue"	"{d:Aegises}"
"DOTA_Profile_CheeseEatenValue"	"{d:CheeseEaten}"
"DOTA_Profile_CreepStackValue"	"{d:CreepStack}"
"DOTA_Profile_GPMLocalValue"	"{s:GPMLocal}"
"DOTA_Profile_XPMLocalValue"	"{s:XPMLocal}"
"DOTA_Profile_LHLocalValue"	"{s:LHLocal}"
"DOTA_Profile_RampagesLocalValue"	"{d:RampagesLocal}"
"DOTA_Profile_TripleKillsLocalValue"	"{d:TripleKillsLocal}"
"DOTA_Profile_FirstBloodLocalValue"	"{d:FirstBloodLocal}"
"DOTA_Profile_FirstBledLocalValue"	"{d:FirstBledLocal}"
"DOTA_Profile_CourierKillsLocalValue"	"{d:CourierKillsLocal}"
"DOTA_Profile_AegisesLocalValue"	"{d:AegisesLocal}"
"DOTA_Profile_CheeseEatenLocalValue"	"{d:CheeseEatenLocal}"
"DOTA_Profile_CreepStackLocalValue"	"{d:CreepStackLocal}"
"DOTA_RecentGames_Title"	"Nylige spil"
"DOTA_RecentGames_TimeStamp"	"Dato/tid"
"DOTA_RecentGames_HeroSelection"	"Helt spillet"
"DOTA_RecentGames_GameResult"	"Resultat"
"DOTA_RecentGames_GameLength"	"Varighed"
"DOTA_RecentGames_Team"	"Hold"
"DOTA_RecentGames_GameType"	"Type"
"DOTA_RecentGames_Items"	"Genstande"
"DOTA_RecentGame_Timestamp_Entry"	"{t:s:timestamp} {t:t:timestamp}"
"DOTA_RecentGame_Duration"	"{t:d:duration}"
"DOTA_RecentGame_Downloading"	"{s:DownloadPercent} downloader"
"DOTA_RecentGame_Watch"	"Se gengivelse"
"DOTA_RecentGame_NoReplay"	"Ingen gengivelse"
"DOTA_RecentGame_Expired"	"Gengivelse udløbet"
"DOTA_RecentGame_Finding"	"Finder..."
"DOTA_RecentGame_Download"	"Download kamp"
"DOTA_RecentGame_Pending"	"Gengivelse afventer"
"DOTA_RecentGame_Unavailable"	"Gengivelse utilgængelig"
"DOTA_RecentGame_MatchID"	"Kamp-ID: #{s:match_id}"
"DOTA_No_Team_Name"	"--"
"DOTA_TrophyCount"	"{d:trophy_count} trofæ"
"DOTA_TrophiesCount"	"{d:trophy_count} trofæer"
"DOTA_TrophyCount_Number"	"{d:trophy_count}"
"DOTA_TrophyCount_NoNum"	"Trofæ"
"DOTA_TrophiesCount_NoNum"	"Trofæer"
"DOTA_Trophies_ViewAll"	"Alle"
"DOTA_TrophyName"	"{s:trophy_name}"
"DOTA_TrophyCategory"	"{s:trophy_category}"
"DOTA_TrophyDescription"	"{s:trophy_description}"
"DOTA_TrophyXP"	"{d:trophy_xp}<span class=\"TrophyPointTextSmall\">TP</span>"
"DOTA_NextTrophy"	"Næste pris"
"DOTA_NewPlayerQuestion_Title"	"VELKOMMEN TIL DOTA 2"
"DOTA_PlayerOriginQuestion_Question"	"Del venligst dit kendskab til Dota 2 og lignende spil for at forbedre din spiloplevelse:"
"DOTA_PlayerOriginQuestion_BeginnerButton"	"Jeg er en begynder."
"DOTA_PlayerOriginQuestion_RTSButton"	"Jeg har spillet RTS-spil."
"DOTA_PlayerOriginQuestion_MOBAButton"	"Jeg har spillet et spil lignende Dota 2."
"DOTA_PlayerOriginQuestion_Dota2Button"	"Jeg har spillet Dota 2."
"DOTA_PlayerOriginQuestion_MOBAExplanation"	"Vælg det spil du føler dig mest tilpas med:"
"DOTA_OtherGames_LOL"	"League of Legends"
"DOTA_OtherGames_DOTA"	"DotA 1"
"DOTA_OtherGames_HON"	"Heroes of Newerth"
"DOTA_OtherGames_Smite"	"Smite"
"DOTA_OtherGames_Other"	"Et andet spil"
"DOTA_PlayerOriginQuestion_ConfirmationButton"	"LAD OS SPILLE"
"DOTA_Tutorial_SkipButton"	"Spring introduktion over"
"DOTA_ConfirmSkip"	"Spring Dota 2-introduktionen over?"
"DOTA_ConfirmSkipDesc"	"Er du sikker på, at du vil springe introduktionerne til Dota 2 over?"
"DOTA_Tutorial_Start_Quest"	"START OPGAVE"
"DOTA_Tutorial_Quest0_Title"	"OPGAVE 1"
"DOTA_Tutorial_Quest0_TitleDesc"	"AFSTANDSHELT"
"DOTA_Tutorial_Quest0DetailsDesc"	"Denne opgave vil tage ca.\n 10 minutter at gennemføre."
"DOTA_Tutorial_QuestDetailsLearn"	"Du vil lære:"
"DOTA_Tutorial_Quest0DetailsLesson"	"Heltebevægelse\nHelte-level\nEvnebrug\nGenstande\nGrundlæggende kamp\nLast Hitting"
"DOTA_Tutorial_Quest1_Title"	"OPGAVE 2"
"DOTA_Tutorial_Quest1_TitleDesc"	"LANE-KAMP"
"DOTA_Tutorial_Quest1DetailsDesc"	"Denne opgave vil tage ca.\n 10 minutter at gennemføre."
"DOTA_Tutorial_Quest1DetailsLesson"	"Afstandskamp \n AOE-evner \n Minikortet \n Tårne \n Kurérer og lager \n Teleportering"
"DOTA_Tutorial_Quest2_Title"	"OPGAVE 3"
"DOTA_Tutorial_Quest2_TitleDesc"	"LANE-KAMP"
"DOTA_Tutorial_Quest2DetailsDesc"	"Denne opgave vil tage ca.\n 10 - 15 minutter at gennemføre."
"DOTA_Tutorial_Quest2DetailsLesson"	"Lane-kamp \n At forsvare og angribe tårne \n Startgenstande"
"DOTA_Challenges_Title"	"Lær"
"DOTA_ChallengeGroup_0_Title"	"Mekanikker"
"DOTA_ChallengeGroup_1_Title"	"Vejledte bot-kampe"
"DOTA_ChallengeGroup_1_Desc"	"Start her!"
"DOTA_ChallengeGroup_2_Title"	"Bot-kampe"
"DOTA_ChallengeGroup_More"	"Mere på vej"
"DOTA_ChallengeGroup_Locked"	"Låst"
"DOTA_LearnMechanics_Title"	"Mekanikker"
"DOTA_Mechanics_0_Title"	"Mekanikker 1"
"DOTA_Mechanics_0_Desc"	"Heltebevægelse\nHelte-level\nEvnebrug\nGenstande\nGrundlæggende kamp\nLast Hits"
"DOTA_Mechanics_1_Title"	"Mekanikker 2"
"DOTA_Mechanics_1_Desc"	"Afstandskamp\nEvner med områdepåvirkelse (AoE)\nMinikortet\nTårne\nKurérer og lageret\nTeleportation Scrolls"
"DOTA_LearnGuidedBotMatches_Title"	"Vejledte bot-kampe"
"DOTA_GuidedBotMatches_0_Title"	"Luna"
"DOTA_GuidedBotMatches_0_Desc"	"Angreb med kort rækkevidde\nHøj angrebsskade\nHurtig bevægelse\nNogenlunde skrøbelig\nBruger egenskaben: Agilitet"
"DOTA_GuidedBotMatches_1_Title"	"Sven"
"DOTA_GuidedBotMatches_1_Desc"	"Nærkampsangreb\nBurst-angrebsskade\nStærk holdbarhed\nSårbar over for hæmning\nBruger egenskaben: Styrke"
"DOTA_GuidedBotMatches_2_Title"	"Lina"
"DOTA_GuidedBotMatches_2_Desc"	"Langt afstandsangreb\nBurst-evneskade\nKorte nedkølinger\nMeget skrøbelig\nBruger egenskaben: Intelligens"
"DOTA_LearnBotMatches_Title"	"Bot-kampe"
"DOTA_BotMatches_0_Title"	"Lette bots"
"DOTA_BotMatches_0_Desc"	"Lær en ny helt."
"DOTA_BotMatches_1_Title"	"Medium bots"
"DOTA_BotMatches_1_Desc"	"Bliv komfortabel."
"DOTA_BotMatches_2_Title"	"Svære bots"
"DOTA_BotMatches_2_Desc"	"Udfordr dig selv."
"DOTA_BotMatches_3_Title"	"Vanvittige bots"
"DOTA_BotMatches_3_Desc"	"Skad dig selv."
"FileOpenDialog_Open"	"Åbn"
"FileOpenDialog_Save"	"Gem"
"FileOpenDialog_Select"	"Vælg"
"FileOpenDialog_FileType_Folder"	"Mappe"
"DOTA_FindMatch"	"Find kamp"
"DOTA_FindingMatch"	"Finder kamp ( {s:find_match_time} )"
"DOTA_FindMatchTime"	"{s:find_match_time}"
"DOTA_Searching"	"Søger"
"DOTA_StartSoloBotMatch"	"Start bot-kamp"
"DOTA_Create_Lobby"	"Opret lobby"
"DOTA_Join_Lobby"	"Tilslut lobby"
"DOTA_LobbyStartGame"	"Start spil"
"DOTA_ReturnToLobby"	"Tilbage til lobby"
"DOTA_FindMatchStatus"	"{s:searching_matchtype} / {s:searching_gamemodes} / {s:searching_region}"
"DOTA_FindGameModesMany"	"Spiltilstande: "
"DOTA_FindRegionsMany"	"Regioner: "
"DOTA_GameMode_AllPick"	"All Pick"
"DOTA_GameMode_SingleDraft"	"Single Draft"
"DOTA_GameMode_CaptainsMode"	"Captains Mode"
"DOTA_GameMode_RandomDraft"	"Random Draft"
"DOTA_GameMode_AbilityDraft"	"Ability Draft"
"DOTA_GameMode_LeastPlayed"	"Least Played"
"DOTA_GameMode_AllRandom"	"All Random"
"DOTA_GameMode_LimitedHeroes"	"Limited Heroes"
"DOTA_GameMode_CaptainsDraft"	"Captains Draft"
"DOTA_GameMode_AllRandomDeathMatch"	"All Random Death Match"
"DOTA_ImmediatePurchase_Success_Title"	"Succes"
"DOTA_ImmediatePurchase_Success_Text"	"Køb gennemført! Dine genstande vil være i dit arsenal om kort tid."
"DOTA_ImmediatePurchase_Cancelled_Title"	"Annulleret"
"DOTA_ImmediatePurchase_UnbundleFailure"	"Kunne ikke udpakke dit bundt. Prøv venligst igen senere."
"DOTA_ImmediatePurchase_LateCancel"	"Køb blev tidligere annulleret. Du er ikke blevet opkrævet."
"DOTA_ConfirmPurchaseTitle"	"Bekræft køb"
"DOTA_ConfirmPurchaseText"	"Ønsker du at købe denne genstand?"
"DOTA_PurchaseInProgress_Title"	"Køb i gang"
"DOTA_PurchaseInProgress_Text"	"Din købsanmodning bliver behandlet."
"DOTA_UnbundleInProgress_Text"	"Dit bundt bliver udpakket."
"DOTA_ConfirmUnbundleText"	"Du skal udpakke dette bundt for at udstyre genstandene i det. Fortsæt?"
"DOTA_RequestingBalance_Title"	"Anmoder om saldo"
"DOTA_RequestingBalance_Text"	"Anmoder om din Perfect World-kontosaldo..."
"DOTA_PartnerPurchase_Purchase"	"{g:dota_item_price:item_def}"
"DOTA_PartnerPurchase_Balance"	"Saldo: {m:balance}"
"DOTA_PartnerRecharge_Close"	"Vend tilbage til køb"
"RequestBalanceBadAccount"	"Kunne ikke anmode om kontosaldo: Konto ikke fundet."
"StoreCheckout_Error_Title"	"Fejl"
"StoreCheckout_NoItems"	"Din indkøbskurv er tom!"
"StoreCheckout_TooManyItems"	"Du har for mange genstande i din indkøbskurv!"
"StoreCheckout_Loading"	"Går til kassen..."
"StoreCheckout_Unavailable"	"Kassen er ikke tilgængelig i øjeblikket."
"StoreCheckout_Cancelling"	"Annullerer..."
"StoreCheckout_Fail"	"Butikken i spillet er i øjeblikket lukket."
"StoreCheckout_InvalidParam"	"En programmør kludrede i det! En ugyldig parameter blev sendt til spilkoordinatoren. Prøv at købe igen."
"StoreCheckout_InternalError"	"Det ser ud til, at der er opstået en fejl vedrørende initialiseringen eller opdateringen af transaktionen. Vent venligst et minut, og prøv igen, eller kontakt support for hjælp."
"StoreCheckout_ContactSupport"	"Der opstod en fejl med din transaktion. Kontakt venligst support for hjælp."
"StoreCheckout_NotApproved"	"Spilkoordinatoren kunne ikke godkende din transaktion med Steam. Prøv venligst at købe igen senere."
"StoreCheckout_NotLoggedin"	"Du skal være logget på Steam for at gennemføre et køb."
"StoreCheckout_WrongCurrency"	"Denne transaktions valuta svarer ikke til din tegnebogs valuta."
"StoreCheckout_NoAccount"	"Din Steam-konto er i øjeblikket ikke tilgængelig. Prøv venligst dette køb igen senere."
"StoreCheckout_InsufficientFunds"	"Du har ikke penge nok til at gennemføre købet."
"StoreCheckout_TimedOut"	"Denne transaktion er udløbet. Prøv venligst at købe igen."
"StoreCheckout_SteamAccountDisabled"	"Din Steam-konto er deaktiveret og kan ikke foretage et køb."
"StoreCheckout_SteamAccountNoPurchase"	"Steam-tegnebogstransaktioner er blevet deaktiveret på denne konto."
"StoreCheckout_OldPriceSheet"	"Din lokale produktliste er forældet. Anmoder om en ny."
"StoreCheckout_TransactionNotFound"	"Denne transaktions id blev ikke fundet af spilkoordinatoren. Prøv venligst at købe igen."
"StoreCheckout_TransactionCancelled"	"Transaktion annulleret. Du er ikke blevet debiteret."
"StoreCheckout_TransactionCompleted"	"Transaktion gennemført!\\Nyd dit bytte!"
"StoreCheckout_CompleteButUnfinalized"	"Ikke i stand til at bekræfte succes. Hvis succesfuld, vil dine genstande blive leveret på et senere tidspunkt."
"StoreCheckout_NotEnoughRoom"	"Du har ikke plads nok i dit arsenal til at købe så mange genstande."
"StoreCheckout_ContactSupport_Dialog_Title"	"Advarsel"
"StoreCheckout_ContactSupport_Dialog_Btn"	"Kontakt"
"StoreCheckout_LimitedQuantityItemsUnavailable"	"En genstand, du forsøger at købe, er udsolgt eller i øjeblikket utilgængelig."
"StoreCheckout_Nexon_InsufficientFunds"	"Du har ikke penge nok til at gennemføre købet."
"DOTA_AbilityTooltip_Name"	"{s:name}"
"DOTA_AbilityTooltip_Level"	"Level {s:level}"
"DOTA_AbilityTooltip_TargetType"	"PÅVIRKER: {s:targettype}"
"DOTA_AbilityTooltip_CastType"	"EVNE: {s:casttype}"
"DOTA_AbilityTooltip_DamageType"	"SKADETYPE: {s:damagetype}"
"DOTA_AbilityTooltip_SpellImmunityType"	"EVNEIMMUNITET: {s:spellimmunity}"
"DOTA_AbilityTooltip_Description"	"{s:description}"
"DOTA_AbilityTooltip_ScepterDescription"	"{s:scepterdescription}"
"DOTA_AbilityTooltip_ExtraDescription"	"{s:extradescription}"
"DOTA_AbilityTooltip_Attributes"	"{s:attributes}"
"DOTA_AbilityTooltip_Cooldown"	"{s:cooldown}"
"DOTA_AbilityTooltip_ManaCost"	"{s:manacost}"
"DOTA_AbilityTooltip_Lore"	"{s:lore}"
"DOTA_AbilityTooltip_UpgradeLevel"	"Næste opgradering ved helte-level {d:upgradelevel}"
"DOTA_AbilityTooltip_BuildHeader"	"Evneguide"
"DOTA_AbilityTooltip_BuildComment"	"{s:buildcomment}"
"DOTA_PersonaTooltip_Title"	"{g:dota_persona:account_id}"
"DOTA_PersonaTooltip_TitlePro"	"{g:dota_persona_pro:account_id}"
"DOTA_PendingInvites"	"Gruppeinvitationer"
"DOTA_PendingInvitesTooltip_None"	"Ingen afventende invitationer"
"DOTA_PendingInvitesTooltip_1"	"1 afventende invitation"
"DOTA_PendingInvitesTooltip_N"	"{d:pending_invite_count} afventende invitationer"
"DOTA_PendingInvitesTooltip_Leader"	"Klik for at administrer invitationer."
"DOTA_PendingInvitesTooltip_NonLeader"	"Klik for at se invitationer."
"DOTA_PendingInvitesCancelAll"	"Annuller alle invitationer"
"DOTA_PendingInvitesNotPartyLeader"	"Kun gruppelederen kan administrere invitationer"
"DOTA_ChatTab_NotInChannelMessage"	"Ingen kan høre dig."
"DOTA_ChatTab_ToggleGlobal"	"Vis beskeder fra denne kanal i alle faner."
"DOTA_ChatTab_Close"	"Luk denne fane."
"DOTA_ChatTab_Leave"	"Forlad denne kanal."
"DOTA_JoinChatChannel_Title"	"Tilslut kanal"
"DOTA_JoinChatChannel_Description"	"Opret eller tilslut en chatkanal."
"DOTA_JoinChatChannel_AddToCurrentTab"	"Føj til den nuværende fane \"{s:current_tab_name}\""
"DOTA_JoinChatChannel_CreateNewTab"	"Opret en ny fane:"
"DOTA_Chat_ChannelName"	"{s:channel_name}"
"DOTA_Chat_ChannelMemberCount_Singular"	"1 medlem"
"DOTA_Chat_ChannelMemberCount_Plural"	"{d:channel_member_count} medlemmer"
"DOTA_EditChatTab_Title"	"Rediger chatfane"
"DOTA_EditChatTab_Description"	"Vælg hvilke chatbeskeder der skal vises i denne fane."
"DOTA_EditChatTab_AddNewChannel"	"Tilføj en ny kanal..."
"DOTA_EditChatTab_TabName"	"Fanenavn:"
"DOTA_EditChatTab_ChannelToggleDisabled"	"{s:target} skal altid være mindst én fane."
"DOTA_EditChatTab_Target"	"{s:target}"
"DOTA_Chat_TimestampFormat"	"{t:t:timestamp}"
"DOTA_Chat_Autocomplete_Title"	"{s:autocomplete_title}"
"DOTA_Chat_Autocomplete_NoMatches"	"Ingen kampe"
"DOTA_Chat_Autocomplete_WhisperFriends"	"Hvisk til en ven"
"DOTA_Chat_Autocomplete_InviteFriends"	"Inviter en ven"
"DOTA_Chat_Autocomplete_Channels"	"Kanaler"
"DOTA_Chat_Autocomplete_Commands"	"Kommandoer"
"DOTA_Chat_Autocomplete_CommandName"	"/{s:command_name}"
"DOTA_Chat_Autocomplete_CommandDescription"	"{s:command_description}"
"dota_suggest_invite_format"	"Inviter venligst {s:invite_persona} til gruppen."
"dota_suggest_invite_format_leader"	"Inviter venligst {s:invite_persona} til gruppen. ( <a href=\"event:DOTAInviteToParty({s:invite_persona_steamid})\" class=\"InviteButton\">Send Invitation</a> )"
"dota_suggest_invite_format_lobby"	"Inviter venligst {s:invite_persona} til lobbyen."
"dota_suggest_invite_format_lobby_leader"	"Inviter venligst {s:invite_persona} til lobbyen. ( <a href=\"event:DOTAInviteToLobby({s:invite_persona_steamid})\" class=\"InviteButton\">Send Invitation</a> )"
"DOTA_ChatMessage_Default"	"<span class=\"{s:target_class} {s:sender_class} {s:visitor_class}\"><span class=\"ChatTarget\">({s:target})</span> <span class=\"ChatPersona\">{s:event_crest}{s:persona}</span>: {g:dota_filtered_string:message}</span>"
"DOTA_ChatMessage_WhisperTo"	"<span class=\"{s:target_class} {s:sender_class} {s:visitor_class}\">Til <span class=\"ChatPersona\">{s:event_crest}{s:persona}</span>: {g:dota_filtered_string:message}</span>"
"DOTA_ChatMessage_WhisperFrom"	"<span class=\"{s:target_class} {s:sender_class} {s:visitor_class}\">Fra <span class=\"ChatPersona\">{s:event_crest}{s:persona}</span>: {g:dota_filtered_string:message}</span>"
"DOTA_ChatMessage_System"	"<span class=\"{s:target_class} {s:sender_class} {s:visitor_class}\"><span class=\"ChatTarget\">({s:target})</span>: {g:dota_filtered_string:message}</span>"
"DOTA_ChatTarget_Format_Default"	"{s:target}"
"DOTA_ChatTarget_Prompt_Default"	"Til ({s:target}):"
"DOTA_ChatTarget_Format_Whisper"	"{s:persona}"
"DOTA_ChatTarget_Prompt_Whisper"	"Til [{s:persona}]:"
"DOTA_ChatTarget_Party"	"Gruppe"
"DOTA_ChatTarget_Lobby"	"Lobby"
"DOTA_ChatTarget_Team"	"Hold"
"DOTA_ChatTarget_Guild"	"Guild"
"DOTA_ChatTarget_Fantasy"	"Fantasi"
"DOTA_ChatTarget_Console"	"Konsol"
"DOTA_ChatTarget_Whisper"	"Hvisk"
"DOTA_ChatTarget_Invalid"	"Ingen kanal"
"DOTA_ChatTarget_GameAll"	"Alle"
"DOTA_ChatTarget_GameAllies"	"Allierede"
"DOTA_ChatTarget_GameCoaching"	"Coaching"
"DOTA_ChatTarget_GameSpectator"	"Tilskuer"
"DOTA_ChatTargetMenu_Title"	"{s:target}"
"DOTA_ChatTargetMenu_ToggleEnabled"	"{s:toggle_enabled}"
"DOTA_ChatTargetMenu_NotActive"	"(Ikke aktiv)"
"DOTA_Chat_Placeholder"	"Skriv her for at chatte. Brug \"/\" for kommandoer."
"DOTA_Chat_MissedMessages"	"{s:missed_message_count}"
"DOTA_ChatCommand_Party"	"p"
"DOTA_ChatCommand_Party_Name"	"Gruppe"
"DOTA_ChatCommand_Party_Description"	"Chat med din nuværende gruppe."
"DOTA_ChatCommand_Lobby"	"l"
"DOTA_ChatCommand_Lobby_Name"	"Lobby"
"DOTA_ChatCommand_Lobby_Description"	"Chat med din nuværende lobby."
"DOTA_ChatCommand_Channel"	"c"
"DOTA_ChatCommand_Channel_Name"	"Kanal"
"DOTA_ChatCommand_Channel_Description"	"Chat med en angivet chatkanal."
"DOTA_ChatCommand_Whisper"	"w"
"DOTA_ChatCommand_Whisper_Name"	"Hvisk"
"DOTA_ChatCommand_Whisper_Description"	"Hvisk privat med en ven."
"DOTA_ChatCommand_Reply"	"r"
"DOTA_ChatCommand_Reply_Name"	"Svar"
"DOTA_ChatCommand_Reply_Description"	"Svar på en privat besked fra en ven."
"DOTA_ChatCommand_Help"	"?"
"DOTA_ChatCommand_Help_Name"	"Hjælp"
"DOTA_ChatCommand_Help_Description"	"Se hjælp for chatkommandoer."
"DOTA_ChatCommand_InviteToParty"	"partyinvite"
"DOTA_ChatCommand_InviteToParty_Name"	"Inviter til gruppe"
"DOTA_ChatCommand_InviteToParty_Description"	"Inviter en ven til at tilslutte sig din nuværende gruppe."
"DOTA_ChatCommand_LeaveParty"	"leaveparty"
"DOTA_ChatCommand_LeaveParty_Name"	"Forlad gruppe"
"DOTA_ChatCommand_LeaveParty_Description"	"Forlad din nuværende gruppe."
"DOTA_ChatCommand_JoinChannel"	"joinchannel"
"DOTA_ChatCommand_JoinChannel_Name"	"Tilslut kanal"
"DOTA_ChatCommand_JoinChannel_Description"	"Opret eller tilslut en chatkanal."
"DOTA_ChatCommand_LeaveChannel"	"leavechannel"
"DOTA_ChatCommand_LeaveChannel_Name"	"Forlad kanal"
"DOTA_ChatCommand_LeaveChannel_Description"	"Forlad en angivet chatkanal."
"DOTA_ChatCommand_GameAll"	"all"
"DOTA_ChatCommand_GameAll_Name"	"Alle"
"DOTA_ChatCommand_GameAll_Description"	"Chat med alle spillerne i kampen."
"DOTA_ChatCommand_GameAllies"	"allies"
"DOTA_ChatCommand_GameAllies_Name"	"Allierede"
"DOTA_ChatCommand_GameAllies_Description"	"Chat med dine allierede."
"DOTA_ChatCommand_GameCoaching"	"coach"
"DOTA_ChatCommand_GameCoaching_Name"	"Coaching"
"DOTA_ChatCommand_GameCoaching_Description"	"Chat med din studerende eller coach."
"DOTA_ChatCommand_GameSpectator"	"spectator"
"DOTA_ChatCommand_GameSpectator_Name"	"Tilskuer"
"DOTA_ChatCommand_GameSpectator_Description"	"Chat med andre tilskuere."
"DOTA_ChatCommand_Clear"	"clear"
"DOTA_ChatCommand_Clear_Name"	"Ryd"
"DOTA_ChatCommand_Clear_Description"	"Ryd al synlig chat i denne fane."
"DOTA_Chat_UnknownCommandMessage"	"Ukendt chatkommando \"{s:chat_command}\""
"DOTA_ChatHelp_Targets"	"Mål"
"DOTA_ChatHelp_Commands"	"Kommandoer"
"DOTA_ChatHelp_NameFormat"	"{s:command_name}:"
"DOTA_ChatHelp_CommandFormat"	"/{s:command}"
"DOTA_Chat_JoinedParty"	"Tilsluttede en gruppe: {s:party_members}"
"DOTA_Chat_LeftParty"	"Gruppe opløst."
"DOTA_Chat_MemberJoinedParty"	"Spiller tilsluttede gruppen: {s:party_members}"
"DOTA_Chat_MemberLeftParty"	"Spiller forlod gruppen: {s:party_members}"
"DOTA_Chat_InvitedToJoinParty"	"Inviterede: {s:party_members}"
"DOTA_Chat_RequestedToJoinParty"	"Anmodet om at tilslutte: {s:party_members}"
"DOTA_Chat_PartyMemberSeparator"	", "
"DOTA_Feature_Under_Construction_Title"	"Under konstruktion"
"DOTA_Feature_Under_Construction_Text"	"Denne funktion er under konstruktion og er endnu ikke tilgængelig."
"DOTA_PartyJoinRequest_Title"	"Anmodning om gruppetilslutning"
"DOTA_PartyJoinRequest_Description"	"{g:dota_persona:b:inviter} anmodninger om at tilslutte din gruppe."
"DOTA_PartyMergeRequest_Title"	"Sammenflet gruppeanmodninger"
"DOTA_PartyMergeRequest_Description"	"{g:dota_persona:b:inviter} anmoder at deres gruppe tilslutter din."
"DOTA_PartyInvite_Title"	"Gruppeinvitation"
"DOTA_Invite_IOfN"	"{d:received_invite_index} af {d:received_invite_count}"
"DOTA_PartyInvite_Description"	"{g:dota_persona:b:inviter} har inviteret dig til en gruppe."
"DOTA_PartyInvite_LowPriority_Title"	"Lavprioritetsgruppe-invitation"
"DOTA_PartyInvite_LowPriority_Description"	"{g:dota_persona:b:inviter} har inviteret dig til en lavprioritetsgruppe"
"DOTA_PartyInvite_BlockPartyLeader"	"Bloker al kommunikation fra {g:dota_persona:b:inviter}"
"DOTA_LobbyInvite_BlockInviter"	"Bloker al kommunikation fra denne spiller"
"DOTA_PartyInvite_BlockNonFriendInvites"	"Bloker invitationer fra spillere der ikke er på din venneliste"
"DOTA_PartyInvite_Coach"	"Coach:"
"DOTA_PartyVisTooltip_TitleOpen"	"Leder efter gruppemedlemmer"
"DOTA_PartyVisTooltip_TitleNotOpen"	"Leder ikke efter gruppemedlemmer"
"DOTA_PartyVisTooltip_SoloNotOpen"	"Klik for at skifte din status."
"DOTA_PartyVisTooltip_SoloOpen"	"Venner kan anmode om at tilslutte dig.<br/>Klik for at ændre din status."
"DOTA_PartySettings"	"Gruppeindstillinger"
"DOTA_PartySettings_OpenParty"	"Åbn denne gruppe for tilslutningsanmodninger"
"DOTA_PartySettings_BroadcastToFriends"	"Lad mine venner se når jeg er i en gruppe"
"DOTA_PartySettings_OpenState_NotOpen"	"Gruppelederen har ikke markeret gruppen som åben for tilslutningsanmodninger."
"DOTA_PartySettings_OpenState_NotOpenLeader"	"Denne gruppe er ikke åben for tilslutningsanmodninger."
"DOTA_PartySettings_OpenState_OpenButHiddenFromFriends"	"Denne gruppe er åben for tilslutningsanmodninger. Gruppen er ikke synlig for dine venner, men den kan være synlig for andre gruppemedlemmers venner."
"DOTA_PartySettings_OpenState_Open"	"Denne gruppe er åben for tilslutningsanmodninger og er synlig for dine venner. Den kan også være synlig for andre gruppemedlemmers venner."
"DOTA_LobbyInvite_Title"	"Lobbyinvitation"
"DOTA_LobbyInvite_Description"	"{g:dota_persona:inviter} har inviteret dig til en lobby."
"DOTA_PartyJoinedLobby_Title"	"Tilsluttede lobby"
"DOTA_PartyJoinedLobby_Generic"	"{s:party_leader} har flyttet dig ind i en lobby."
"DOTA_PartyJoinedLobby_Custom"	"{s:party_leader} har flyttet dig ind i en {s:custom_game}-lobby."
"DOTA_PartyLeader"	"Gruppeleder"
"DOTA_LobbyKicked_Header"	"Smidt ud af lobby"
"DOTA_LobbyKicked_Message"	"Du blev smidt ud af spillobbyen af lobbylederen."
"DOTA_PlayerContextMenu_ViewProfile"	"Vis profil"
"DOTA_PlayerContextMenu_ChatWithPlayer"	"Send besked"
"DOTA_PlayerContextMenu_InviteToParty"	"Inviter til gruppe"
"DOTA_PlayerContextMenu_SuggestInviteToParty"	"Foreslå invitation til gruppe"
"DOTA_PlayerContextMenu_KickFromParty"	"Smid ud af gruppe"
"DOTA_PlayerContextMenu_SetPartyLeader"	"Angiv som gruppeleder"
"DOTA_PlayerContextMenu_LeaveParty"	"Forlad gruppe"
"DOTA_PlayerContextMenu_CoachParty"	"Coach denne gruppe"
"DOTA_PlayerContextMenu_StopCoachingParty"	"Stop coaching af denne gruppe"
"DOTA_PlayerContextMenu_AddFriend"	"Tilføj ven"
"DOTA_PlayerContextMenu_RemoveFriend"	"Fjern ven"
"DOTA_PlayerContextMenu_AcceptFriendRequest"	"Accepter venneanmodning"
"DOTA_PlayerContextMenu_IgnoreFriendRequest"	"Ignorer venneanmodning"
"DOTA_PlayerContextMenu_Spectate"	"Se på spil"
"DOTA_PlayerContextMenu_InviteToLobby"	"Inviter til lobby"
"DOTA_PlayerContextMenu_SuggestInviteToLobby"	"Foreslå invitation til lobby"
"DOTA_PlayerContextMenu_KickFromLobby"	"Smid ud af lobby"
"DOTA_PlayerContextMenu_KickFromLobbyTeam"	"Smid ud af lobbyholdet"
"DOTA_FeaturedHero_UnableToLoad"	"Kunne ikke indlæse udvalgte helte."
"DOTA_FeaturedHero_ViewGrid"	"Vis gittervisning"
"DOTA_FeaturedHero_HeroName"	"{s:hero_name}"
"DOTA_FeaturedHero_ItemName"	"{g:dota_item_name:item_def}"
"DOTA_FeaturedHeroReason_NewHero"	"Nylig udgivet helt"
"DOTA_FeaturedHeroReason_NewItem"	"Ny {s:item_rarity}"
"DOTA_FeaturedHeroReason_FrequentlyPlayedHero"	"Fordi du spillede"
"DOTA_FeaturedHeroReason_FeaturedItem"	"Udvalgt genstand"
"DOTA_FeaturedHeroReason_PopularItem"	"Topsælger"
"DOTA_FeaturedHeroReason_SaleItem"	"På udsalg nu"
"DOTA_NewFeaturedHero_WinterWyvern"	"På en køling vind kommer Eldwurmen."
"DOTA_HeroSelectorCategory_Default"	"Alle helte"
"DOTA_HeroSelectorCategory_NewItems"	"Nye genstande"
"DOTA_HeroSelectorCategory_Favorites"	"Foretrukne"
"DOTA_HeroSelectorCategory_MostPlayed"	"Mine mest spillede"
"DOTA_HeroSelectorCategory_LeastPlayed"	"Mine mindst spillede"
"DOTA_HeroSelectorCategory_HaveItems"	"Som jeg har genstande til"
"DOTA_HeroSelectorCategory_PrimaryAttribute_Strength"	"Styrke"
"DOTA_HeroSelectorCategory_PrimaryAttribute_Agility"	"Agilitet"
"DOTA_HeroSelectorCategory_PrimaryAttribute_Intelligence"	"Intelligens"
"DOTA_HeroSelectorCategory_AttackRange_Melee"	"Nærkamp"
"DOTA_HeroSelectorCategory_AttackRange_Ranged"	"Afstandskamp"
"DOTA_HeroSelector_SelectHero_Label"	"Vælg"
"DOTA_HeroSelector_ClearFilters"	"Ryd filtre"
"DOTA_OwnedItemSet_Selector_Title"	"Ejet"
"DOTA_EquippedItemSet_Selector_Title"	"Udstyret"
"DOTA_OwnedItemSet_Available_Title"	"Tilgængelig"
"DOTA_FeaturedItemSet_Selector_Title"	"Udvalgt"
"DOTA_AllItemSet_Selector_Title"	"Alle"
"DOTA_ConfirmLANLobby_title"	"LOKAL LOBBY"
"DOTA_ConfirmLANLobby_desc"	"Et lokalt spil oprettes på din computer. Systemkravene er højere, når du er vært for et spil."
"DOTA_ConfirmLANLobbyDisconnect_title"	"Forlad lokal lobby?"
"DOTA_ConfirmLANLobbyDisconnect_desc"	"Din maskine er vært for dette lobbyspil. At afbryde vil afslutte spillet for alle spillere. Vil du fortsætte?"
"DOTA_ConfirmLANLobbyDisconnect_ok"	"Ja, afbryd"
"DOTA_Lobby_Settings_General"	"GENERELLE LOBBYINDSTILLINGER"
"DOTA_Lobby_Settings_Required"	"PÅKRÆVET"
"DOTA_Lobby_Settings_Confirm"	"{s:lobby_confirm_label}"
"DOTA_Lobby_Settings_Game_Mode"	"SPILTILSTAND"
"DOTA_Lobby_Settings_Region"	"SERVERLOKALITET"
"DOTA_Lobby_Settings_Password"	"LOBBYADGANGSKODE"
"DOTA_Lobby_Settings_Game_Name"	"SPILNAVN"
"DOTA_Lobby_Settings_Advanced"	"AVANCEREDE LOBBYINDSTILLINGER"
"DOTA_Lobby_Settings_Competitive"	"KONKURRENCEMÆSSIG"
"DOTA_Lobby_Settings_Starting_Team"	"STARTENDE HOLD"
"DOTA_Lobby_Settings_Starting_Team_Random"	"TILFÆLDIG"
"DOTA_Lobby_Settings_Starting_Team_Radiant"	"RADIANT"
"DOTA_Lobby_Settings_Starting_Team_Dire"	"DIRE"
"DOTA_Lobby_Settings_Penalty_Radiant"	"STRAF - RADIANT"
"DOTA_Lobby_Settings_Penalty_Dire"	"STRAF - DIRE"
"DOTA_Lobby_Settings_Penalty_Level_0"	"Ingen straf"
"DOTA_Lobby_Settings_Penalty_Level_1"	"-30 sek. forbudsfase"
"DOTA_Lobby_Settings_Penalty_Level_2"	"-70 sek. forbudsfase"
"DOTA_Lobby_Settings_Penalty_Level_3"	"-110 sek. forbudsfase"
"DOTA_Lobby_Settings_Penalty_Tooltip"	"Når der spilles Captain's Mode, så reducerer denne valgmulighed antallet af sekunder, som dette hold har til at forbyde helte."
"DOTA_Lobby_Settings_Series_Type"	"SERIETYPE"
"DOTA_Lobby_Settings_No_Series"	"INGEN SERIE"
"DOTA_Lobby_Settings_Series_Best_of_3"	"BEDST AF 3"
"DOTA_Lobby_Settings_Series_Best_of_5"	"BEDST AF 5"
"DOTA_Lobby_Settings_Gameplay_Rules"	"GAMEPLAY-REGLER"
"DOTA_Lobby_Settings_Enable_Cheats"	"SLÅ SNYDEDKODER TIL"
"DOTA_Lobby_Settings_All_Chat"	"ALCHAT"
"DOTA_Lobby_Settings_Fill_Bots"	"FYLD TOMME PLADSER MED BOTS"
"DOTA_Lobby_Settings_Bot_Difficulty"	"BOT-SVÆRHEDSGRAD"
"DOTA_Lobby_Settings_Bot_Difficulty_Passive"	"PASSIV"
"DOTA_Lobby_Settings_Bot_Difficulty_Easy"	"LET"
"DOTA_Lobby_Settings_Bot_Difficulty_Medium"	"MEDIUM"
"DOTA_Lobby_Settings_Bot_Difficulty_Hard"	"SVÆR"
"DOTA_Lobby_Settings_Bot_Difficulty_Unfair"	"URIMELIG"
"DOTA_Lobby_Settings_Version"	"VERSION"
"DOTA_Lobby_Settings_Version_Latest"	"SENESTE"
"DOTA_Lobby_Settings_Version_Tournament"	"TURNERING"
"DOTA_Lobby_Settings_Spectator_Section"	"TILSKUER"
"DOTA_Lobby_Settings_Dota_TV_Delay"	"DOTA TV-FORSINKELSE"
"DOTA_Lobby_Settings_Dota_TV_Delay_2_Minutes"	"2 minutter"
"DOTA_Lobby_Settings_Dota_TV_Delay_5_Minutes"	"5 minutter"
"DOTA_Lobby_Settings_Dota_TV_Delay_10_Seconds"	"10 sekunder"
"DOTA_Lobby_Settings_Spectators"	"TILSKUERE"
"DOTA_Lobby_Settings_Spectators_Enabled"	"SLÅET TIL"
"DOTA_Lobby_Settings_Spectators_Disabled"	"SLÅET FRA"
"dota_lobby_settings_hide_password"	"Skjul adgangskode"
"dota_lobby_settings_local_host"	"Lokal vært"
"DOTA_Lobby_Settings_Visibility"	"Lobbysynlighed"
"DOTA_Lobby_Settings_Visibility_Public"	"Offentlig"
"DOTA_Lobby_Settings_Visibility_Friends"	"Venner"
"DOTA_Lobby_Settings_Visibility_Unlisted"	"Skjult"
"DOTA_Lobby_Settings_Visibility_Tooltip"	"Styrer hvor lobbyen er synlig henne. Offentlige lobbyer er synlige i lobby-browseren og i vennelisten. Vennelobbyer er kun synlige for venner, men andre spillere kan dog inviteres. Skjulte lobbyer er ikke synlige i browseren eller i vennelisten."
"DOTA_TeamUnsetHeader"	"Hold ikke valgt"
"DOTA_TeamUnsetMessage"	"Mindst ét hold har ikke noget holdnavn/logo valgt. Start kampen alligevel?"
"DOTA_LeagueUnsetHeader"	"Liga ikke valgt"
"DOTA_LeagueUnsetMessage"	"Der er ikke angivet nogen liga for denne lobby, men du kan godt angive en. Ønsker du virkelig at starte kampen?"
"DOTA_LobbyAllowSpectatingHeader"	"Kan ikke starte lobbyspil"
"DOTA_LobbyAllowSpectatingMessage"	"Spillet skal være angivet til at tilladelse tilskuere, når der er tilskuere i lobbyen. Slå tilskuere til i Indstillinger."
"dota_radiant"	"Radiant"
"dota_dire"	"Dire"
"dota_lobby_team_name_radiant"	"{s:team_name_good_guys}"
"dota_lobby_team_name_dire"	"{s:team_name_bad_guys}"
"dota_lobby_no_team"	"Intet hold"
"dota_lobby_broadcast_default_channel_name"	"Kanalnavn"
"dota_lobby_broadcast_join"	"Tilslut"
"dota_lobby_broadcast_leave"	"Forlad"
"dota_lobby_broadcast_create"	"Opret ny kanal"
"dota_lobby_broadcast_no_channels"	"Ingen broadcastkanaler er blevet skabt"
"dota_popup_broadcast_channel_edit_title"	"Tilpas broadcasterkanal"
"dota_lobby_broadcast_default_channel_name_custom"	"{s:custom_title}"
"dota_popup_broadcast_channel_edit_channel_name"	"Kanaltitel"
"dota_popup_broadcast_channel_edit_country"	"Land"
"dota_popup_broadcast_channel_edit_language"	"Sprog"
"dota_popup_broadcast_channel_edit_save"	"Gem som standardindstillinger og anvend på tomme kanaler ved tilslutning"
"DOTA_Lobby_Broadcaster_Channel_Other_Language"	"Andet sprog"
"lobby_slot_error_header"	"Kunne ikke bytte plads"
"generic_gc_timeout"	"Besked udløb."
"lobby_slot_success_header"	"Succes"
"lobby_slot_denied"	"Du har ikke tilladelse til at tage denne plads."
"lobby_slot_cameramanalready"	"Broadcasterkanaler kan kun have én kameramand"
"lobby_slot_cameramanon"	"Du er nu markeret som kameramand"
"lobby_slot_cameramanoff"	"Du er ikke længere kameramand"
"lobby_slot_error"	"Kunne ikke skifte lobbyplads."
"lobby_create_timeout"	"Lobbyoprettelse mislykkedes."
"find_match_error"	"Kan ikke søge efter en kamp på nuværende tidspunkt."
"DOTA_DialogVariableTest1"	"Simpel: {s:var}"
"DOTA_DialogVariableTest2"	"Pengeværdi: {m:money}"
"DOTA_DialogVariableTest3"	"Genstandslink: {g:dota_item_link:item_def}"
"DOTA_DialogVariableTest4"	"Genstandspris: {g:dota_item_price:item_def}"
"DOTA_DialogVariableTest5"	"Konto-ID-navn: {g:dota_persona:account_id}, Pro-navn: {g:dota_persona:pro:account_id}"
"DOTA_DialogVariableTest6"	"Simpel med span: <span class=\"TextSpan\">{s:var}</span>"
"LobbySetting_GameMode"	"Spiltilstand"
"LobbySetting_GameMode_Value"	"{s:lobbysetting_gamemode}"
"LobbySetting_Bots"	"Bots"
"LobbySetting_Bots_Value"	"{s:lobbysetting_bots}"
"LobbySetting_Password"	"Adgangskode"
"LobbySetting_Password_Value"	"{s:lobbysetting_password}"
"LobbySetting_Server"	"Server"
"LobbySetting_Server_Value"	"{s:lobbysetting_server}"
"LobbySetting_Cheats"	"Snydekoder"
"LobbySetting_Cheats_Value"	"{s:lobbysetting_cheats}"
"LobbySetting_Spectators"	"Tilskuere"
"LobbySetting_Spectators_Value"	"{s:lobbysetting_spectators}"
"LobbySetting_Visibility"	"Synlighed"
"LobbySetting_Visibility_Value"	"{s:lobbysetting_visibility}"
"dota_lobby_lan_title"	"Lokal server"
"dota_lobby_coaches_none"	"Coaches: Ingen"
"dota_lobby_coaches"	"Coaches:"
"DOTA_Custom_Game"	"Tilpasset spil"
"DOTA_Custom_Game_Info"	"Info"
"DOTA_Custom_Game_View_Details"	"Se spiloplysninger"
"DOTA_Custom_Game_Author"	"af {g:dota_persona:author}"
"DOTA_Custom_Game_Lobby_Count"	"{d:lobby_count} lobby"
"DOTA_Custom_Game_Lobby_Count_Plural"	"{d:lobby_count} lobbyer"
"DOTA_Custom_Game_Friend_Lobbies_Alert"	"Du har {d:friend_count} ven med en åben spillobby."
"DOTA_Custom_Game_Friend_Lobbies_Alert_Plural"	"Du har {d:friend_count} venner med åbne spillobbyer."
"DOTA_Custom_Game_Quick_Join"	"Hurtig-tilslut"
"DOTA_Custom_Game_View_Lobbies"	"Vis lobbyer"
"DOTA_Custom_Game_Find_Lobby"	"Find lobby"
"DOTA_Custom_Game_Create_Lobby"	"Opret lobby"
"DOTA_Custom_Game_Game_Page"	"Spilside"
"DOTA_Custom_Game_Workshop_Page"	"Værkstedsside"
"DOTA_Custom_Game_Download_Queued"	"Download sat i kø"
"DOTA_Custom_Game_Downloading"	"Downloader..."
"DOTA_Custom_Game_Downloading_Percent"	"Downloader - {d:lobby_download_percent}%"
"DOTA_Custom_Game_Needs_Update"	"Skal opdateres"
"DOTA_Custom_Game_Play"	"Spil {s:game_mode_name}"
"DOTA_Custom_Game_Uninstall"	"Afinstaller"
"DOTA_Custom_Game_Install"	"Installer"
"DOTA_Custom_Game_Installed"	"Installeret"
"DOTA_Custom_Game_Not_Installed"	"Ikke installeret"
"DOTA_Custom_Game_Connect"	"Tilslut lobby"
"DOTA_Custom_Game_FileSize"	"{d:file_size} MB"
"DOTA_Custom_Game_Name"	"{s:game_mode_name}"
"DOTA_Custom_Game_Released_By"	"Udgivet d. {s:release_date}</b> af <b>{g:dota_persona:author}</b>"
"DOTA_Custom_Game_Subscription"	"{s:subscriptions_count} abonnement"
"DOTA_Custom_Game_Subscriptions"	"{s:subscriptions_count} abonnementer"
"DOTA_Custom_Game_Rating"	"Vurdering"
"DOTA_Custom_Game_Release_Date"	"Udgivet"
"DOTA_Custom_Game_Playing_Now"	"{s:player_count} spiller nu"
"DOTA_Custom_Game_Ratings_Count"	"({d:ratings_count})"
"DOTA_Custom_Game_Description"	"{s:game_description}"
"DOTA_Custom_Game_Last_Updated"	"Senest opdateret {t:r:t:last_updated}"
"DOTA_Custom_Game_Update_Note_Title"	"{s:timestamp}"
"DOTA_Custom_Game_Screenshots"	"Skærmbilleder"
"DOTA_Custom_Game_Map_Label"	"Bane"
"DOTA_Custom_Game_Map_Any"	"Enhver"
"DOTA_Custom_Game_Update"	"Opdater"
"DOTA_Custom_Game_Spectate"	"Se på"
"DOTA_Custom_Game_Already_In_Lobby"	"Færdiggør dit nuværende spil for at starte denne spiltilstand."
"DOTA_Custom_Game_Friends_Playing"	"Venner der spiller tilpassede spil"
"DOTA_Custom_Game_Friends_In_Lobbies"	"{d:friends_in_open_lobbies} i åbne lobbyer"
"DOTA_Custom_Game_Friends_In_Game"	"{d:friends_in_game} venner i tilpassede spil"
"DOTA_Custom_Games_Friends_Play"	"Tilpassede spil dine venner spiller"
"DOTA_Custom_Game_Invite_Friend"	"Inviter en ven"
"DOTA_Custom_Game_Tooltip_Subscribers"	"{d:subscriber_count} abonnementer"
"DOTA_Custom_Game_Tooltip_Subscriber"	"{d:subscriber_count} abonnement"
"DOTA_Custom_Game_Most_Popular"	"Mest populære"
"DOTA_Custom_Game_Installed_Games"	"Installerede spil"
"DOTA_Custom_Game_Favorite_Games"	"Vis kun foretrukne"
"DOTA_Custom_Game_Add_Favorite"	"Føj til foretrukne"
"DOTA_Custom_Game_VotePrompt"	"Skal vi hjælpe flere folk med at lære dette spil at kende?"
"DOTA_Custom_Game_DetailsPrompt"	"Se spillets oplysningsside for at lære mere, installere og spille det."
"DOTA_Custom_Game_Vote_Box_Title"	"Værkstedsafstemning"
"DOTA_Custom_Game_Vote_Box_Desc"	"Hjælp ikke-opdagede spil med at få et fodfæste."
"DOTA_Custom_Game_Vote_Start"	"Start afstemning"
"DOTA_Custom_Game_VoteThanks"	"Tak for din stemme!"
"DOTA_Custom_Game_Vote_PrevLabel"	"Forrige spil"
"DOTA_Custom_Game_Vote_NextLabel"	"Næste spil"
"DOTA_Custom_Game_Vote_ControlsLabel"	"Værkstedsafstemning"
"DOTA_Custom_Game_Vote_YesLabel"	"Ja, fremhæv det!"
"DOTA_Custom_Game_Vote_NoLabel"	"Niks, skal arbejdes på."
"DOTA_Custom_Game_Vote_SkipLabel"	"Spring dette spil over; jeg har ingen mening."
"DOTA_Custom_Game_Vote_Up"	"Godt spil"
"DOTA_Custom_Game_Vote_Down"	"Skal arbejdes på"
"Video_Support_Coming_Soon"	"Videounderstøttelse kommer snart"
"DOTA_Custom_Game_Leave_Lobby"	"Forlad denne lobby"
"DOTA_Custom_Game_Suggested_Title"	"Foreslåede spil"
"DOTA_Custom_Game_Suggested_Info"	"Denne liste indeholder populære spil og spil, som modtager positive stemmer.<br><br>Udvalget skifter hvert 30. minut og præsenterer derfor de samme 15 spil til hele fællesskabet på samme tid."
"DOTA_Custom_Game_Addon_Restricted"	"Kan ikke udføre denne handling mens der køres i addon-begrænset værktøjstilstand."
"DOTA_Custom_Game_Search"	"Søg tilpassede spil"
"DOTA_Custom_Lobby_Create_Button"	"Opret tilpasset lobby"
"DOTA_Custom_Lobby_Settings_Title"	"Opret lobby"
"DOTA_Custom_Lobby_Settings_Mode"	"Spiltilstand"
"DOTA_Custom_Lobby_Settings_Map"	"Bane"
"DOTA_Custom_Lobby_LobbyName"	"Valgfri beskrivelse"
"DOTA_Custom_Lobby_List_Desc"	"En liste over private lobbyer (adgangskodebeskyttede) og ikke ufiltrerede aktive tilpassede spil"
"DOTA_Custom_Lobby_Public"	"Offentlig"
"DOTA_Custom_Lobby_Passworded"	"Spillere kan kun tilslutte sig denne lobby via invitationer ved at filtrere lobbylisten efter adgangskode."
"DOTA_Custom_Lobby_Join_Failed_Title"	"Tilslutning mislykkedes"
"DOTA_Custom_Lobby_Join_Failed_Reason"	"{s:join_error}"
"DOTA_Custom_Lobby_Join_Failed_Prompt"	"Ønsker du at søge efter en åben {s:game_name}-lobby nu?"
"DOTA_Lobby_Failed_Pings"	"Kunne ikke hente oplysninger om ping. Kontroller venligst om du har internetforbindelse og om Dota 2-serverne er online."
"DOTA_Custom_Lobby_Create_Private_Button"	"Opret privat lobby"
"DOTA_Custom_Lobby_Find_Private_Button"	"Find privat lobby"
"DOTA_Custom_Lobby_Find_Private_Title"	"Find privat lobby"
"DOTA_Custom_Lobby_Find_Private_Desc"	"Indtast en adgangskode for at finde en privat lobby:"
"DOTA_Custom_Lobby_List_Game_Header"	"Spil"
"DOTA_Custom_Lobby_List_Name_Header"	"Beskrivelse"
"DOTA_Custom_Lobby_List_Players_Header"	"Spillere"
"DOTA_Custom_Lobby_List_Map_Header"	"Bane"
"DOTA_Custom_Lobby_List_Region_Header"	"Region"
"DOTA_Custom_Lobby_List_Connection_Header"	"Forbindelse"
"DOTA_Custom_Lobby_List_Game"	"{s:lobby_game}"
"DOTA_Custom_Lobby_List_Lobby_Name"	"{s:lobby_name}"
"DOTA_Custom_Lobby_List_Players"	"{s:lobby_players} / {s:lobby_max_players}"
"DOTA_Custom_Lobby_List_Map"	"{s:lobby_map}"
"DOTA_Custom_Lobby_List_Region"	"{s:lobby_region}"
"DOTA_Custom_Lobby_List_Connection"	"..."
"DOTA_Custom_Lobby_List_Status"	"{s:lobby_status}"
"DOTA_Custom_Lobby_List_Connect"	"{s:connect_button_text}"
"DOTA_Custom_Lobby_Game_Name"	"{s:game_name}"
"DOTA_Custom_Lobby_Map_Name"	"Bane: {s:map_name}"
"DOTA_Custom_Lobby_Player_Count"	"Spillere: {d:player_count} / {d:max_player_count}"
"DOTA_Custom_Lobby_Player_Count_Short"	"{d:player_count} / {d:max_player_count}"
"DOTA_Custom_Lobby_Visibility"	"Lobbysynlighed"
"DOTA_Custom_Join_Chat"	"Tilslut chat"
"DOTA_Custom_Join_Chat_Member_Count"	"({d:ChatMemberCount})"
"DOTA_Custom_Leave_Chat"	"Forlad chat"
"DOTA_Custom_Game_Vote_Up_Tooltip"	"Klik for at op-stemme dette spil i Steam-værkstedet."
"DOTA_Page_Number"	"Side: {d:current_page} / {d:num_pages}"
"DOTA_TabName_ModsOverview"	"Oversigt"
"DOTA_TabName_ModsSubscribed"	"Bibliotek"
"DOTA_TabName_ModsWorkshop"	"Værksted"
"DOTA_TabName_ModsBrowse"	"Gennemse"
"DOTA_WatchTabName_Live"	"Direkte"
"DOTA_WatchTabName_Featured"	"Udvalgte"
"DOTA_WatchTabName_Replays"	"Gengivelser"
"DOTA_WatchTabName_Tournaments"	"Turneringer"
"DOTA_WatchTabName_Downloads"	"Downloads"
"DOTA_WatchLive_Search"	"Søge efter helte at se på"
"DOTA_WatchLive_DataPending"	"Finder direkte spil..."
"DOTA_WatchLive_DataError"	"Fejl under indlæsningen af direkte spil"
"DOTA_WatchLive_NoGames"	"Ingen direkte spil spilles på nuværende tidspunkt"
"DOTA_WatchLive_Connecting"	"Venter på spildata..."
"DOTA_WatchLive_HeroFilter"	"Filter: {s:hero_filter_name}"
"DOTA_WatchLive_CountSpec"	"{i:num_spectating} ser på"
"DOTA_WatchLive_CountSpecFriend"	"{i:num_friends_spectating} ven og {i:num_spectating} ser på"
"DOTA_WatchLive_CountSpecFriends"	"{i:num_friends_spectating} venner og {i:num_spectating} ser på"
"DOTA_WatchLive_CountFriends"	"{i:num_friends_playing} venner spiller"
"DOTA_WatchLive_ParticipantsVs"	"<font color='#ffffff'>{s:team_1}</font> <font color='#888888'>mod</font> <font color='#ffffff'>{s:team_2}</font>"
"DOTA_WatchLive_ParticipantsMMR"	"<font color='#ffffff'>{i:mmr}</font> <font color='#888888'>gennemsnitlig MMR</font>"
"DOTA_WatchLive_ParticipantsUnranked"	"Ikke rangeret"
"DOTA_WatchLive_Participants1"	"{s:friend_1}"
"DOTA_WatchLive_Participants2"	"{s:friend_1} og {s:friend_2}"
"DOTA_WatchLive_Participants3"	"{s:friend_1}, {s:friend_2} og {s:friend_3}"
"DOTA_WatchLive_Participants4Plus"	"{s:friend_1}, {s:friend_2}, {s:friend_3} og {i:friend_count_over_3} flere..."
"DOTA_WatchLive_MatchType_MM_Kills"	"{s:game_mode}"
"DOTA_WatchLive_MatchType_MM"	"{s:game_mode}"
"DOTA_WatchLiveDotaTV"	"Se i DotaTV"
"DOTA_WatchLivePurchase"	"Køb turneringspas {g:dota_item_price:ticket_itemdef}"
"DOTA_WatchLiveSpectatorFriends1"	"{g:dota_persona:spectator_friend_1} ser på"
"DOTA_WatchLiveSpectatorFriends2"	"{g:dota_persona:spectator_friend_1} og {g:dota_persona:spectator_friend_2} ser på"
"DOTA_WatchLiveSpectatorFriends3"	"{g:dota_persona:spectator_friend_1}, {g:dota_persona:spectator_friend_2} og {g:dota_persona:spectator_friend_3} ser på"
"DOTA_WatchLiveSpectatorFriends4Plus"	"{g:dota_persona:spectator_friend_1}, {g:dota_persona:spectator_friend_2}, {g:dota_persona:spectator_friend_3} og {i:spectator_friend_count_over_3} andre venner ser på"
"DOTA_WatchLiveSpectatorCount"	"{i:spectator_count} ser på"
"DOTA_WatchLive_ElapsedTime"	"Forløbet tid:"
"DOTA_WatchLive_Spectating"	"Ser på:"
"DOTA_WatchReplays_TournamentsHeader"	"POPULÆRE TURNERINGSKAMPE"
"DOTA_WatchReplays_FriendsHeader"	"VENNERS KAMPE"
"DOTA_WatchReplays_Popular"	"POPULÆRE KAMPE"
"DOTA_WatchReplays_SavedForLater"	"GEMT TIL AT SE SENERE"
"DOTA_WatchReplays_ParticipantsVs"	"{s:team_1} mod {s:team_2}"
"DOTA_WatchReplays_MatchType_League"	"{s:league_name}"
"DOTA_WatchReplays_MatchType_Public"	"Kamp {s:match_id} - {s:game_mode}"
"DOTA_WatchReplays_Recommendations"	"{i:recommendations}"
"DOTA_WatchReplays_Recommendations1"	"{g:dota_persona:friend_1} + {i:recommendations}"
"DOTA_WatchReplays_Recommendations2"	"{g:dota_persona:friend_1}, {g:dota_persona:friend_2} + {i:recommendations}"
"DOTA_WatchReplays_Recommendations3Plus"	"{g:dota_persona:friend_1} + {i:friend_count_over_1} flere venner + {i:recommendations}"
"DOTA_WatchReplays_Friends1"	"{g:dota_persona:b:friend_1} spillede"
"DOTA_WatchReplays_Friends2"	"{g:dota_persona:b:friend_1} og {g:dota_persona:friend_2} spillede"
"DOTA_WatchReplays_Friends3Plus"	"{g:dota_persona:b:friend_1}, {g:dota_persona:b:friend_2} og {i:friend_count_over_2} flere venner"
"DOTA_WatchReplays_Views"	"{i:views} visninger"
"DOTA_WatchReplays_Price"	"{g:dota_item_price:ticket_itemdef}"
"DOTA_WatchReplays_SharedMatch"	"{g:dota_persona:shared_by} delte - \"{s:shared_text}\""
"DOTA_WatchReplays_SharedHighlight"	"{g:dota_persona:shared_by} delte et højdepunkt"
"DOTA_WatchReplays_Duration"	"{s:minutes}:{s:seconds}"
"DOTA_WatchReplays_Tag"	"\"{s:recommendation_text}\""
"DOTA_WatchTournaments_FeaturedTitle"	"{s:tournament_featured_title}"
"DOTA_WatchTournaments_FeaturedDates"	"{s:tournament_featured_start} - {s:tournament_featured_end}"
"DOTA_WatchTournaments_FeaturedDescription"	"{s:tournament_featured_description}"
"DOTA_WatchTournaments_FeaturedTeams"	"Hold"
"DOTA_WatchTournaments_PrizePool"	"Præmiepulje:"
"DOTA_WatchTournaments_PrizePoolAmt"	"{s:tournament_featured_prize_pool}"
"DOTA_WatchTournaments_Purchase"	"Turneringspas - {s:tournament_featured_price}"
"DOTA_WatchTournament_TournamentName"	"{s:tournament_name}"
"DOTA_WatchTournament_Price"	"{s:price}"
"DOTA_Replays_Search"	"Søg efter KampID'er"
"DOTA_Watch_GameStatus"	"Se spilstatus"
"DOTA_Watch_Pending"	"Venter på at se på spil..."
"DOTA_Watch_GameServerNotFound"	"Spilserveren, som hoster dette spil, kunne ikke findes."
"DOTA_Watch_Unavailable"	"Kan ikke se på dette spil på nuværende tidspunkt."
"DOTA_Watch_LobbyNotFound"	"Lobby ikke fundet."
"DOTA_Watch_MissingLeagueSubscription"	"Dette spil er et ligaspil, som kræver et abonnement for at kunne ses."
"vs"	"MOD"
"dota_matchmaking_language_title"	"Vælg matchmaking-sprog"
"dota_matchmaking_language_primary_label"	"Dit primære matchmaking-sprog er:"
"dota_matchmaking_language_primary"	"{s:environment_language}"
"dota_matchmaking_language_primary_invalid"	"Dit sprog, {s:environment_language}, er ikke tilgængelig som et matchmakingsprog i Dota 2."
"dota_matchmaking_language_select_secondary"	"Hvis du vil, kan du vælge et sekundært sprog:"
"dota_matchmaking_language_select_primary"	"Vælg venligst et matchmaking-sprog:"
"dota_matchmaking_language_no_selection"	"Intet valgt"
"dota_matchmaking_language_english"	"Engelsk"
"dota_matchmaking_language_russian"	"Russisk"
"dota_matchmaking_language_chinese"	"Kinesisk"
"dota_matchmaking_language_schinese"	"Kinesisk"
"dota_matchmaking_language_korean"	"Koreansk"
"dota_matchmaking_language_koreana"	"Koreansk"
"dota_matchmaking_language_spanish"	"Spansk"
"dota_matchmaking_language_portuguese"	"Portugisisk"
"GameUI_Language_English"	"Engelsk"
"GameUI_Language_German"	"Tysk"
"GameUI_Language_French"	"Fransk"
"GameUI_Language_Italian"	"Italiensk"
"GameUI_Language_Korean"	"Koreansk"
"GameUI_Language_Spanish"	"Spansk"
"GameUI_Language_Simplified_Chinese"	"Forenklet kinesisk"
"GameUI_Language_Traditional_Chinese"	"Traditionelt kinesisk"
"GameUI_Language_Russian"	"Russisk"
"GameUI_Language_Thai"	"Thai"
"GameUI_Language_Japanese"	"Japansk"
"GameUI_Language_Portuguese"	"Portugisisk"
"GameUI_Language_Polish"	"Polsk"
"GameUI_Language_Danish"	"Dansk"
"GameUI_Language_Dutch"	"Hollandsk"
"GameUI_Language_Finnish"	"Finsk"
"GameUI_Language_Norwegian"	"Norsk"
"GameUI_Language_Swedish"	"Svensk"
"GameUI_Language_Hungarian"	"Ungarsk"
"GameUI_Language_Czech"	"Tjekkisk"
"GameUI_Language_Romanian"	"Rumænsk"
"GameUI_Language_Turkish"	"Tyrkisk"
"GameUI_Language_Brazilian"	"Portugisisk-Brasilien"
"GameUI_Language_Bulgarian"	"Bulgarsk"
"GameUI_Language_Greek"	"Græsk"
"GameUI_Language_Ukrainian"	"Ukrainsk"
"client_version_out_of_date_title"	"Opdatering krævet"
"client_version_out_of_date"	"Spilklienten er forældet. Luk venligst Dota 2 og genstart for at få den seneste version."
"dota_matchmaking_region_title"	"Vælg matchmaking-regioner"
"dota_matchmaking_region_auto"	"Vælg automatisk den bedste region ud fra min lokalitet."
"dota_matchmaking_region_select"	"Vælg op til tre matchmaking-regioner. Vælg kun de tætteste regioner for den bedste oplevelse."
"limited_heroes_abandon_header"	"Limited Heroes-tilstand"
"limited_heroes_abandon_explanation"	"Der er ingen straf for at forlade en kamp med Limited Heroes-tilstanden, da din helt bliver erstattet af en bot. At forlade enhver anden spiltilstand resulterer muligvis i anbringelse i lav prioritet."
"dota_abandon_dialog_title"	"Forlad spil"
"dota_abandon_dialog_confirm"	"Er du sikker på, at du vil forlade dette spil?"
"dota_abandon_dialog_yes"	"Ja, forlad spillet."
"dota_leave_dialog_title"	"Forlad spil"
"dota_leave_dialog_confirm"	"Er du sikker på, at du ønsker at forlade dette spil?"
"dota_leave_dialog_yes"	"Ja, forlad spillet."
"dota_accept_match_title"	"Dit spil er klar"
"dota_accept_match_readyup_title"	"Venter på spillere"
"dota_accept_match_accept"	"Accepter"
"dota_accept_match_accept_low_pri"	"Accepter kamp med lav prioritet"
"dota_accept_match_accept_button"	"{s:accept}"
"dota_accept_match_decline"	"Afslå"
"dota_accept_match_subtitle"	"{s:subtitle}"
"dota_finding_match_players"	"( {s:searching_player_count} søger )"
"dota_finding_match_accept_count"	"accepterede kamp: {s:match_num_accepted} / {s:match_num_total}"
"dota_finding_match_generic"	"Normal kamp"
"dota_finding_match_ranked"	"Rangeret kamp"
"dota_finding_match_bot"	"Bot-kamp"
"dota_finding_match_bot_passive"	"Bot-kamp ( passiv )"
"dota_finding_match_bot_easy"	"Bot-kamp ( let )"
"dota_finding_match_bot_medium"	"Bot-kamp ( medium )"
"dota_finding_match_bot_hard"	"Bot-kamp ( svær )"
"dota_finding_match_bot_unfair"	"Bot-kamp ( urimelig )"
"dota_finding_match_team"	"Holdrangeret kamp"
"dota_finding_1v1_match_casual"	"1v1-kamp"
"dota_finding_match_practice_lobby"	"Lobbyspil"
"dota_safe_to_abandon_inline"	"Spillet kan forlades sikkert"
"dota_match_connected"	"Fik forbindelse til spillet"
"dota_match_local_game"	"Tilsluttet lokalt spil"
"dota_match_connecting"	"Opretter forbindelse til spillet..."
"dota_match_in_progress"	"Igangværende spil"
"dota_match_finished"	"Spillet er færdigt"
"matchmaking_waiting_for_players"	"Venter på andre spillere"
"matchmaking_player_declined"	"En spiller afviste kampen"
"dota_match_wait_for_host"	"Venter på vært"
"dota_match_find_server"	"Finder server"
"ranked_disabled"	"Rangeret matchmaking er på nuværende tidspunkt slået fra."
"ranked_mmr"	"Din matchmaking-rang"
"ranked_mmr_solo_label"	"Solo"
"ranked_mmr_solo_value"	"{i:solo_mmr}"
"ranked_mmr_solo_no_data"	"Kræver {i:solo_calibrating_required_games} spil for kalibrering"
"ranked_mmr_party_label"	"Gruppe"
"ranked_mmr_party_value"	"{i:party_mmr}"
"ranked_mmr_party_no_data"	"Kræver {i:party_calibrating_required_games} spil for kalibrering"
"matchmaking_account_disabled"	"Du har været for forstyrrende og vil ikke kunne chatte eller søge efter en kamp. Tid tilbage: {t:r:match_denied_time}"
"matchmaking_match_disabled_party"	"{s:match_denied_player_name} forhindrer matchmaking da vedkommende ikke var klar eller forlod sit sidste spil. Tid tilbage: {t:r:match_denied_time}"
"matchmaking_low_priority_party"	"{s:match_denied_player_name} vil kun tillade lav-prioritetsmatchmaking på grund af forladte spil eller modtagelse af for mange rapporteringer. Spil tilbage: {d:match_denied_games}"
"matchmaking_match_disabled_local"	"Du er forhindret i at starte matchmaking, da du ikke var klar eller forlod dit sidste spil. Tid tilbage: {t:r:match_denied_time}"
"matchmaking_low_priority_local"	"Du kan kun søge i matchmaking med lav prioritet på grund af forladte spil eller modtagelse af for mange rapporteringer. Spil tilbage: {d:match_denied_games}"
"dota_ready_up_count"	"{s:ready_up_ready} / {s:ready_up_lobby_members}"
"dota_play_normal_match"	"Normal kamp"
"dota_play_ranked_match"	"Rangeret kamp"
"dota_play_practice_1v1"	"Træn 1v1"
"dota_play_practice_with_bots"	"Træn med bots"
"dota_play_practice_1v1_playtab"	"TRÆN 1v1"
"dota_play_practice_1v1_party_warning"	"Grupper er ikke tilladte i 1v1-matchmaking"
"dota_play_button_label"	"{s:play_button_label}"
"dota_play"	"Spil Dota"
"dota_play_searching"	"Finder kamp"
"dota_play_connecting"	"Værten indlæser..."
"dota_play_lobby_find_server"	"Finder server"
"dota_play_find_match_label"	"{s:find_match_label}"
"dota_reconnect"	"Tilslut igen"
"dota_abandon_game"	"Forlad"
"dota_safe_leave_game"	"Forlad spil"
"dota_disconnect"	"Afbryd"
"dota_play_unavailable"	"Utilgængelig"
"dota_leaver_consequence_tooltip_header"	"Konsekvenser"
"dota_leaver_consequences"	"{s:leaver_consequences}"
"dota_leaver_consequences_details"	"{s:leaver_consequences_details}"
"dota_leaver_view_tooltip"	"Vis oplysninger"
"dota_leaver_consequence_header_leave_match"	"At forlade denne kamp vil resultere i negative konsekvenser"
"dota_leaver_consequence_LetDownTeammates"	"Dine holdkammerater fortsætter spillet med en ulempe."
"dota_leaver_consequence_SmallMatchmakingCooldown"	"Du vil blive forhindret i at starte matchmaking i noget tid."
"dota_leaver_consequence_CreditWithAbandon"	"Spillet vil tælle som forladt."
"dota_leaver_consequence_ForcedLossForLeaver"	"Du vil modtage et nederlag."
"dota_leaver_consequence_ForcedLossForLeaversParty"	"Alle i din gruppe vil modtage et nederlag."
"dota_leaver_consequence_ForcedLossForLeaversTeam"	"Dit hold, %s1, vil modtage et nederlag."
"dota_leaver_consequence_MMRLossForLeaver"	"Din MMR vil falde."
"dota_leaver_consequence_MMRLossForLeaversParty"	"MMR'en for alle i din gruppe vil falde."
"dota_leaver_consequence_MMRLossForLeaversTeam"	"MMR'en for dit hold, %s1, vil falde."
"dota_leaver_consequence_MatchDiscardedForOtherPlayers"	"Kampen tælles ikke for andre spillere."
"dota_leaver_consequence_NotDecrementLowPriGamesRemaining"	"Kampen vil ikke tælle som en gennemført kamp."
"dota_reconnect_popup_title"	"Tilslut igen?"
"dota_reconnect_popup_message"	"Vil du gerne slutte til spillet igen?"
"dota_matchmaking_regions_refresh"	"Opdater pings"
"dota_matchmaking_region_ping"	"{s:region_ping}"
"dota_matchmaking_region_offline"	"Offline pga. vedligeholdelse"
"dota_matchmaking_region_unknown_ping"	"Ping: Ukendt"
"dota_matchmaking_region_ping_time"	"Ping: {i:ping_ms}ms"
"DOTA_VAC_Verification_Header"	"Valve Anti-Cheat (VAC)"
"DOTA_VAC_Verification_Header_Solo"	"Kan ikke deltage i matchmaking fordi et problem med din computer blokerer for VAC-systemet. Sørg venligst for at du ikke bruger nogen programmer, som kan forstyrre VAC og bekræft, at Steam er rigtigt installeret."
"DOTA_VAC_Verification_Header_Party"	"Kan ikke deltage i matchmaking fordi et problem med din computer blokerer for VAC-systemet for én eller flere af dine gruppemedlemmer. Sørg venligst for at du ikke bruger nogen programmer, som kan forstyrre VAC og bekræft, at Steam er rigtigt installeret."
"DOTA_VAC_Verification_Button1"	"Mere info"
"DOTA_VAC_Verification_Button2"	"Luk"
"dota_matchmaking_regions_button"	"{s:regions_selected}"
"dota_region_automatic"	"Region: Auto"
"dota_regions_selected"	"Regioner: "
"dota_lobby_region_invalid"	"Ingen"
"dota_play_no_language_selected"	"VÆLG SPROG"
"dota_play_language"	"{s:match_language}"
"dota_play_language_many"	"SPROG: {i:match_language_count}"
"dota_ready_fail"	"KLARGØRELSE MISLYKKEDES"
"dota_ready_fail_desc"	"Din kamp var klar, men det lykkedes dig ikke at svare, og du er blevet fjernet fra matchmaking-sammenslutningen."
"dota_all_chat_label"	"[ALLE]"
"dota_chatwheel_label_Ok"	"Okay"
"dota_chatwheel_label_Care"	"Forsigtig"
"dota_chatwheel_label_GetBack"	"Gå tilbage"
"dota_chatwheel_label_NeedWards"	"Brug for wards"
"dota_chatwheel_label_Stun"	"Lam"
"dota_chatwheel_label_Help"	"Hjælp"
"dota_chatwheel_label_Push"	"Push"
"dota_chatwheel_label_GoodJob"	"Godt spillet"
"dota_chatwheel_label_Missing"	"Mangler"
"dota_chatwheel_label_Missing_Top"	"Mangler top"
"dota_chatwheel_label_Missing_Mid"	"Mangler midt"
"dota_chatwheel_label_Missing_Bottom"	"Mangler bund"
"dota_chatwheel_label_Go"	"Go!"
"dota_chatwheel_label_Initiate"	"Initier!"
"dota_chatwheel_label_Follow"	"Følg mig"
"dota_chatwheel_label_Group_Up"	"Gruppér"
"dota_chatwheel_label_Spread_Out"	"Spred jer"
"dota_chatwheel_label_Split_Farm"	"Split-farm"
"dota_chatwheel_label_Attack"	"Angrib nu!"
"dota_chatwheel_label_BRB"	"Er snart tilbage"
"dota_chatwheel_label_Dive"	"Dive!"
"dota_chatwheel_label_OMW"	"Er på vej"
"dota_chatwheel_label_Get_Ready"	"Vær klar"
"dota_chatwheel_label_Bait"	"Bait"
"dota_chatwheel_label_Heal"	"Hel"
"dota_chatwheel_label_Mana"	"Mana"
"dota_chatwheel_label_OOM"	"Ikke mere mana"
"dota_chatwheel_label_Skill_Cooldown"	"Nedkøling"
"dota_chatwheel_label_Ulti_Ready"	"Ulti klar"
"dota_chatwheel_label_Enemy_Returned"	"Fjende tilbage"
"dota_chatwheel_label_All_Missing"	"Alle mangler"
"dota_chatwheel_label_Enemy_Incoming"	"Indkommende"
"dota_chatwheel_label_Invis_Enemy"	"Usynlig fjende"
"dota_chatwheel_label_Enemy_Had_Rune"	"Fjenden har runen"
"dota_chatwheel_label_Split_Push"	"Split-push"
"dota_chatwheel_label_Coming_To_Gank"	"Kommer for at ganke"
"dota_chatwheel_label_Request_Gank"	"Anmod om gank"
"dota_chatwheel_label_Fight_Under_Tower"	"Under tårn"
"dota_chatwheel_label_Deny_Tower"	"Deny tårn"
"dota_chatwheel_label_Buy_Courier"	"Køb kurér"
"dota_chatwheel_label_Upgrade_Courier"	"Opgrader kurér"
"dota_chatwheel_label_Need_Detection"	"Vi har brug for detektion"
"dota_chatwheel_label_They_Have_Detection"	"De har detektion"
"dota_chatwheel_label_Buy_TP"	"Køb TP"
"dota_chatwheel_label_Reuse_Courier"	"Anvend kuréren igen"
"dota_chatwheel_label_Deward"	"Deward"
"dota_chatwheel_label_Building_Mek"	"Bygger Mek"
"dota_chatwheel_label_Building_Pipe"	"Bygger Pipe"
"dota_chatwheel_label_Stack_And_Pull"	"Stack og pull"
"dota_chatwheel_label_Pull"	"Pull kryb"
"dota_chatwheel_label_Pulling"	"Pull'er kryb"
"dota_chatwheel_label_Stack"	"Stack neutrale"
"dota_chatwheel_label_Jungling"	"Jungler"
"dota_chatwheel_label_Roshan"	"Roshan"
"dota_chatwheel_label_Affirmative"	"Bekræftet"
"dota_chatwheel_label_Wait"	"Vent"
"dota_chatwheel_label_Pause"	"Pause"
"dota_chatwheel_label_Current_Time"	"Nuværende tid"
"dota_chatwheel_label_Check_Runes"	"Tjek runer"
"dota_chatwheel_label_Smoke_Gank"	"Smoke gank!"
"dota_chatwheel_label_GLHF"	"Held og lykke"
"dota_chatwheel_label_Nice"	"Nice"
"dota_chatwheel_label_Thanks"	"Tak"
"dota_chatwheel_label_Sorry"	"Undskyld"
"dota_chatwheel_label_No_Give_Up"	"Giv ikke op"
"dota_chatwheel_label_Just_Happened"	"Det skete lige"
"dota_chatwheel_label_Game_Is_Hard"	"Spillet er svært"
"dota_chatwheel_label_New_Meta"	"Ny meta"
"dota_chatwheel_label_My_Bad"	"Min fejl"
"dota_chatwheel_label_Regret"	"Fortryd"
"dota_chatwheel_label_Relax"	"Rolig nu"
"dota_chatwheel_label_GG"	"GG"
"dota_chatwheel_label_GGWP"	"GGWP"
"dota_chatwheel_label_All_GG"	"(Alle) GG"
"dota_chatwheel_label_All_GGWP"	"(Alle) GGWP"
"dota_chatwheel_label_What_To_Buy"	"Hvad skal jeg købe?"
"dota_chatwheel_label_Im_Retreating"	"Jeg trækker mig tilbage"
"dota_chatwheel_label_Space_Created"	"Pusterum skabt"
"dota_chatwheel_label_Whoops"	"Ups"
"dota_chatwheel_label_Tower_then_Back"	"Tårn og så tilbage"
"dota_chatwheel_label_Barracks_then_Back"	"Barakker og så tilbage"
"dota_chatwheel_label_Ward_Bottom_Rune"	"Ward den nederste rune"
"dota_chatwheel_label_Ward_Top_Rune"	"Ward den øverste rune"
"dota_chatwheel_label_Zeus_Ult"	"Zeus, brug ult"
"dota_chatwheel_header_positioning"	"Positionering"
"dota_chatwheel_header_status"	"Status"
"dota_chatwheel_header_enemy"	"Fjende"
"dota_chatwheel_header_lane"	"Lane"
"dota_chatwheel_header_items"	"Genstande"
"dota_chatwheel_header_neutrals"	"Neutrale"
"dota_chatwheel_header_misc"	"Diverse"
"dota_chatwheel_header_flavor"	"Karakter"
"dota_chatwheel_message_Ok"	"Okay. "
"dota_chatwheel_message_Care"	"Forsigtig!"
"dota_chatwheel_message_GetBack"	"Tilbage!"
"dota_chatwheel_message_NeedWards"	"Vi har brug for wards."
"dota_chatwheel_message_Stun"	"Lam nu!"
"dota_chatwheel_message_Help"	"Hjælp!"
"dota_chatwheel_message_Push"	"Push nu"
"dota_chatwheel_message_GoodJob"	"Godt spillet!"
"dota_chatwheel_message_Missing"	"Mangler!"
"dota_chatwheel_message_Missing_Top"	"Mangler top!"
"dota_chatwheel_message_Missing_Mid"	"Mangler midt!"
"dota_chatwheel_message_Missing_Bottom"	"Mangler bund!"
"dota_chatwheel_message_Go"	"Go!"
"dota_chatwheel_message_Initiate"	"Initier!"
"dota_chatwheel_message_Follow"	"Følg mig"
"dota_chatwheel_message_Group_Up"	"Gruppér"
"dota_chatwheel_message_Spread_Out"	"Spred jer"
"dota_chatwheel_message_Split_Farm"	"Del jer og farm"
"dota_chatwheel_message_Attack"	"Angrib nu!"
"dota_chatwheel_message_BRB"	"Er snart tilbage"
"dota_chatwheel_message_Dive"	"Dive!"
"dota_chatwheel_message_OMW"	"Er på vej"
"dota_chatwheel_message_Get_Ready"	"Vær klar"
"dota_chatwheel_message_Bait"	"Bait"
"dota_chatwheel_message_Heal"	"Hel"
"dota_chatwheel_message_Mana"	"Mana"
"dota_chatwheel_message_OOM"	"Ikke mere mana"
"dota_chatwheel_message_Skill_Cooldown"	"Evner på nedkøling"
"dota_chatwheel_message_Ulti_Ready"	"Ultimate klar"
"dota_chatwheel_message_Enemy_Returned"	"Fjenden er tilbage"
"dota_chatwheel_message_All_Missing"	"Alle fjendtlige helte mangler!"
"dota_chatwheel_message_Enemy_Incoming"	"Indkommende fjende!"
"dota_chatwheel_message_Invis_Enemy"	"Usynlig fjende i nærheden!"
"dota_chatwheel_message_Enemy_Had_Rune"	"Fjenden har runen"
"dota_chatwheel_message_Split_Push"	"Split-push"
"dota_chatwheel_message_Coming_To_Gank"	"Kommer for at ganke"
"dota_chatwheel_message_Request_Gank"	"Anmoder om et gank"
"dota_chatwheel_message_Fight_Under_Tower"	"Kæmp under tårnet"
"dota_chatwheel_message_Deny_Tower"	"Deny tårnet!"
"dota_chatwheel_message_Buy_Courier"	"Køb venligst en kurér"
"dota_chatwheel_message_Upgrade_Courier"	"Kan nogen opgradere kuréren?"
"dota_chatwheel_message_Need_Detection"	"Vi har brug for detektion"
"dota_chatwheel_message_They_Have_Detection"	"De har detektion"
"dota_chatwheel_message_Buy_TP"	"Køb en Teleport Scroll"
"dota_chatwheel_message_Reuse_Courier"	"Anvend kuréren igen"
"dota_chatwheel_message_Deward"	"Deward venligst"
"dota_chatwheel_message_Building_Mek"	"Bygger Mekansm"
"dota_chatwheel_message_Building_Pipe"	"Bygger Pipe"
"dota_chatwheel_message_Stack_And_Pull"	"Stack og pull venligst"
"dota_chatwheel_message_Pull"	"Pull venligst krybene"
"dota_chatwheel_message_Pulling"	"Pull'er kryb"
"dota_chatwheel_message_Stack"	"Stack neutrale"
"dota_chatwheel_message_Jungling"	"Jungler"
"dota_chatwheel_message_Roshan"	"Roshan"
"dota_chatwheel_message_Affirmative"	"Modtaget"
"dota_chatwheel_message_Wait"	"Vent"
"dota_chatwheel_message_Pause"	"Pause venligst!"
"dota_chatwheel_message_Current_Time"	"Nuværende spiltid"
"dota_chatwheel_message_Check_Runes"	"Tjek venligst runerne"
"dota_chatwheel_message_Smoke_Gank"	"Lad os smoke gank'e!"
"dota_chatwheel_message_GLHF"	"Held og lykke, hav det sjovt"
"dota_chatwheel_message_Nice"	"Nice"
"dota_chatwheel_message_Thanks"	"Tak!"
"dota_chatwheel_message_Sorry"	"Undskyld"
"dota_chatwheel_message_No_Give_Up"	"Giv ikke op!"
"dota_chatwheel_message_Just_Happened"	"Det skete lige"
"dota_chatwheel_message_Game_Is_Hard"	"Spillet er svært"
"dota_chatwheel_message_New_Meta"	"Ny meta"
"dota_chatwheel_message_My_Bad"	"Min fejl"
"dota_chatwheel_message_Regret"	"Jeg fortryder med det samme min beslutning"
"dota_chatwheel_message_Relax"	"Rolig nu, du klarer dig fint"
"dota_chatwheel_message_MissingHero"	"%s1 mangler!"
"dota_chatwheel_message_ReturnedHero"	"%s1 er vendt tilbage!"
"dota_chatwheel_message_GG"	"God kamp"
"dota_chatwheel_message_GGWP"	"God kamp, godt spillet"
"dota_chatwheel_message_All_GG"	"God kamp"
"dota_chatwheel_message_All_GGWP"	"God kamp, godt spillet"
"dota_chatwheel_message_What_To_Buy"	"Hvad skal jeg købe?"
"dota_chatwheel_message_Im_Retreating"	"Jeg trækker mig tilbage"
"dota_chatwheel_message_Space_Created"	"Pusterum skabt"
"dota_chatwheel_message_Whoops"	"Ups"
"dota_chatwheel_message_Tower_then_Back"	"Ødelæg tårnet og fald tilbage"
"dota_chatwheel_message_Barracks_then_Back"	"Ødelæg barakkerne og fald tilbage"
"dota_chatwheel_message_Ward_Bottom_Rune"	"Ward den nederste rune"
"dota_chatwheel_message_Ward_Top_Rune"	"Ward den øverste rune"
"dota_chatwheel_message_Zeus_Ult"	"Zeus, brug ult nu!"
"dota_settings_hotkeys"	"Genvejstaster"
"dota_settings_options"	"Indstillinger"
"dota_settings_audio"	"Lyd"
"dota_settings_voice"	"Tale"
"dota_settings_volume"	"Lydstyrke"
"dota_settings_video"	"Video"
"dota_settings_resetkeys"	"Nulstil genvejstaster..."
"dota_settings_legacykeys"	"Brug oprindelige taster"
"dota_settings_abilities"	"Evner"
"dota_settings_abilities_hero"	"Helt"
"dota_settings_abilities_neutrals"	"Neutrale"
"dota_settings_abilities_courier"	"Kurér"
"dota_settings_abilities_primary1"	"1"
"dota_settings_abilities_primary2"	"2"
"dota_settings_abilities_primary3"	"3"
"dota_settings_abilities_secondary1"	"4"
"dota_settings_abilities_secondary2"	"5"
"dota_settings_abilities_neutral1"	"1"
"dota_settings_abilities_neutral2"	"2"
"dota_settings_abilities_neutral3"	"3"
"dota_settings_abilities_neutral4"	"4"
"dota_settings_abilities_courier1"	"1"
"dota_settings_abilities_courier2"	"2"
"dota_settings_abilities_courier3"	"3"
"dota_settings_abilities_courier4"	"4"
"dota_settings_abilities_courier5"	"5"
"dota_settings_abilities_courier6"	"6"
"dota_settings_abilities_ultimate"	"U"
"dota_settings_cast"	"Kast"
"dota_settings_autocast"	"Auto-kast"
"dota_settings_quickcast"	"Hurtig-kast"
"dota_settings_mirror"	"Afspejl genvejstaster fra heltepanelet"
"dota_settings_abilitylearn"	"Lær evne"
"dota_settings_upgradestats"	"Opgrader egenskaber"
"dota_settings_unitactions"	"Enhedshandlinger"
"dota_settings_attack"	"Ryk og angrib / Tvangsangreb"
"dota_settings_move"	"Flyt"
"dota_settings_stop"	"Stop"
"dota_settings_holdposition"	"Hold position"
"dota_settings_selecthero"	"Vælg helt"
"dota_settings_selectall"	"Vælg alle enheder"
"dota_settings_selectallothers"	"Vælg alle andre enheder"
"dota_settings_selectcourier"	"Vælg kurér"
"dota_settings_courierdeliver"	"Kurér: Lever genstande"
"dota_settings_courierhaste"	"Kurér: Hastighedsforøgelse"
"dota_settings_useactionitem"	"Handlingsgenstand"
"dota_settings_herotaunt"	"Hångenstand"
"dota_settings_items"	"Genstande"
"dota_settings_openshop"	"Åbn butik"
"dota_settings_purchasequickbuy"	"Køb hurtigkøb"
"dota_settings_purchasesticky"	"Køb fast genstand"
"dota_settings_grabstashitems"	"Tag lager-genstande"
"dota_settings_camera"	"Kamera"
"dota_settings_cameraactions"	"Kamerahandlinger"
"dota_settings_cameraup"	"Kamera fremad"
"dota_settings_cameradown"	"Kamera bagud"
"dota_settings_cameraleft"	"Kamera til venstre"
"dota_settings_cameraright"	"Kamera til højre"
"dota_settings_cameragrip"	"Kamera-greb"
"dota_settings_recentevent"	"Vis nylige begivenheder"
"dota_settings_inspectheroinworld"	"Fremvisningstilstand"
"dota_settings_chat"	"Chat"
"dota_settings_phrases"	"Sætninger"
"dota_settings_chatwheel_page"	"Chat-hjul"
"dota_settings_chatteam"	"Chat med holdet"
"dota_settings_chatglobal"	"Chat med alle"
"dota_settings_chatvoice_party"	"Stemme (gruppe)"
"dota_settings_chatvoice_team"	"Stemme (hold)"
"dota_settings_chatwheel_show"	"Chat-hjul"
"dota_settings_playeractions"	"Spillerhandlinger"
"dota_settings_activateglyph"	"Aktiver glyf"
"dota_settings_scoreboardtoggle"	"Pointtavle"
"dota_settings_pause"	"Pause"
"dota_settings_screenshot"	"Skærmbillede"
"dota_settings_console"	"Konsol"
"dota_settings_controlgroups"	"Kontrolgrupper"
"dota_settings_controlgroupsadditional"	"Flere kontrolgrupper"
"dota_settings_controlgroupcycle"	"Skift imellem kontrolgrupper"
"dota_settings_group1"	"Gruppe 1"
"dota_settings_group2"	"Gruppe 2"
"dota_settings_group3"	"Gruppe 3"
"dota_settings_group4"	"Gruppe 4"
"dota_settings_group5"	"Gruppe 5"
"dota_settings_group6"	"Gruppe 6"
"dota_settings_group7"	"Gruppe 7"
"dota_settings_group8"	"Gruppe 8"
"dota_settings_group9"	"Gruppe 9"
"dota_settings_group10"	"Gruppe 10"
"dota_settings_advancedpanel_goto"	"Avanceret"
"dota_settings_standardpanel_goto"	"Standard"
"dota_settings_spectatorandreplay"	"Styring: Tilskuer/gengivelse"
"dota_settings_spectatorandreplay_pt2"	"Styring: Tilskuer/gengivelse fortsat"
"dota_settings_spectatorcameraup"	"Tilskuerkamera fremad"
"dota_settings_spectatorcameradown"	"Tilskuerkamera tilbage"
"dota_settings_spectatorcameraleft"	"Tilskuerkamera venstre"
"dota_settings_spectatorcameraright"	"Tilskuerkamera højre"
"dota_settings_spectatorcameragrip"	"Tilskuerkamera-greb"
"dota_settings_spectatorpause"	"Tilskuerpause"
"dota_settings_spectatorchat"	"Tilskuerchat"
"dota_settings_spectatorscoreboard"	"Tilskuerpointtavle"
"dota_settings_spectatorbroadcastermenu"	"Åbn broadcaster-menu"
"dota_settings_spectatorincreasereplayspeed"	"Øg gengivelseshastighed"
"dota_settings_spectatordecreasereplayspeed"	"Formindsk gengivelseshastighed"
"dota_settings_spectatorstatsharvest"	"Tilskuerstatistik for guld og XP"
"dota_settings_spectatorstatsitem"	"Tilskuer-genstandsstatistikker"
"dota_settings_spectatorstatsgold"	"Tilskuer-guldgraf"
"dota_settings_spectatorstatsxp"	"Tilskuer-XP-graf"
"dota_settings_spectatorstatsfantasy"	"Fantasistatstikker for tilskuere"
"dota_settings_spectatorfowboth"	"Tilskuer-FOW begge hold"
"dota_settings_spectatorfowradient"	"Tilskuer-FOW Radiant"
"dota_settings_spectatorfowdire"	"Tilskuer-FOW Dire"
"dota_settings_statsdropdown"	"Statistik-rullemenu"
"dota_settings_spectatordropdown_sort"	"Skift sortering"
"dota_settings_spectatordropdown_close"	"Ryd kategori"
"dota_settings_spectatordropdown_kda"	"Drab/Dødsfald/Assisterede"
"dota_settings_spectatordropdown_lasthits_denies"	"Last hits/denies"
"dota_settings_spectatordropdown_level"	"Heltelevel"
"dota_settings_spectatordropdown_xp_per_min"	"XP per minut"
"dota_settings_spectatordropdown_gold"	"Nuværende guld"
"dota_settings_spectatordropdown_totalgold"	"Nettoværdi"
"dota_settings_spectatordropdown_gold_per_min"	"Guld per minut"
"dota_settings_spectatordropdown_buyback"	"Tilbagekøbsstatus"
"dota_settings_spectatordropdown_fantasy"	"Fantasi-score"
"dota_settings_coaching"	"Coaching"
"dota_settings_spectatorcoach_viewtoggle"	"Coach: Skift mellem elevperspektiv"
"dota_settings_keyboardtemplate"	"Vælg en tastaturskabelon"
"dota_settings_or"	"Eller"
"dota_settings_cancel"	"Annuller"
"dota_settings_apply"	"Anvend"
"dota_settings_game"	"Spil"
"dota_settings_autoattack"	"Auto-angreb"
"dota_settings_attackafterspell"	"Auto-angreb efter evne"
"dota_settings_autopurchase"	"Auto-køb genstande"
"dota_settings_autoselect"	"Auto-vælg hidkaldte enheder"
"dota_settings_doubletapself"	"Dobbelttryk evne for at kaste på dig selv"
"dota_settings_unifiedorders"	"Forenede enhedsordrer"
"dota_settings_teleportrequireshalt"	"Teleport kræver stop"
"dota_settings_herofinder"	"Hold ALT nede for at fremhæve helt"
"dota_settings_reducedflash"	"Reducerede lysglimt"
"dota_settings_minimap"	"Minikort"
"dota_settings_minimapsimplecolors"	"Brug simple farver på minikort"
"dota_settings_minimaphidebackground"	"Skjul minikort-baggrund"
"dota_settings_minimapshowheroicon"	"Vis helteikoner på minikort med ALT"
"dota_settings_minimapalwaysshowname"	"Minikort: ALT altid til"
"dota_settings_minimapflip"	"Vis minikort på højre"
"dota_settings_cameraspeed"	"Kamerahastighed"
"dota_settings_cameraedgepan"	"Kantpanorering"
"dota_settings_camerascreenshake"	"Slå skærm-rysten til"
"dota_settings_profile"	"Profil"
"dota_settings_hideprofile"	"Skjul Dota- og Steam-profil"
"dota_settings_exposematchdata"	"Offentliggør kampdata"
"dota_settings_ignorenonfriendparties"	"Bloker gruppeinvitationer fra ikke-venner"
"dota_settings_allowtradeinvitesheader"	"Bytteinvitationer fra:"
"dota_settings_trade_guildandfriends"	"Guild-medlemmer og venner"
"dota_settings_trade_friends"	"Kun venner"
"dota_settings_trade_anyone"	"Alle"
"dota_settings_network"	"Netværk"
"dota_settings_networkquality"	"Netværkskvalitet"
"dota_settings_networkquality_low"	"Lav"
"dota_settings_networkquality_high"	"Høj"
"dota_settings_usenativeresolution"	"Brug min skærms aktuelle opløsning"
"dota_settings_customresolution"	"Brug avancerede indstillinger"
"dota_settings_resolution"	"Opløsning"
"dota_settings_rendering"	"Rendering"
"dota_settings_aspectratio"	"Billedformat"
"dota_settings_aspectratio43"	"4:3"
"dota_settings_aspectratio169"	"16:9"
"dota_settings_aspectratio1610"	"16:10"
"dota_settings_resolution_size"	"Størrelse"
"dota_settings_fullscreen"	"Eksklusiv fuldskærm"
"dota_settings_window"	"I vindue"
"dota_settings_borderless"	"Kantløs vindue"
"dota_settings_videodefaults"	"Nultil til standarder"
"dota_settings_fastestvideo"	"Hurtigste"
"dota_settings_appearancevideo"	"Flotteste"
"dota_settings_advancedvideosettings"	"Brug avancerede indstillinger"
"dota_settings_antialiasing"	"Udglatning"
"dota_settings_waterquality"	"Høj vandkvalitet"
"dota_settings_fog"	"Atmosfærisk tåge"
"dota_settings_animateportrait"	"Animer portræt"
"dota_settings_ambientocclusion"	"Omgivende selvskygning"
"dota_settings_vsync"	"VSync"
"dota_settings_renderquality"	"Renderingskvalitet af spilskærm"
"dota_settings_shadowquality"	"Skyggekvalitet"
"dota_settings_shadowquality_low"	"Lav"
"dota_settings_shadowquality_med"	"Mellem"
"dota_settings_shadowquality_high"	"Høj"
"dota_settings_texturequality"	"Teksturkvalitet"
"dota_settings_texturequality_low"	"Lav"
"dota_settings_texturequality_med"	"Mellem"
"dota_settings_texturequality_high"	"Høj"
"dota_settings_mastervolume"	"Primær lydstyrke"
"dota_settings_gamevolume"	"Spillyde"
"dota_settings_musicvolume"	"Musik"
"dota_settings_voicevolume"	"Tale"
"dota_settings_gamevoicevolume"	"Enhedsreplikker"
"dota_settings_audiodefaults"	"Lydstandarder"
"dota_settings_defaultaudio"	"Standard"
"dota_settings_sounddevice"	"Lydenhed:"
"dota_settings_headphones"	"Hovedtelefoner"
"dota_settings_2speakers"	"2 højtalere"
"dota_settings_4speakers"	"4 højtalere"
"dota_settings_5speakers"	"5.1 højtalere"
"dota_settings_7speakers"	"7.1 højtalere"
"dota_settings_playsoundinbackground"	"Afspil lyd når minimeret"
"dota_settings_chatsounds"	"Chatbesked-lyd"
"dota_settings_mutecobroadcasters"	"Dæmp med-broadcastere"
"dota_settings_enhancestereo"	"Forbedret stereo"
"dota_settings_unitspeeh"	"Enhedstale"
"dota_settings_unitspeech_off"	"Fra"
"dota_settings_unitspeech_events"	"Begivenheder"
"dota_settings_unitspeech_all"	"Alle"
"OS_Default_Device"	"Standardenhed"
"DOTA_Keybind_ARROW"	"Pil (standard)"
"DOTA_Keybind_WASD"	"WASD"
"DOTA_Keybind_MMO"	"MMO"
"DOTA_Keybind_LEGACY"	"Oprindelige taster"
"DOTA_Keybind_LOL"	"League of Legends"
"DOTA_Keybind_HON"	"Heroes of Newerth"
"DOTA_Keybind_SMITE"	"Smite"
"DOTA_Hotkeys_Tooltip_HeroStop"	"Afbryd din nuværende handling."
"DOTA_Hotkeys_Tooltip_HeroHold"	"Afbryd din nuværende handling og bliv stående."
"DOTA_Hotkeys_Tooltip_HeroSelect"	"Vælg din helt."
"DOTA_Hotkeys_Tooltip_SelectAll"	"Vælg alle enheder du kontrollerer."
"DOTA_Hotkeys_Tooltip_SelectAllOthers"	"Vælg alle andre enheder du kontrollerer. (Din helt vælges ikke.)"
"DOTA_Hotkeys_Tooltip_CourierSelect"	"Vælg kuréren."
"DOTA_Hotkeys_Tooltip_CourierDeliver"	"Få kuréren til at levere genstandene i dit lager til dig."
"DOTA_Hotkeys_Tooltip_CourierHaste"	"Aktiver en hastighedsforøgelse på din kurér, når evnen er tilgængelig."
"DOTA_Hotkeys_Tooltip_UseActionItem"	"Brug handlingsgenstand."
"DOTA_Hotkeys_Tooltip_HeroTaunt"	"Brug dit helte-hån. Tilgængelig som en udstyrbar genstand."
"DOTA_Hotkeys_Tooltip_ShopToggle"	"Åbn butikspanelet."
"DOTA_Hotkeys_Tooltip_PurchaseQuickbuy"	"Køb den næste genstand i dit hurtigkøb-felt, hvis du har råd."
"DOTA_Hotkeys_Tooltip_GrabStashItems"	"Overfør alle genstande fra dit lager til din helt."
"DOTA_Hotkeys_Tooltip_RecentEvent"	"Flyt kameraet til den seneste begivenhed i banen."
"DOTA_Hotkeys_Tooltip_InspectHeroInWorld"	"Se en enhed fra et tæt perspektiv."
"DOTA_Hotkeys_Tooltip_ChatTeam"	"Send en besked til alle på dit hold."
"DOTA_Hotkeys_Tooltip_ChatGlobal"	"Send en besked til alle i dit nuværende spil. (Tilføjer SHIFT-modifikator til holdchat-genvejstasten)"
"DOTA_Hotkeys_Tooltip_ChatVoiceParty"	"Brug din mikrofon til at kommunikere med alle gruppemedlemmer. Hvis sat til åben mikrofon, virker dette også på dashbordet."
"DOTA_Hotkeys_Tooltip_ChatWheel"	"Åbner chat-hjulet til let kommunikation via ofte brugte udtryk."
"DOTA_Hotkeys_Tooltip_CameraGrip"	"Hold nede og træk omkring i banen for at flytte kameraet. Tasten er også bundet til den midterste museknap."
"DOTA_Hotkeys_Tooltip_ActivateGlyph"	"Aktiverer Glyph of Fortification som gør dit holds bygninger usårlige i 5 sekunder."
"DOTA_Hotkeys_Tooltip_ScoreboardToggle"	"Åbner pointtavlen i spillet."
"DOTA_Hotkeys_Tooltip_Pause"	"Sæt et igangværende spil på pause eller genoptag det."
"DOTA_Hotkeys_Tooltip_ScreenshotSettings"	"Tag et skærmbillede af spillet."
"DOTA_Hotkeys_Tooltip_Console"	"Åbn konsollen. (Kun for avancerede brugere)"
"DOTA_Hotkeys_Tooltip_ControlGroupCycle"	"Skift mellem hver enheder i en valgt gruppe."
"DOTA_Hotkeys_Tooltip_Group"	"Vælg en forudindstillet enhedsgruppe. For at angive en kontrolgruppe, vælg da de ønskede enheder og hold CTRL nede + en af disse gruppe-genvejstaster."
"DOTA_Settings_Tooltip_AutoPurchase"	"Køb den næste genstand i listen over anbefalede genstande, når du har råd til den."
"DOTA_Settings_Tooltip_Screenshake"	"Nogle evner og lammelser ryster kameraet."
"DOTA_create_bot_practice_desc"	"Spil en kamp mod AI-modstandere. Du kan bruge matchmaking til at spille med andre menneskelige holdkammerater eller udfylde dine tomme holdpladser med bots."
"DOTA_Lobby_BotDifficulty"	"Bot-sværhedsgrad"
"DOTA_Lobby_BotDifficulty_no_bot"	"Ingen bot"
"DOTA_Lobby_BotDifficulty_passive"	"Passiv"
"DOTA_Lobby_BotDifficulty_easy"	"Let"
"DOTA_Lobby_BotDifficulty_medium"	"Medium"
"DOTA_Lobby_BotDifficulty_hard"	"Svær"
"DOTA_Lobby_BotDifficulty_unfair"	"Urimelig"
"DOTA_Lobby_BotTeam"	"Vælg hold"
"DOTA_create_bot_practice_solo"	"Solo"
"DOTA_create_bot_practice_coop"	"Co-Op"
"DOTA_Lobby_BotDifficulty_bot_passive"	"Passiv bot"
"DOTA_Lobby_BotDifficulty_bot_easy"	"Let bot"
"DOTA_Lobby_BotDifficulty_bot_medium"	"Medium bot"
"DOTA_Lobby_BotDifficulty_bot_hard"	"Svær bot"
"DOTA_Lobby_BotDifficulty_bot_unfair"	"Urimelig bot"
"dota_lobby_title"	"{s:lobby_name}"
"dota_lobby_title_local_game"	"Lokal lobby"
"dota_lobby_title_default"	"Lobby"
"lobby_row_player_name"	"{s:player_name}"
"dota_lobby_row_game_name"	"{s:game_name}"
"dota_lobby_row_slots"	"{s:slots}"
"dota_lobby_row_game_mode"	"{s:game_mode}"
"dota_lobby_row_join"	"Tilslut"
"dota_lobby_row_leave"	"Forlad"
"dota_lobby_coaches_title"	"Coaches"
"dota_lobby_browser_all_game_modes"	"Alle spiltilstande"
"dota_lobby_browser_title"	"Gennemse Dota-lobbyer"
"dota_lobby_browser_num_available"	"( {d:lobbies_available} tilgængelig )"
"dota_lobby_browser_no_lobbies"	"Ingen lobbyer fundet"
"dota_lobby_browser_no_matching_lobbies"	"Ingen lobbyer der matcher din søgning"
"dota_lobby_browser_updating"	"Opdaterer lobbyliste..."
"dota_lobby_browser_search_placeholder"	"Søg lobbyer"
"dota_lobby_browser_game_mode"	"Spiltilstand"
"dota_lobby_browser_refresh"	"Opdater"
"dota_lobby_browser_filter_title"	"Filtrer lobbyer"
"dota_lobby_submit_filter"	"Anvend"
"dota_popup_lobby_password_title"	"Indtast lobbyadgangskode"
"DOTA_AttackCapability_Melee"	"Nærkamp"
"DOTA_AttackCapability_Ranged"	"Afstandskamp"
"DOTA_Item_OnMarket"	"Marked"
"DOTA_Items_DefaultSet"	"Standardsæt"
"DOTA_Items_SetEquipped_Label"	"Udstyret"
"DOTA_EquippedItem_Label"	"Udstyret"
"DOTA_PreviewingItem_Label"	"Forhåndsviser"
"DOTA_EquippedItem_Rarity"	"{s:equipped_econ_set_rarity}"
"DOTA_EquippedItem_SetName"	"{s:equipped_econ_set_name}"
"DOTA_EquippedItem_Style"	"{i:equipped_econ_set_style_count} stil(e)"
"DOTA_EquippedItem_Button_Details"	"{s:equipped_details_button_text}"
"DOTA_EquippedItem_Customize"	"Tilpas"
"DOTA_EquippedItem_CustomSet"	"Tilpas sæt"
"DOTA_EquippedItem_Equip"	"Udstyr"
"DOTA_EquippedItem_Unpack_And_Equip"	"Pak ud og udstyr"
"DOTA_EquippedItem_Details"	"{s:equipped_econ_set_type_name}-detaljer"
"DOTA_EquippedItem_Purchase_Button"	"Køb"
"DOTA_EquippedItem_Marketplace_Button"	"Marked"
"DOTA_EquippedItem_BundleName"	"I bundtet \"{s:equipped_econ_set_bundle}\""
"DOTA_EquippedItem_FilterText"	"Forhåndsviser"
"DOTA_EquippedItem_SaleAmount"	"-{i:equipped_econ_set_sale_amount}%"
"DOTA_EquippedItem_RegularSetPrice"	"{s:equipped_econ_regular_set_price}"
"DOTA_EquippedItem_SetPrice"	"{s:equipped_econ_set_price}"
"DOTA_EquippedItem_TreasurePrice"	"{s:equipped_econ_treasure_price}"
"DOTA_HeroDemo_Button"	"Afprøv {s:econ_item_category_name}"
"DOTA_HeroDemo_Button_Tooltip"	"Start demotilstanden for at afprøve dette genstandssæt eller denne helts evner"
"DOTA_HeroDemo_Button_Return"	"Vend tilbage til demoen"
"DOTA_HeroDemo_Button_DBQuit"	"Afslut demo"
"DOTA_EquippedItem_Bundle"	"Bundt"
"DOTA_EquippedItem_ItemSet"	"Sæt"
"DOTA_EquippedItem_Item"	"Genstand"
"DOTA_EconItemSet_Name"	"{s:econ_set_name}"
"DOTA_EconItemSet_Rarity"	"{s:econ_set_rarity}"
"DOTA_EconItemSet_Status"	"{s:econ_set_status}"
"DOTA_EconItemSet_Price"	"{s:econ_set_price}"
"DOTA_EconItemSet_SaleAmount"	"-{i:econ_sale_amount}%"
"DOTA_EconItemSet_DeveloperOnly"	"Ikke offentlig"
"DOTA_HeroRole_Carry"	"Carry"
"DOTA_HeroRole_Support"	"Support"
"DOTA_HeroRole_Nuker"	"Nuker"
"DOTA_HeroRole_Disabler"	"Disabler"
"DOTA_HeroRole_Jungler"	"Jungler"
"DOTA_HeroRole_Durable"	"Durable"
"DOTA_HeroRole_Escape"	"Escape"
"DOTA_HeroRole_LaneSupport"	"Lane Support"
"DOTA_HeroRole_Pusher"	"Pusher"
"DOTA_HeroRole_Initiator"	"Initiator"
"DOTA_HeroRole_Description_Carry"	"Vil blive mere nyttig senere i spillet, hvis givet en tilstrækkelig guld-fordel."
"DOTA_HeroRole_Description_Jungler"	"Kan effektivt farme fra neutrale kryb inde i junglen tidligt i spillet."
"DOTA_HeroRole_Description_Durable"	"Har evnen til at holde længere i holdkampe."
"DOTA_HeroRole_Description_LaneSupport"	"Hjælpsom i det tidlige stadie af spillet til at beskytte dit holds carry og lade dem farme."
"DOTA_HeroRole_Description_Initiator"	"God til at begynde en holdkamp"
"DOTA_HeroGrid_OptionCategory_Role"	"Roller:"
"DOTA_HeroGrid_OptionCategory_Attributes"	"Attributter:"
"DOTA_HeroGrid_OptionCategory_AttackType"	"Angrebstype:"
"DOTA_HeroLoadout_PreviousHeroName"	"{s:previous_hero_name}"
"DOTA_HeroLoadout_NextHeroName"	"{s:next_hero_name}"
"DOTA_HeroLoadout_CurrentHeroName"	"{s:hero_name}"
"DOTA_HeroLoadout_AttackType"	"{s:hero_attack_type}"
"DOTA_HeroLoadout_HeroFilterName"	"Helt"
"DOTA_HeroLoadout_Search"	"Søg efter {s:hero_name}-genstande"
"DOTA_HeroCustomize_Title"	"Tilpas helt"
"DOTA_HeroCustomize_OwnedItems"	"Ejede genstande"
"DOTA_HeroCustomize_Slot"	"Plads"
"DOTA_HeroCustomize_SlotName"	"{s:slot_name}"
"DOTA_HeroCustomize_SlotEquippedItemName"	"{s:equipped_item_name}"
"DOTA_HeroCustomize_DefaultItemName"	"Standard genstand"
"DOTA_HeroCustomize_PreviewItemName"	"{s:preview_item_name}"
"DOTA_HeroCustomize_PreviewStyle"	"{s:preview_style_name}"
"DOTA_HeroCustomize_PreviewItemSlot"	"{s:preview_item_slot}"
"DOTA_HeroCustomize_Rarity"	"{s:preview_item_rarity}"
"DOTA_UIEconItem_StyleIndex"	"{i:style_index}"
"dota_ready_up_num_accepted"	"{i:num_accepted} / {i:total_players} accepterede"
"returning_top_of_queue"	"Vender tilbage til matchmaking med høj prioritet..."
"returning_to_lobby"	"Vender tilbage til lobbyen for at finde flere spillere..."
"GC_reconnecting"	"Genopretter forbindelse til Dota 2-spilkoordinatoren..."
"GC_nosteam"	"Mistede forbindelsen til Steam"
"GC_searching"	"Søger efter Dota 2-spilkoordinatoren..."
"GC_noconnection"	"Ikke tilsluttet til Dota 2-spilkoordinatoren."
"GC_connecting"	"Tilslutter til Dota 2-spilkoordinatoren..."
"GC_connected"	"Forbundet til Dota 2-spilkoordinatoren."
"GC_down"	"Dota 2-spilkoordinatoren er midlertidigt offline."
"GC_Network_Full"	"Dota 2-spilkoordinatoren er fuld lige nu."
"GC_Queue_Position"	"Dota 2-spilkoordinatoren er på nuværende tidspunkt fuld. Kø-nummer: {i:gc_queue_position}"
"GC_Queue_Wait_Time"	"Dota 2-spilkoordinatoren er på nuværende tidspunkt fuld. kø-nummer: {i:gc_queue_position}, anslået ventetid: {s:gc_queue_wait_time}"
"GC_Wait_Time"	"Anslået ventetid: %s1"
"GC_Wait_Time_Unknown"	"Ukendt"
"dota_practice_vs_bots"	"Begynd træning mod bots"
"dota_practice_vs_bots_difficulty"	"Bot-sværhedsgrad"
"dota_practice_vs_bots_team"	"Spil som hvilket hold?"
"DOTA_practice_vs_bots_team_radiant"	"Radiant"
"DOTA_practice_vs_bots_team_dire"	"Dire"
"DOTA_practice_vs_bots_team_random"	"Tilfældig"
"DOTA_EmoticonUpsell"	"Emotikoner oplåses ved køb af specifikke heltegenstande eller turneringsbilletter."
"DOTA_CurrentTime"	"{t:t:current_time}"
"DOTA_MonthlyPlayers"	"{s:users_last_month}"
"DOTA_MonthlyPlayersLabel"	"Unikke spillere i den sidste måned"
"DOTA_CurrentPlayers"	"{s:current_users}"
"DOTA_CurrentPlayersLabel"	"Spillere i spil nu"
"DOTA_Search_NoResults"	"Ingen resultater"
"DOTA_Search_ItemShortDescription"	"<span class=\"ItemRarityColor\">{s:item_rarity}</span> {s:item_slot}"
"join_error_already_in_game"	"Kunne ikke tilslutte til træningslobby, da du allerede er i et spil."
"join_error_invalid_lobby"	"Lobbyen du angav eksisterer ikke længere."
"join_error_incorrect_password"	"Forkert adgangskode."
"join_error_access_denied"	"Adgang nægtet."
"join_error_generic"	" "
"join_error_in_team_party"	"Kunne ikke deltage i træningslobby. Du skal opløse din holdgruppe, før du deltager i træningsspil."
"join_error_lobby_full"	"Lobbyen er fuld."
"join_error_timed_out"	"Anmodningen udløb."
"DOTA_Friends_Ready_To_Play"	"Åbne spil"
"DOTA_Friend_Finding_Match"	"Finder kamp..."
"DOTA_Friend_In_Match"	"I kamp"
"DOTA_Friend_Solo_Open_Party"	"{s:player_name} vil gerne spille"
"DOTA_Friend_In_Party_Open"	"{s:player_name} er i en åben gruppe"
"DOTA_Friend_Solo_Open_Party_Self"	"Du søger efter gruppemedlemmer"
"DOTA_Friend_In_Open_Party_Self"	"Du er i en åben gruppe"
"DOTA_Friends_In_Party_Open"	"{d:num_friends} venner i en åben gruppe"
"DOTA_Friend_Lobby_Mode_Self"	"Du er i en {s:game_mode}-lobby"
"DOTA_Friend_Lobby_Mode_1_Friend"	"{s:player_name} i {s:game_mode}-lobby"
"DOTA_Friend_Lobby_Mode_N_Friends"	"{d:num_friends} venner i {s:game_mode}-lobby"
"DOTA_Friend_Lobby_Mode_Small"	"{s:game_mode}-lobby"
"DOTA_Friend_Lobby_Players"	"{d:player_count} / {d:max_player_count}"
"DOTA_Friend_Lobby_Join_Button"	"{s:join_button_text}"
"DOTA_Friend_Lobby_Friend_Count"	"+{d:extra_friend_count}"
"DOTA_Friend_Invite_To_Party"	"Inviter til gruppe"
"DOTA_Friend_SuggestInviteToParty"	"Foreslå invitation til gruppe"
"DOTA_Request_Join_Party"	"Anmod om at tilslutte gruppe"
"DOTA_Request_Merge_Parties"	"Anmod om at sammenflette grupper"
"DOTA_Request_Merge_Parties_NotLeader"	"Gruppelederen kan anmode om at sammenflette grupper."
"DOTA_Friend_PartyInvitePending"	"Gruppeinvitation afventer"
"DOTA_Friend_PartyInvitePending_Leader"	"Gruppeinvitation afventer<br/>Klik for at annullere invitation"
"DOTA_Friend_JoinParty"	"Tilslut gruppe"
"DOTA_Friend_Watch"	"Se på"
"DOTA_PartyVisTooltip_SoloTitleOpen"	"Vil gerne spille"
"DOTA_PartyMerge_Error_NO_SUCH_GROUP"	"Gruppe eksisterer ikke længere."
"DOTA_PartyMerge_Error_OTHER_GROUP_NOT_OPEN"	"Gruppen er ikke åben for tilslutnings-/sammenfletsanmodninger."
"DOTA_Feed_Timestamp_Recently"	"Lige nu"
"DOTA_Feed_Timestamp_MinutesAgo"	"{i:value} minutter siden"
"DOTA_Feed_Timestamp_HourAgo"	"{i:value} time siden"
"DOTA_Feed_Timestamp_HoursAgo"	"{i:value} timer siden"
"DOTA_Feed_Timestamp_Yesterday"	"I går"
"DOTA_Feed_Timestamp_Date"	"{s:day}. {s:month}"
"dota_lobby_type_general"	"Ikke rangeret"
"dota_lobby_type_practice"	"Træning"
"dota_lobby_type_practice_game_mode_custom"	"Tilpasset spil"
"dota_lobby_type_tournament"	"Turnering"
"dota_lobby_type_coop_bot"	"Co-op bot"
"dota_lobby_type_competitive"	"Rangeret"
"dota_lobby_type_casual_1v1"	"1v1-kamp"
"dota_lobby_unknown"	"Ukendt"
"DOTA_Lobby_No_Players_Title"	"INGEN SPILLERE PÅ ET HOLD"
"DOTA_Lobby_No_Players_Desc"	"Du skal have mindst én spiller på Radiant- eller Dire-holdet."
"dota_match_result_won"	"Vandt"
"dota_match_result_lost"	"Tabte"
"dota_match_result_none"	"???"
"dota_social_feed_loading"	"Indlæser..."
"DOTA_LoadingPlayerUnknown"	"-"
"DOTA_LoadingPlayerLoading"	"Indlæser..."
"DOTA_LoadingPlayerFullyConnected"	"Klar"
"DOTA_LoadingPlayerFailed"	"Mislykket"
"LoadingScreenTimer"	"{t:d:countdown_timer_seconds}"
"HeroSelectionTimer"	"{i:timer_seconds}"
"LoadingScreenMapInfo"	"Bane: {s:map_name}"
"LoadingScreenPlayersInfo"	"Spillere: {i:players_loaded}/{i:players_total}"
"LoadingScreenSpectatorsInfo"	"Tilskuere: {i:spectators_loaded}/{i:spectators_total}"
"custom_end_screen_victory_message"	"{s:winning_team_name} sejrede!"
"custom_end_screen_legend_player"	"Spiller"
"custom_end_screen_legend_level"	"Level"
"custom_end_screen_legend_hero"	"Helt"
"custom_end_screen_legend_kills"	"K"
"custom_end_screen_legend_deaths"	"D"
"custom_end_screen_legend_assists"	"A"
"custom_end_screen_legend_items"	"Genstande"
"custom_end_screen_legend_gold"	"Guld"
"custom_end_screen_legend_team_score"	"Score"
"custom_scoreboard_hero_name_and_desc"	"Lvl. {i:hero_level} {s:hero_name}"
"CustomEndScreenClose"	"Luk"
"DOTA_Armory_Category_Heroes"	"Helte"
"DOTA_Armory_Category_Couriers"	"Kurérer"
"DOTA_Armory_Category_Pets"	"Kæledyr"
"DOTA_Armory_Category_World"	"Verden"
"DOTA_Armory_Category_Wards"	"Wards"
"DOTA_Armory_Category_Weather"	"Vejreffekter"
"DOTA_Armory_Category_Effigies"	"Afbildninger"
"DOTA_Armory_Category_Interface"	"Grænseflade"
"DOTA_Armory_Category_Emoticons"	"Emotikoner"
"DOTA_Armory_Category_LoadingScreens"	"Indlæsningsskærme"
"DOTA_Armory_Category_HUDs"	"HUDs"
"DOTA_Armory_Category_CursorPacks"	"Markørpakker"
"DOTA_Armory_Category_Audio"	"Lyd"
"DOTA_Armory_Category_VoicePacks"	"Stemmepakker"
"DOTA_Armory_Category_AnnouncerPacks"	"Kommentatorpakker"
"DOTA_Armory_Category_Music"	"Musik"
"DOTA_Armory_Category_All"	"Alle"
"DOTA_Armory_Category_Other"	"Andet"
"DOTA_Armory_Category_View"	"Kategorivisning"
"DOTA_Armory_Filter"	"Angiv filter"
"DOTA_Armory_SortBy"	"Sorter efter:"
"DOTA_Armory_SortBy_Rarity"	"Sjældenhed"
"DOTA_Armory_SortBy_Quality"	"Kvalitet"
"DOTA_Armory_SortBy_Name"	"Navn"
"DOTA_Armory_SortBy_Recent"	"Dato anskaffet"
"DOTA_Armory_SortBy_Sockets"	"Antal af indfatninger"
"DOTA_Armory_ContextMenu_Preview"	"Genstandsoplysninger"
"DOTA_Armory_ContextMenu_PreviewSet"	"Forhåndsvis hele sættet"
"DOTA_Armory_ContextMenu_Equip"	"Udstyr genstand"
"DOTA_Armory_ContextMenu_Unequip"	"Tag genstand af"
"DOTA_Armory_ContextMenu_Socketing"	"Indfatning"
"DOTA_Armory_ContextMenu_GiftWrap"	"Pak genstand ind"
"DOTA_Armory_ContextMenu_Delete"	"Slet"
"dota_page_match_details_loading"	"Indlæser kamp..."
"dota_page_match_details_victory"	"Vinder: {s:winner}"
"dota_page_match_details_legend_player"	"Spiller"
"dota_page_match_details_legend_level"	"Level"
"dota_page_match_details_legend_hero"	"Helt"
"dota_page_match_details_legend_kills"	"K"
"dota_page_match_details_legend_deaths"	"D"
"dota_page_match_details_legend_assists"	"A"
"dota_page_match_details_legend_items"	"Genstande"
"dota_page_match_details_legend_gold"	"Guld"
"dota_page_match_details_legend_last_hits"	"LH"
"dota_page_match_details_legend_denies"	"DN"
"dota_page_match_details_legend_gold_per_min"	"GPM"
"dota_page_match_details_legend_xp_per_min"	"XPM"
"dota_page_match_details_legend_winner_tooltip"	"Vinderhold"
"dota_page_match_details_legend_kills_tooltip"	"Drab"
"dota_page_match_details_legend_deaths_tooltip"	"Dødsfald"
"dota_page_match_details_legend_assists_tooltip"	"Assisterede"
"dota_page_match_details_legend_gold_per_min_tooltip"	"Guld per minut"
"dota_page_match_details_legend_xp_per_min_tooltip"	"XP per minut"
"dota_page_match_details_header_league_name"	"Liganavn"
"dota_page_match_details_header_custom_game_map_name"	"Banenavn"
"dota_page_match_details_header_match_id"	"Kamp-ID"
"dota_page_match_details_header_game_mode"	"Spiltilstand"
"dota_page_match_details_header_duration"	"Varighed"
"dota_page_match_details_voting_votes"	"{i:num_votes} stemmer"
"dota_page_match_details_match_discussion"	"Kampdiskussion"
"dota_page_match_details_comment_placeholder"	"Skriv en kommentar..."
"dota_page_match_details_comment_loading_comments"	"Indlæser kommentarer..."
"dota_page_match_details_comment_no_comments"	"Ingen kommentarer slået op for denne kamp"
"dota_page_match_details_replay_existence_unknown"	"Søger efter gengivelse..."
"dota_page_match_details_replay_existence_cdn_found"	"Download gengivelse"
"dota_page_match_details_replay_existence_not_found"	"Gengivelse utilgængelig"
"dota_page_match_details_replay_existence_downloading"	"Downloader..."
"dota_page_match_details_replay_existence_disk_found_replay"	"Se gengivelse"
"dota_page_match_details_replay_existence_disk_found_highlights"	"Se højdepunkter"
"dota_page_match_details_replay_existence_wrong_engine"	"Source 1-gengivelser er utilgængelige i Source 2"
"dota_profile_content_tab_activity_feed"	"Aktivitetsfeed"
"dota_profile_content_tab_recent_games"	"Nylige spil"
"dota_profile_recent_games_option_show_practice_matches"	"Vis træningskampe"
"dota_profile_recent_game_header_timestamp"	"Dato / tid"
"dota_profile_recent_game_header_hero_name"	"Helte spillet"
"dota_profile_recent_game_header_result"	"Resultat"
"dota_profile_recent_game_header_duration"	"Varighed"
"dota_profile_recent_game_header_type"	"Type"
"dota_profile_recent_game_result_win"	"Sejr"
"dota_profile_recent_game_result_loss"	"Nederlag"
"dota_profile_recent_game_result_abandon"	"Forladt"
"dota_profile_recent_game_icon_source1"	"S1"
"dota_profile_hero_with_index"	"{d:hero_index} {s:hero_name}"
"dota_profile_hero"	"{s:hero_name}"
"dota_page_match_details_replay_error_not_found"	"Gengivelse ikke fundet på harddisken."
"DOTA_tooltip_econ_item_name"	"{s:item_name}"
"DOTA_tooltip_econ_item_description"	"{s:item_description}"
"DOTA_tooltip_econ_item_set"	"Del af: <font color='#dddddd'>{s:item_set}</font>"
"DOTA_tooltip_econ_item_rarity_label"	"Sjældenhed: "
"DOTA_tooltip_econ_item_rarity"	"{s:item_rarity}"
"DOTA_tooltip_econ_item_slot"	"Plads: {s:item_slot}"
"DOTA_tooltip_econ_item_gifter"	"{g:dota_persona:gifter_name}"
"DOTA_tooltip_econ_item_gift_received_date"	"Modtaget: {t:T:gift_received_date_time}"
"DOTA_tooltip_econ_item_trade_restriction_permanent"	"Kan ikke byttes eller sælges"
"DOTA_tooltip_econ_item_trade_restriction_date"	"Kan byttes og sælges efter: {t:s:tradable_after_date_time}"
"DOTA_tooltip_econ_item_market_restriction_permanent"	"Ikke salgbar"
"DOTA_tooltip_econ_item_gift_restriction_permanent"	"Kan ikke gives som gave"
"DOTA_tooltip_econ_item_gift_restriction_date"	"Kan ikke gives som gave indtil: {t:T:giftable_after_date_time} {t:s:giftable_after_date_time}"
"DOTA_tooltip_econ_item_gem_type"	"{s:gem_type}"
"DOTA_tooltip_econ_item_gem_strange_count"	"{d:strange_count}"
"DOTA_tooltip_econ_item_gem_description"	"{s:gem_description}"
"DOTA_tooltip_econ_item_partner"	"{s:partner}"
"DOTA_econ_item_details_item_name"	"{s:item_name}"
"DOTA_econ_item_details_item_creation_date"	"SKABELSESDATO: {t:l:creation_date}"
"DOTA_econ_item_details_set_includes"	"Indeholder følgende:"
"DOTA_econ_item_details_item_set"	"Del af: <font color='#dddddd'>{s:item_set}</font>"
"DOTA_econ_item_details_rarity_label"	"Sjældenhed: "
"DOTA_econ_item_details_item_rarity"	"{s:item_rarity}"
"DOTA_econ_item_details_item_slot"	"Plads: {s:item_slot}"
"DOTA_econ_item_details_item_description"	"{s:item_description}"
"DOTA_econ_item_details_gem_type"	"{s:gem_type}"
"DOTA_econ_item_details_gem_strange_count"	"{d:strange_count}"
"DOTA_econ_item_details_gem_description"	"{s:gem_description}"
"DOTA_Treasure_Name"	"{s:treasure_name}"
"DOTA_Treasure_Rarity"	"<span class=\"ItemRarityColor\">{s:treasure_rarity}</span> skat"
"custom_game_team_select_timer"	"{i:countdown_timer_seconds}"
"custom_game_team_select_shuffle"	"Bland"
"custom_game_team_select_starting"	"Starter"
"custom_game_team_select_lock_start"	"Lås + start"
"custom_game_team_select_cancel_unlock"	"Annuller + oplås"
"custom_game_team_select_join"	"Tilslut"
"custom_game_team_select_empty_slot"	"Tom plads"
"custom_game_team_select_auto_assign"	"Autotildel"
"CouldntFindCompendium"	"Kunne ikke indlæse kompendiets testfil: {s:s1}"
"CompendiumPageError_Pages"	"Kunne ikke finde en \"pages\"-blok i kompendium-datafilen."
"CompendiumPageError_Template"	"Kunne ikke finde en \"template\"-indtastning for kompendium-siden \"{s:s1}\" (sidenummer {s:s2})"
"CompendiumPageError_Scrollbar"	"Kunne ikke finde en scrollbar med navnet \"{s:s1}\" på kompendium-siden \"{s:s2}\""
"CompendiumPageError_Selection"	"Kunne ikke finde et valg kaldet \"{s:s1}\" på kompendium-siden \"{s:s2}\""
"CompendiumPageError_CustomEle"	"Kunne ikke instantiere det tilpassede element \"{s:s1}\" på kompendium-siden \"{s:s2}\""
"CompendiumPageError_SelDesc"	"Kunne ikke finde en \"description\"-nøgle for valget \"{s:s1}\" på kompendium-siden \"{s:s2}\""
"CompendiumPageError_NoTime"	"Manglende eller ugyldig \"time\" angivet for valget \"{s:s1}\" i \"{s:s2}\""
"CompendiumPageError_ElementType"	"Manglende eller ugyldig \"elementtype\" for elementet \"{s:s1}\" på kompendium-siden \"{s:s2}\""
"CompendiumPageError_ImageDL"	"Kunne ikke starte download af kompendium-billede \"{s:s1}\" ({s:s2})"
"CompendiumPageError_ImageDLErr"	"Kunne ikke downloade kompendium-billede \"%s\" ({s:s2})"
"CompendiumPageError_BtnBadSel"	"Indstillingen \"selection_force_to\" i elementet \"{s:s1}\" er ikke i listen over valgmuligheder i valget \"{s:s2}\""
"CompendiumPageError_BtnSelIdx"	"Knappen \"{s:s1}\" i kompendium-siden \"{s:s2}\" har manglende eller ugyldig \"selection_index\""
"CompendiumPageError_ImgBadStyle"	"Forkert billedstil \"{s:s1}\" for billedet \"{s:s2}\"."
"CompendiumError_Template"	"Kunne ikke finde en skabelon kaldt \"{s:s1}\""
"CompendiumError_DupeTemplate"	"Fandt adskillige skabeloner ved navn \"{s:s1}\""
"CompendiumError_NoDefines"	"Skabelonen \"{s:s1}\" kræver 'defines', men instansen \"{s:s2}\" af den har ikke en 'defines'-blok."
"CompendiumError_MissingDef"	"Afledt instans \"{s:s1}\" indeholder ikke en 'define' ved navn \"{s:s2}\", men skabelonen, den afledes af, kræver sådan en."
"CompendiumError_BadDef"	"Skabelonen \"{s:s1}\" indeholder en krævet 'define' ved navn \"{s:s2}\", som ikke starter med \"%def\", hvilket er krævet."
"DOTA_GlobalItems_Couriers"	"Kurérer"
"DOTA_GlobalItems_Pets"	"Kæledyr"
"DOTA_GlobalItems_World"	"Verden"
"DOTA_GlobalItems_Wards"	"Wards"
"DOTA_GlobalItems_Effigies"	"Afbildninger"
"DOTA_GlobalItems_Weather"	"Vejreffekter"
"DOTA_GlobalItems_Interface"	"Grænseflade"
"DOTA_GlobalItems_Emoticons"	"Emotikoner"
"DOTA_GlobalItems_LoadingScreens"	"Indlæsningsskærme"
"DOTA_GlobalItems_HUDs"	"HUDs"
"DOTA_GlobalItems_Audio"	"Lyd"
"DOTA_GlobalItems_Announcers"	"Kommentatorpakke"
"DOTA_GlobalItems_Music"	"Musik"
"DOTA_Search"	"Søg"
"DOTA_Start"	"Start"
"DOTA_PleaseWait"	"Vent venligst..."
"DOTA_ChallengeGroup_2_Desc"	"Træn med og mod AI-kontrollerede helte i et stressfrit træningsspil."
"DOTA_ChatTab_ToggleSounds"	"Afspil en lyd når en besked modtages i denne kanal."
"dota_lobby_swap_teams"	"Byt hold"
"dota_lobby_broadcast_channels"	"Slå broadcastkanaler til/fra"
"dota_lobby_settings"	"Lobbyindstillinger"
"dota_lobby_settings_edit"	"Rediger"
"dota_lobby_leave"	"Forlad denne lobby"
"DOTA_Custom_Game_View_Lobby_List"	"Vis lobbyliste"
"DOTA_Custom_Game_Lobby_List_Title"	"Lobbyliste"
"DOTA_Custom_Game_Browse_All"	"Gennemse alle spil"
"DOTA_Custom_Game_Friends_Ready"	"Venner klar til at spille"
"DOTA_Custom_Game_Friends_Who_Play"	"Venner der spiller"
"DOTA_Custom_Game_Friends_Playing_Now"	"Venner, der spiller nu"
"DOTA_Custom_Game_Browse_Sort"	"Sorter:"
"DOTA_Custom_Game_Sort_Popular_Today"	"Højst vurderede (i dag)"
"DOTA_Custom_Game_Sort_Popular_Week"	"Højst vurderede (denne uge)"
"DOTA_Custom_Game_Sort_Top_Rated"	"Højst vurderede (i alt)"
"DOTA_Custom_Game_Sort_Date"	"Udgivelsesdato"
"DOTA_WatchLive_WatchLabel"	"SE PÅ:"
"DOTA_WatchLive_ThirdParty"	"TREDJEPART"
"DOTA_WatchLive_Steam"	"STEAM"
"DOTA_WatchLive_InGame"	"I SPIL"
"DOTA_WatchLive_Broadcaster0"	"Se på {g:dota_persona:b:broadcaster_account_id_0}"
"DOTA_WatchLive_Broadcaster1"	"Se på {g:dota_persona:b:broadcaster_account_id_1}"
"DOTA_WatchLive_Broadcaster2"	"Se på {g:dota_persona:b:broadcaster_account_id_2}"
"DOTA_WatchLive_Broadcaster3"	"Se på {g:dota_persona:b:broadcaster_account_id_3}"
"DOTA_WatchLive_Broadcaster4"	"Se på {g:dota_persona:b:broadcaster_account_id_4}"
"DOTA_WatchLive_Broadcaster5"	"Se på {g:dota_persona:b:broadcaster_account_id_5}"
"DOTA_WatchLive_Broadcaster6"	"Se på {g:dota_persona:b:broadcaster_account_id_6}"
"DOTA_WatchLive_Broadcaster7"	"Se på {g:dota_persona:b:broadcaster_account_id_7}"
"DOTA_WatchLive_Broadcaster8"	"Se på {g:dota_persona:b:broadcaster_account_id_8}"
"DOTA_WatchLive_Broadcaster9"	"Se på {g:dota_persona:b:broadcaster_account_id_9}"
"dota_matchmaking_region_title_confirm"	"Bekræft matchmaking-regioner"
"dota_play_lobby_games"	"Vis lobbyer"
"dota_play_host_loading"	"Vært indlæser..."
"dota_play_connecting_to_server"	"Forbinder..."
"dota_reconnecting"	"Tilslutter igen..."
"dota_matchmaking_regions_retry"	"Prøv igen"
"dota_matchmaking_region_ping_calculating"	"Ping: Udregner..."
"dota_matchmaking_region_or"	"Eller"
"dota_matchmaking_region_selected_offline"	"Én eller flere valgte region(er) er i øjeblikket offline."
"dota_matchmaking_region_check_internet"	"Tjek din internetforbindelse."
"dota_settings_hide_party_unless_open"	"Skjul gruppestatus når jeg ikke er i en åben gruppe"
"dota_settings_networkhud"	"Vis netværksinformation"
"dota_settings_fullscreenbrightness"	"Lysstyrke"
"dota_settings_quicktargetattack"	"Hurtigangreb"
"dota_settings_chat_whispers"	"Vis Steam-beskeder som hvisken"
"dota_settings_no_mode_resolutions"	"Ingen understøttede opløsninger"
"dota_lobby_browser_header_name"	"Lobbynavn"
"dota_lobby_browser_header_slots"	"Pladser"
"dota_lobby_browser_header_game_mode"	"Spiltilstand"
"dota_lobby_browser_region"	"Region"
"dota_lobby_browser_lobby_name"	"Lobbynavn"
"DOTA_Friend_Game_Mode_Self"	"Du er i et {s:game_mode}-spil"
"DOTA_Friend_Game_Mode_1_Friend"	"{s:player_name} spiller {s:game_mode}"
"DOTA_Friend_Game_Mode_N_Friends"	"{d:num_friends} venner spiller {s:game_mode}"
"Compendium_DefaultText_TimerTitle_Active"	"VALGENE LUKKER OM"
"Compendium_DefaultText_TimerTitle_Expired"	"VALGENE ER LUKKET"
"Compendium_DefaultText_CD_Days"	"Dage"
"Compendium_DefaultText_CD_Hours"	"Timer"
"Compendium_DefaultText_CD_Minutes"	"Minutter"
"Compendium_DefaultText_CD_Seconds"	"Sekunder"
"NetGraph_FPS"	"fps: {d:fps}"
"NetGraph_Ping"	"ping: {d:ping}ms"
"NetGraph_Loss"	"tab: {d:loss}%"
"DOTA_Credits"	"Anerkendelser"
"DOTA_ActorCredits_1_Name"	"Dee Bradley Baker"
"DOTA_ActorCredits_1_Heroes"	"Techies"
"DOTA_ActorCredits_2_Name"	"Dennis Bateman"
"DOTA_ActorCredits_2_Heroes"	"Invoker"
"DOTA_ActorCredits_3_Name"	"Tom Chantler"
"DOTA_ActorCredits_3_Heroes"	"Centaur Warruner, Lion, Outworld Destoyer, Riki, Slark, Tusk, Witch Doctor"
"DOTA_ActorCredits_4_Name"	"Merle Dandridge"
"DOTA_ActorCredits_4_Heroes"	"Legion Commander, Winter Wyvern"
"DOTA_ActorCredits_5_Name"	"Barry Dennen"
"DOTA_ActorCredits_5_Heroes"	"Chaos Knight, Phantom Lancer, Rubick"
"DOTA_ActorCredits_6_Name"	"Dave Fennoy"
"DOTA_ActorCredits_7_Name"	"Jim French"
"DOTA_ActorCredits_7_Heroes"	"Elder Titan"
"DOTA_ActorCredits_8_Name"	"Michael Gregory"
"DOTA_ActorCredits_8_Heroes"	"Bounty Hunter, Clinkz, Silencer"
"DOTA_ActorCredits_9_Name"	"Gin Hammond"
"DOTA_ActorCredits_9_Heroes"	"Crystal Maiden, Drow Ranger, Enchantress, Mirana, Phantom Assassin, Spectre, Vengeful Spirit"
"DOTA_ActorCredits_10_Name"	"John Patrick Lowrie"
"DOTA_ActorCredits_10_Heroes"	"Ancient Apparition, Dark Seer, Doom, Earthshaker, Pudge, Shadow Fiend, Storm Spirit"
"DOTA_ActorCredits_11_Name"	"Ellen McLain"
"DOTA_ActorCredits_11_Heroes"	"Broodmother, Death Prophet"
"DOTA_ActorCredits_12_Name"	"Bruce Miles"
"DOTA_ActorCredits_12_Heroes"	"Alchemist, Lifestealer, Omniknight"
"DOTA_ActorCredits_13_Name"	"Linda K. Morris"
"DOTA_ActorCredits_13_Heroes"	"Luna, Naga Siren, Queen of Pain, Templar Assassin"
"DOTA_ActorCredits_13_Extra"	"Kommentator"
"DOTA_ActorCredits_14_Name"	"Sam A. Mowry"
"DOTA_ActorCredits_14_Heroes"	"Anti-Mage, Beastmaster, Clockwerk, Necrophos, Slardar, Warlock"
"DOTA_ActorCredits_14_Extra"	"Hemmelig butikejer"
"DOTA_ActorCredits_15_Name"	"Eric Newsome"
"DOTA_ActorCredits_15_Heroes"	"Chen, Leshrac, Natures Prophet, Razor, Tidehunter, Tiny, Zeus"
"DOTA_ActorCredits_16_Name"	"Nolan North"
"DOTA_ActorCredits_16_Heroes"	"Brewmaster, Earth Spirit, Gyrocopter, Keeper of the Light, Lone Druid, Lycan, Meepo, Ogre Magi, Shadow Demon, Troll Warlord"
"DOTA_ActorCredits_17_Name"	"Dempsey Pappion"
"DOTA_ActorCredits_17_Heroes"	"Magnus, Nyx Assassin, Visage"
"DOTA_ActorCredits_18_Name"	"TJ Ramini"
"DOTA_ActorCredits_18_Heroes"	"Abaddon, Bristleback, Skywrath Mage, Timbersaw"
"DOTA_ActorCredits_19_Name"	"Harry S. Robins"
"DOTA_ActorCredits_19_Heroes"	"Tinker"
"DOTA_ActorCredits_20_Name"	"Gary Schwartz"
"DOTA_ActorCredits_20_Heroes"	"Lich, Pugna"
"DOTA_ActorCredits_21_Name"	"David Scully"
"DOTA_ActorCredits_21_Heroes"	"Bane, Dazzle, Juggernaut, Morphling, Sand King, Sven, Weaver"
"DOTA_ActorCredits_22_Name"	"Mike Shapiro"
"DOTA_ActorCredits_22_Heroes"	"Oracle"
"DOTA_ActorCredits_23_Name"	"David Sobolov"
"DOTA_ActorCredits_23_Heroes"	"Terrorblade"
"DOTA_ActorCredits_24_Name"	"Jon St. John"
"DOTA_ActorCredits_24_Heroes"	"Axe, Bloodseeker, Enigma, Kunkka"
"DOTA_ActorCredits_25_Name"	"Fred Tatasciore"
"DOTA_ActorCredits_25_Heroes"	"Disruptor, Spirit Breaker, Treant, Undying, Ursa"
"DOTA_ActorCredits_25_Extra"	"Warlocks golem"
"DOTA_ActorCredits_26_Name"	"Jen Taylor"
"DOTA_ActorCredits_26_Heroes"	"Lina, Medusa, Puck, Windranger"
"DOTA_ActorCredits_27_Name"	"Tony Todd"
"DOTA_ActorCredits_27_Heroes"	"Dragon Knight, Night Stalker, Viper"
"DOTA_ActorCredits_28_Name"	" "
"DOTA_ActorCredits_28_Heroes"	" "
"DOTA_PlayerContextMenu_Trade"	"Inviter til byttehandel"
"DOTA_Custom_Game_Finished_Vote_Title"	"Tilpasset spil-afstemning"
"DOTA_Custom_Game_Finished_Vote_Question"	"Hvad synes du om dette tilpassede spil?"
"DOTA_Custom_Game_Finished_Vote_Skip"	"Spring over"
"DOTA_TabName_ModsLobbyList"	"Lobbyliste"
"DOTA_WatchLive_Fullscreen"	"FULDSKÆRM"
"DOTA_JoinChatChannel_ChannelName"	"Kanalnavn"
"DOTA_JoinChatChannel_ChannelMemberCount"	"Medlemmer"
"DOTA_Chat_ChannelMemberCount"	"{d:channel_member_count}"
"DOTA_Trading_UI_Body_Outgoing"	"Venter på at {s:player_name} svarer på din anmodning..."
"DOTA_GiftWrap_ConfirmDedication_Title"	"Bekræft dedikering"
"DOTA_GiftWrap_Success_Header"	"Sucess"
"DOTA_GiftWrap_Success"	"Din gave er blevet leveret."
"DOTA_Custom_Game_Sort_Most_Played"	"Mest populære (denne uge)"
"dota_settings_about"	"Om"
"DOTA_ClientVersion"	"Version: <span class=\"VersionNumber\">{d:client_version_number}</span>"
"DOTA_GameplayVersion"	"Gameplay-version: <span class=\"VersionNumber\">{s:gameplay_version_number}</span>"
"DOTA_CurrentGameplayVersion"	"6.85"
"DOTA_Credits_LindaKMorris_Extra"	"og standardkommentatoren"
"DOTA_Credits_SamAMowry_Extra"	"og den hemmelige butiksejer"
"DOTA_Credits_FredTatasciore_Extra"	"og Warlocks golem"
"DOTA_Recycling"	"Genbrug"
"DOTA_Recycling_Action"	"Genbrug"
"DOTA_Recycling_DragItems"	"Træk uønskede genstande hertil"
"DOTA_Recycling_Outputs"	"Modtag"
"DOTA_Recycling_Confirm"	"Er du sikker på, at du ønsker at genbruge disse genstande?"
"DOTA_RecyclingCharm_Bonus"	"+25 kompendium-mønter"
"DOTA_Previous"	"Forrige"
"DOTA_PreviousShort"	"Forrige"
"DOTA_Next"	"Næste"
"DOTA_Friends_Add_Friend_Tooltip"	"Tilføj ven"
"DOTA_EconItemSet_Tooltip_MultipleTeams"	"Har forskellige stile for Radiant og Dire"
"DOTA_Armory_ActiveFilter"	"{s:filter_field} {s:filter_op} {s:filter_value}"
"DOTA_Treasure_Purchase"	"Køb skat"
"DOTA_Treasure_CharmPurchase"	"Køb amulet"
"DOTA_Treasure_SearchPlaceholder"	"Søg efter skatte"
"DOTA_Treasure_ViewAll"	"Vis alle skatte"
"DOTA_Treasure_QuantityOption"	"Antal: {d:quantity}"
"DOTA_Treasure_Gift"	"Gave"
"DOTA_Treasure_Open"	"Åbn"
"DOTA_Treasure_OpenQuantity"	"{d:owned_quantity}"
"DOTA_Treasure_Owned"	"Ejet"
"DOTA_Treasure_Received"	"Modtaget"
"DOTA_Treasure_Autographed"	"Autograf:"
"DOTA_Treasure_AutographName"	"{s:treasure_autograph_name}"
"DOTA_OpenTreasureTooltip_NormalTitle"	"Indeholder følgende genstande:"
"DOTA_OpenTreasureTooltip_UnitName"	"{g:dota_item_unit_name:item_def}"
"DOTA_OpenTreasureTooltip_ItemName"	" - {g:dota_item_name:item_def}"
"dota_profile_content_tab_official_info"	"Proinfo"
"dota_profile_oi_team"	"HOLD"
"dota_profile_oi_sponsor"	"SPONSOR"
"dota_profile_oi_country"	"LAND"
"dota_profile_oi_role"	"ROLLE"
"dota_profile_oi_submit_info"	"Indsend"
"dota_profile_oi_submit_pending"	"Indsender..."
"dota_profile_oi_submit_success"	"Succes!"
"dota_role_core"	"Core"
"dota_role_support"	"Support"
"Compendium_PreparePublish"	"Klargør til udgivelse"
"Compendium_PublishFinishedTitle"	"Udgivelse lykkedes"
"DOTA_Treasure"	"Skat"
"DOTA_Blog"	"Nyt i Dota 2"
"DOTA_SortBy"	"Sorter efter"
"DOTA_SortOption_Newest"	"Nyest"
"DOTA_SortOption_Owned"	"Ejet"
"DOTA_SortOption_Price"	"Pris"
"DOTA_SortOption_Alphabetical"	"Alfabetisk"
"Action_Use"	"Anvend"
"DOTA_BadgeLevel"	"{d:badge_level}"
"DOTA_AHC_CurrentHero"	"Nuværende helt"
"DOTA_AHC_CurrentHeroName"	"{s:current_hero_name}"
"DOTA_AHC_InProgress"	"I gang"
"DOTA_AHC_CurrentHeroAttempts"	"{s:current_hero_attempts} forsøg"
"DOTA_AHC_CurrentHeroAverage"	"Verdensgennemsnit"
"DOTA_AHC_CurrentHeroAverageAttempts"	"{s:current_hero_average_attempts} forsøg"
"DOTA_AHC_NextHero"	"Næste helt"
"DOTA_AHC_NextHeroName"	"{s:next_hero_name}"
"DOTA_AHC_ChallengeProgress"	"Udfordringsfremskridt ({d:challenge_progress_percent}%)"
"DOTA_AHC_HeroesCompleted"	"Helte gennemført"
"DOTA_AHC_HeroesCompletedValue"	"{d:heroes_completed} / {d:heroes_total}"
"DOTA_AHC_TotalAttempts"	"Forsøg i alt"
"DOTA_AHC_TotalAttemptsValue"	"{d:challenge_total_attempts} spil"
"DOTA_AHC_EquivalentWorldAverageValue"	"{d:challenge_average_total_attempts} spil"
"DOTA_AHC_FullChallengesCompletedValue"	"{d:full_challenges_completed}"
"DOTA_AHC_BestFullChallengeValue"	"{d:best_full_challenge} spil"
"DOTA_AHC_FullChallengeAverageValue"	"{s:full_challenge_average} spil"
"DOTA_AHC_ChallengeReward"	"Udfordringsbelønning"
"DOTA_AHC_ChallengeTrophyName"	"{s:challenge_trophy_name}"
"DOTA_AHC_ChallengeTrophyLevel"	"Level {d:challenge_trophy_level}"
"DOTA_Trophies_ViewEarned"	"Opnået"
"DOTA_Party_Add_Friends"	"Tilføj venner for at oprette en gruppe"
"DOTA_ItemSet_Count_text"	"{d:item_current_group} / {d:item_group_count}"
"DOTA_Custom_Game_Map_AnyNumbered"	"Enhver ({d:map_choices})"
"dota_settings_enable_console"	"Slå konsol til"
"DOTA_HeroLoadout_Loadout"	"Udstyr"
"DOTA_HeroLoadout_About"	"Om"
"DOTA_HeroLoadout_Guides"	"Guider"
"DOTA_HeroLoadout_Roles"	"Roller"
"DOTA_HeroLoadout_Biography"	"Biografi"
"DOTA_Armory_ClearFilter"	"Ryd filter"
"DOTA_Armory_ContextMenu_Tags"	"Tags..."
"DOTA_EffigyEditor_CreateEffigy"	"Skab afbildning"
"DOTA_EffigyEditor_Model"	"Helt"
"DOTA_EffigyEditor_Loadout"	"Gå til udstyr"
"DOTA_EffigyEditor_Inscription"	"Inskription:"
"DOTA_EffigyEditor_Animation"	"Animation:"
"DOTA_tooltip_econ_item_delete_restriction"	"Kan ikke slettes"
"DOTA_tooltip_econ_item_modifiers"	"Modifikatorer"
"DOTA_tooltip_econ_item_modifier_animation"	"Animation"
"DOTA_tooltip_econ_item_modifier_announcer"	"Kommentator"
"DOTA_tooltip_econ_item_modifier_HUD"	"HUD"
"DOTA_tooltip_econ_item_modifier_health_bar"	"Helbredsbjælke"
"DOTA_tooltip_econ_item_modifier_ability_name"	"Evnenavn"
"DOTA_tooltip_econ_item_modifier_loading_screen"	"Indlæsningsskærm"
"DOTA_tooltip_econ_item_modifier_cursor_pack"	"Markørpakke"
"DOTA_tooltip_econ_item_modifier_portrait"	"Portræt"
"DOTA_tooltip_econ_item_modifier_ambient_effects"	"Miljøeffekter"
"DOTA_tooltip_econ_item_modifier_kill_effects"	"Drabseffekter"
"DOTA_tooltip_econ_item_modifier_spell_effects"	"Evneeffekter"
"DOTA_tooltip_econ_item_modifier_model"	"Model"
"DOTA_tooltip_econ_item_modifier_scale"	"Skala"
"DOTA_tooltip_econ_item_modifier_wearable"	"Udstyrbar"
"DOTA_tooltip_econ_item_modifier_courier"	"Kurér"
"DOTA_tooltip_econ_item_modifier_flying_courier"	"Flyvende kurér"
"DOTA_tooltip_econ_item_modifier_pet"	"Kæledyr"
"DOTA_tooltip_econ_item_modifier_weather"	"Vejr"
"DOTA_tooltip_econ_item_modifier_sound"	"Lyd"
"DOTA_tooltip_econ_item_modifier_voice"	"Stemme"
"DOTA_tooltip_econ_item_modifier_icon"	"Ikon"
"DOTA_econ_item_details_style_label"	"Stil:"
"DOTA_econ_item_details_gift_label"	"Gave fra:"
"Compendium_Downloading"	"Downloader kompendium..."
"Compendium_DLFailed"	"Download mislykkedes"
"Compendium_DLFailed_Desc"	"Kunne ikke downloade kompendiet.\n\nPrøv igen senere."
"Compendium_Error"	"Kompendiumfejl"
"Compendium_Retry"	"Prøv igen"
"Compendium_preview_click"	"Klik for flere oplysninger"
"Compendium_level"	"LEVEL"
"Compendium_to_next_level"	"TIL NÆSTE LEVEL"
"Compendium_LevelupPts_Singular"	"1 point"
"Compendium_LevelupPts_Plural"	"{d:next_comp_level} point"
"DOTA_GlobalItems_MegaKill"	"Megadrab-pakker"
"DOTA_Treasure_BonusReward"	"Bonusbelønning"
"DOTA_OpenTreasureTooltip_ExtraItems"	"... og {d:extra_items_count} flere!"
"DOTA_AASystem_Green"	"Akkumuleret online spilletid: {s:playtime}. Du spiller på nuværende tidspunkt inden for den sunde tidsgrænse. Nyd spillet!"
"DOTA_AASystem_Yellow"	"Akkumuleret online spilletid: {s:playtime}. Du har overskredet den sunde spilletidsgrænse. Sørg for at hvile!"
"DOTA_AASystem_Red"	"Akkumuleret online spilletid: {s:playtime}. Du har overskredet den sunde spilletidsgrænse. Det anbefales, at du går offline og hviler!"
"DOTA_AntiAddiction_Initial_With_ID_18Plus"	"Sidst online: %s1\nSidste IP-addresse: %s2"
"DOTA_AntiAddiction_Initial_With_ID_Under_18"	"Du er under 18.  Anti-afhængighedssystemet er i kraft.\nSidst online: %s1\nSidste IP-addresse: %s2"
"DOTA_AntiAddiction_Initial_No_ID"	"Din konto er ikke registreret.\nSidst online: %s1\nSidste IP-addresse: %s2"
"DOTA_AntiAddiction_CompleteInfoNow"	"Indtast information"
"DOTA_AntiAddiction_CompleteInfoNotNow"	"Ikke nu"
"DOTA_AntiAddiction_Label_Green"	"Spiltid: {s:playtime} ( sundt )"
"DOTA_AntiAddiction_Label_Yellow"	"Spiltid: {s:playtime} ( usundt )"
"DOTA_AntiAddiction_Label_Red"	"Spiltid: {s:playtime} ( overskredet )"
"DOTA_Workshop_Browse"	"Gennemse"
"DOTA_Workshop_TextureName_color"	"Farve"
"DOTA_Workshop_Model"	"Model"
"DOTA_Workshop_Animations"	"Animationer"
"DOTA_Workshop_Misc"	"Diverse"
"DOTA_Workshop_SubmissionType_Ward"	"Ward"
"DOTA_Workshop_ImportP4"	"Importer (P4)"
"DOTA_Workshop_ImportNoP4"	"Importer (ikke P4)"
"DOTA_Workshop_SaveSettings"	"Gem indstillinger"
"DOTA_Workshop_LoadSettings"	"Indlæs indstillinger"
"DOTA_Workshop_Ready"	"Klar"
"DOTA_Workshop_Optional"	"Valgfri"
"DOTA_Workshop_Required"	"Påkrævet"
"DOTA_Workshop_NotRequired_Geometry"	"(Maks. antal trekanter: %s1)"
"DOTA_Workshop_NotRequired_Texture"	"(Teksturer vil blive skaleret til: %s1)"
"DOTA_Workshop_LOD0Title"	"Portrætgeometri"
"DOTA_Workshop_LOD1Title"	"Geometri i spillet"
"DOTA_Workshop_LOD1Desc"	"Dette er filerne .DMX, .SMD eller .FBX, som indeholder din genstands skinnede geometri. Det vil blive brugt i spillet."
"DOTA_Workshop_Texture_Title"	"TEKSTURFILER"
"DOTA_Workshop_Texturing"	"Tekstureringshjælp"
"DOTA_Workshop_Modelling"	"Modelleringshjælp"
"DOTA_Workshop_Animation"	"Animationshjælp"
"DOTA_Workshop_AbilityIconsHelp"	"Hjælp til evne-ikoner"
"DOTA_Workshop_Reimport"	"Opdater"
"DOTA_Workshop_Models_Title"	"Modeller"
"DOTA_Workshop_Materials_Title"	"Materialer"
"DOTA_Workshop_Attachments_Title"	"Tilknytninger"
"DOTA_Workshop_Marketing_Title"	"Markedsføring"
"DOTA_Workshop_Particles_Title"	"Partikler"
"DOTA_Workshop_Particles_Help"	"Partikelhjælp"
"DOTA_Workshop_Images_Title"	"Billeder"
"DOTA_Workshop_AbilityIcons_Title"	"Evneikoner"
"DOTA_UI_LoadScreen_16_9"	"16:9-billedformat"
"DOTA_UI_LoadScreen_16_10"	"16:10-billedformat"
"DOTA_UI_LoadScreen_4_3"	"4:3-billedformat"
"DOTA_Workshop_ImportChatEmoticon"	"IMPORTER CHAT-EMOTIKON"
"DOTA_Workshop_ChatEmoticon_Intro"	"Et animeret chatemotikon"
"DOTA_Workshop_ChatEmoticon_Help"	"Chatemotikonshjælp"
"DOTA_Workshop_ChatEmoticon_Title"	"Kildebilledsfil"
"DOTA_Workshop_ChatEmoticon_Preview_Title"	"Forhåndsvis chat-emotikon"
"DOTA_Workshop_ImportChatEmoticon_Preview"	"Forhåndsvis"
"DOTA_Workshop_File_ChatEmoticon"	"Kildebillede (.png-filer)"
"DOTA_Workshop_Attachments_Desc"	"Tilknytningspunkter er punkter på modellen, som spillet kan bruge til at positionere visse effekter. Hvert tilknytningspunkt har både en position og en vinkel, hvilket den henter fra en knogle i din model. Angiv et knoglenavn for hvert krævet tilknytningspunkt. Når du har bygget din importerede model, vil forhåndsvisningen vise dig tilknytningspunkterne, så du kan bekræfte deres placering."
"DOTA_Workshop_Attachments_UIBlock"	"Tilknytninger %s1"
"DOTA_Workshop_Attachment_HitLocation"	"Træffersted-knoglenavn"
"DOTA_Workshop_Attachment_HitLocation_Desc"	"Angiver hvor på modellen at indkommende fjendtlige projektiler skal bevæge sig mod. Et godt sted er over centrum af modellen, såsom centrum af hovedet på et humanoidt væsen."
"DOTA_Workshop_Attachment_LeftEye"	"Venstre øje-knoglenavn"
"DOTA_Workshop_Attachment_LeftEye_Desc"	"Angiver hvor på modellen der skal anbringes usædvanlige partikeleffekter ment til det venstre øje på skabningen. Tilknyt kun på et øjeled som ikke er animeret eller på hovedledet. Positioner på det venstre øje med den røde tx-pil pegende fremad."
"DOTA_Workshop_Attachment_RightEye"	"Højre øje-knoglenavn"
"DOTA_Workshop_Attachment_RightEye_Desc"	"Angiver hvor på modellen der skal anbringes usædvanlige partikeleffekter ment til det højre øje på skabningen. Tilknyt kun på et øjeled som ikke er animeret eller på hovedledet. Positioner på det højre øje med den røde tx-pil pegende fremad."
"DOTA_Workshop_Attachment_AttackPoint"	"Angrebspunkt-knoglenavn"
"DOTA_Workshop_Attachment_AttackPoint_Desc"	"For afstandsenheder angiver dette, hvor deres angrebsprojektil skal starte. For nærkampsenheder er dette hvor vi placerer træffereffekter såsom blodsprøjt."
"DOTA_Workshop_Attachment_AttackPoint2"	"Sekundær angrebspunkt-knoglenavn"
"DOTA_Workshop_Attachment_AttackPoint2_Desc"	"Når en SEKUNDÆRT ANGREB-animation bruges i stedet for et basis-ANGREB, bruges dette angrebspunkt til at skabe træffereffekter og projektiler."
"DOTA_Workshop_Attachment_Mouth"	"Mund-knoglenavn"
"DOTA_Workshop_Attachment_Mouth_Desc"	"Angiver hvor på modellen der skal anbringes partikeleffekter ment til enhedens mund."
"DOTA_Workshop_Attachment_BowTop"	"Buestrengens øverste tilknytningspunkt"
"DOTA_Workshop_Attachment_BowTop_Desc"	"Angiver hvor på modellen at toppen af buestrengens partikeleffekt skal tilknyttes."
"DOTA_Workshop_Attachment_BowMid"	"Buestrengens midterste tilknytningspunkt"
"DOTA_Workshop_Attachment_BowMid_Desc"	"Angiver hvor på modellen at midten af buestrengens partikeleffekt skal være. Bruges til at bøje buestrengen når den spændes."
"DOTA_Workshop_Attachment_BowBot"	"Buestrengens nederste tilknytningspunkt"
"DOTA_Workshop_Attachment_BowBot_Desc"	"Angiver hvor på modellen at bunden af buestrengens partikeleffekt skal tilknyttes."
"DOTA_Workshop_Attachment_LowerStaff"	"Earth Spirits stavs nedre tilknytningspunkt"
"DOTA_Workshop_Attachment_LowerStaff_Desc"	"Angiver hvor på stavmodellen den nedre partikeleffekt skal tilknyttes."
"DOTA_Workshop_Attachment_UpperStaff"	"Earth Spirits stavs øvre tilknytningspunkt"
"DOTA_Workshop_Attachment_UppperStaff_Desc"	"Angiver hvor på stavmodellen den øvre partikeleffekt skal tilknyttes."
"DOTA_Workshop_Animation_Title"	"Animationer"
"DOTA_Workshop_Animation_Desc"	"Animationer er filerne .DMX, .SMD eller .FBX, som hver indeholder en enkel animation til din model."
"DOTA_Workshop_Animation_UIBlock"	"Animationer %s1"
"DOTA_Workshop_Preview_Anim"	"Animation:"
"DOTA_Workshop_Preview_Skin"	"Tekstur:"
"DOTA_Workshop_Preview_Model"	"Model:"
"DOTA_Workshop_Preview_Attachment"	"Fremhæv tilknytning:"
"DOTA_Workshop_Preview_NoAttachment"	"Ingen"
"DOTA_Workshop_Preview_ShowReference"	"Vis referencemodel"
"DOTA_Workshop_Preview_ToggleUI"	"Slå UI til/fra"
"DOTA_Workshop_ImportError_Validation"	"Validering mislykkedes"
"DOTA_Workshop_Error_TooManyBones"	"%1 indeholder flere knogler end tilladt.\nModeller må ikke indeholde flere end 52 knogler."
"DOTA_Workshop_ImportError"	"Importfejl"
"DOTA_Workshop_Error_VMTCount"	"%s1-modellen bruger mere end ét materiale. Kun ét materiale er tilladt for alle LOD's i en model.\nMaterialer fundet:\n\n%s2"
"DOTA_Workshop_Error_TextureNameA"	"Kan ikke genkende det valgte .TGA-filnavn. Teksturer skal slutte på en af følgende endelser: _color, _normal, _mask1, _mask2"
"DOTA_Workshop_Error_TextureNameB"	"Kan ikke finde en tilsvarende .TGA-fil med følgende endelse:\n %s1"
"DOTA_Workshop_RequiredFileError"	"Påkrævet fil ikke fundet!"
"DOTA_Workshop_RequiredFile_Name"	"Kan ikke finde en påkrævet fil med følgende navn:\n %s1"
"DOTA_Workshop_ZipError"	"Filfejl!"
"DOTA_Workshop_ZipError_Desc"	"Kunne ikke oprette midlertidig indsendelses-zip-fil på: %s1"
"DOTA_Workshop_Error"	"Importfejl"
"DOTA_Workshop_Error_Unskinned"	"%1: Kunne ikke finde nogen knogler i den udstyrbare genstand, der korresponderer til knogler i heltemodellen. Udstyrbare genstande skal skinnes til heltens knogler for at kunne indsendes."
"DOTA_Workshop_Error_NoManifest"	"Zip-filen indeholder ikke manifest.txt."
"DOTA_Workshop_Quicksave_Fail"	"Kunne ikke gemme"
"DOTA_Workshop_Quicksave_Fail_Desc"	"Kunne ikke gemme importeringstilstand på %s1"
"DOTA_Workshop_Quickload_Fail"	"Indlæsning mislykkedes"
"DOTA_Workshop_Quickload_Fail_Desc"	"Indlæsning mislykkedes: gemt fil ikke fundet på %s1"
"DOTA_Workshop_NotInTest"	"Kan ikke udgive i Dota 2 Test"
"DOTA_Workshop_NotInTest_Desc"	"Brug venligst Dota 2-hovedklienten til at interagere med Steam-værkstedet."
"DOTA_Workshop_Import"	"Importer"
"DOTA_Workshop_Importing"	"Importerer"
"DOTA_Workshop_Import_Failed"	"IMPORTERING MISLYKKEDES"
"DOTA_Workshop_OutOfBudget"	"%1 er uden for trekant-budgettet:\n %2 indeholder %3 trekanter, men budgettet tillader kun %4."
"DOTA_Workshop_LOD0Title_Ward"	"Portrætgeometri"
"DOTA_Workshop_LOD1Title_Ward"	"Geometri i spillet"
"DOTA_Workshop_LOD1Desc_Ward"	"Dette er filerne .DMX, .SMD eller .FBX, som indeholder din genstands skinnede geometri. Det vil blive brugt i spillet."
"DOTA_Workshop_Mat0Title_Ward"	"Observer-teksturfiler"
"DOTA_Workshop_Mat0Desc_Ward"	"Dette er _color .TGA-filen, som lægger teksturer til geometrifilerne som et Observer Ward. _normal, _mask1 og _mask2 .TGA-filer er valgfrie til Wards. Hvis vi finder dem i samme mappe, vil vi bruge dem."
"DOTA_Workshop_Mat1Title_Ward"	"Sentry-teksturfiler"
"DOTA_Workshop_Mat1Desc_Ward"	"Dette er _color .TGA-filen, som lægger teksturer til geometrifilerne som et Sentry Ward. _normal, _mask1 og _mask2 .TGA-filer er valgfrie til Wards. Hvis vi finder dem i samme mappe, vil vi bruge dem."
"DOTA_Workshop_Animation_Spawn"	"Tilbagevenden"
"DOTA_Workshop_Animation_Idle"	"Passiv"
"DOTA_Workshop_Animation_IdleAlt"	"Alternativ passiv"
"DOTA_Workshop_Animation_IdleRare"	"Sjælden passiv"
"DOTA_Workshop_Animation_Run"	"Løb"
"DOTA_Workshop_Animation_RunAlt"	"Alternativ løb"
"DOTA_Workshop_Animation_RunRare"	"Sjælden løb"
"DOTA_Workshop_Animation_RunHaste"	"Hasteværk-løb"
"DOTA_Workshop_Animation_RunInjured"	"Såret løb"
"DOTA_Workshop_Animation_Die"	"Dødsfald"
"DOTA_Workshop_Animation_Die2"	"Alternativt dødsfald"
"DOTA_Workshop_Animation_Attack"	"Angreb"
"DOTA_Workshop_Animation_Attack_Desc"	"Angrebsanimationer skal passe med timingen af enhedens standardanimation. Angrebsanimationen for denne enhed skal være %s2 sekunder lang, og angrebspunktet skal ske %s1 sekunder inde i animationen."
"DOTA_Workshop_Animation_AttackB"	"Alternativt angreb"
"DOTA_Workshop_Animation_AttackB_Desc"	"En alternativ angrebsanimation som tilfældigt bruges i stedet for ANGREB-animationen. Skal have samme længde og timing som ANGREB-animationen."
"DOTA_Workshop_Animation_Attack2"	"Sekundært angreb"
"DOTA_Workshop_Animation_Attack2_Desc"	"En alternativ angrebsanimation som tilfældigt bruges i stedet for ANGREB-animationen. Træffereffekter / projektiler skabes fra den SEKUNDÆRE ANGREBSPUNKT-tilknytning i stedet for basis-ANGREBSPUNKTET. Skal have samme længde og timing som ANGREB-animationen."
"DOTA_Workshop_Animation_Attack2B"	"Sekundært alternativt angreb"
"DOTA_Workshop_Animation_Attack2B_Desc"	"En alternativ angrebsanimation som tilfældigt bruges i stedet for ANGREB-animationen. Træffereffekter / projektiler skabes fra den SEKUNDÆRE ANGREBSPUNKT-tilknytning i stedet for basis-ANGREBSPUNKTET. Skal have samme længde og timing som ANGREB-animationen."
"DOTA_Workshop_Animation_Flail"	"Fægtende"
"DOTA_Workshop_Animation_Flail_Desc"	"En animation, der kører i løkke, når enheden er disabled og flyttes (f.eks. mens i cyklon, black hole, fyret op i luften)"
"DOTA_Workshop_Animation_Disabled"	"Disabled / lammet"
"DOTA_Workshop_Animation_TurnPoseCenter"	"Drejestilling centrum"
"DOTA_Workshop_Animation_TurnPoseLeft"	"Drejestilling venstre"
"DOTA_Workshop_Animation_TurnPoseRight"	"Drejestilling højre"
"DOTA_Workshop_Animation_TurnPoseCenter_Desc"	"En enkel frame-stilling af enheden, der kigger fremad. Generelt kan du blot genbruge frame 0 i løbeanimationen. Hvis valgt er du nødt til at angive venstre og højre drejestillinger."
"DOTA_Workshop_Animation_TurnPoseLeft_Desc"	"En enkel frame-stilling af enheden, der drejer til venstre. Idet enheden drejer til venstre, vil vi kombinere denne stilling og centrum-stillingen. Hvis valgt er du nødt til at angive centrum og højre drejestillinger."
"DOTA_Workshop_Animation_TurnPoseRight_Desc"	"En enkel frame-stilling af enheden, der drejer til højre. Idet enheden drejer til højre, vil vi kombinere denne stilling og centrum-stillingen. Hvis valgt er du nødt til at angive centrum og venstre drejestillinger."
"DOTA_Workshop_Animation_PortraitIdle"	"Portræt passiv"
"DOTA_Workshop_Animation_PortraitRare"	"Sjælden portræt passiv"
"DOTA_Workshop_Animation_LeftIdle"	"Venstre passiv"
"DOTA_Workshop_Animation_LeftAttack"	"Venstre angreb"
"DOTA_Workshop_Animation_Victory"	"SEJR"
"DOTA_Workshop_Animation_Defeat"	"NEDERLAG"
"DOTA_Workshop_Animation_Die_Forward"	"DØDSFALD FREMAD"
"DOTA_Workshop_BackgroundColor"	"Baggrundsfarve"
"DOTA_Workshop_BackgroundTexture"	"Baggrundstekstur"
"DOTA_Workshop_Camera"	"Kamera"
"DOTA_Workshop_CameraFOV"	"Kamerasynsfelt"
"DOTA_Workshop_EditAngles"	"Rediger vinkler"
"DOTA_Workshop_EditAttachments"	"Rediger tilknytninger"
"DOTA_Workshop_EditPortrait"	"Rediger portræt"
"DOTA_Workshop_GameDay"	"Dag"
"DOTA_Workshop_GameNight"	"Nat"
"DOTA_Workshop_ImportLog"	"Importer log"
"DOTA_Workshop_Next"	"Næste"
"DOTA_Workshop_Portrait"	"Portræt"
"DOTA_Workshop_Prev"	"Forrige"
"DOTA_Workshop_Preview"	"Forhåndsvis"
"DOTA_Workshop_PreviewInGame"	"Forhåndsvis i spil"
"DOTA_Workshop_ShowReferenceModel"	"Vis referencemodel"
"DOTA_Workshop_Submit"	"Indsend"
"DOTA_Workshop_Texture"	"Tekstur"
"DOTA_Workshop_Err_InvalidFile"	"Ugyldig fil: \"%1\""
"DOTA_Workshop_BrowseForZipCaption"	"Vælg zip"
"DOTA_Workshop_BrowseForZipFilter"	"Værkstedsindsendelser"
"DOTA_Workshop_LoadSession"	"Indlæs session"
"DOTA_Workshop_SaveSession"	"Gem session"
"DOTA_Workshop_Err_Misc"	"Intern fejl (%1)"
"DOTA_Filter_Field_Category"	"Tags"
"DOTA_Armory_Tags_Popup_Title"	"Angiv tags"
"DOTA_Armory_Attributes"	"Attributter"
"DOTA_Event_Level"	"Level"
"DOTA_Skip"	"Spring over"
"DOTA_Done"	"Færdig"
"DOTA_TryAgain"	"Prøv igen"
"DOTA_Treasure_OpenAnother"	"Åbn endnu en"
"DOTA_Treasure_OpenTreasure"	"Åbn skat"
"DOTA_Treasure_OpenSuccess"	"Tillykke! Du modtog:"
"DOTA_Custom_Game_Dedicated_Servers"	"Dedikerede servere"
"DOTA_View_Details"	"Vis oplysninger"
"DOTA_TabName_Featured"	"Fremhævede"
"DOTA_TabName_Heroes"	"Helte"
"DOTA_Profile_Edit"	"Rediger profil"
"DOTA_Profile_LifetimeStats"	"Livstidsstatistikker"
"DOTA_Profile_ViewSteamProfile"	"Vis Steam-profil"
"DOTA_Profile_SendMessage"	"Send besked"
"DOTA_Trophies_ViewAvailable"	"Tilgængelige"
"DOTA_TrophyXPProgress"	"{d:trophy_xp} / {d:total_trophy_xp}<span class=\"TrophyPointTextSmall\">TP</span>"
"DOTA_TrophyDetails_XP"	"{d:trophy_details_xp}<span class=\"TrophyPointTitleSmall\">TP</span>"
"DOTA_TrophyDetails_PointsPerLevel"	"Optjen {d:trophy_points_per_level} trofæpoint hver gang denne stiger i level."
"DOTA_Trophy_Upgraded"	"Trofæ opgraderet"
"DOTA_Trophy_Achieved"	"Trofæ opnået"
"DOTA_Lobby_Settings_Tournament_None"	"Ingen"
"DOTA_Lobby_Settings_Tournament"	"Liga"
"DOTA_WatchReplays_Game1"	"Spil 1"
"DOTA_WatchReplays_Game2"	"Spil 2"
"DOTA_WatchReplays_Game3"	"Spil 3"
"DOTA_WatchReplays_Game4"	"Spil 4"
"DOTA_WatchReplays_Game5"	"Spil 5"
"DOTA_WatchReplayError_Incompatible"	"Denne gengivelse er ikke kompatibel med denne version af Dota."
"DOTA_WatchReplayError_DoesNotExist"	"Denne kamp eksisterer ikke."
"DOTA_WatchTournaments_PrizePoolLabel"	"præmiepulje"
"DOTA_WatchTournaments_PrizePoolTicketPrice"	"Billet {g:dota_item_price:ticket_itemdef}"
"DOTA_WatchTournaments_PrizePoolActivate"	"Aktiver billet"
"DOTA_WatchTournaments_LiveGames"	"- DIREKTE KAMPE I GANG"
"DOTA_WatchTournaments_View"	"Vis"
"DOTA_WatchTournaments_Region_NA"	"Nordamerika"
"DOTA_WatchTournaments_Region_SA"	"Sydamerika"
"DOTA_WatchTournaments_Region_EU"	"Europa"
"DOTA_WatchTournaments_Region_RU"	"Rusland"
"DOTA_WatchTournaments_Region_CN"	"Kina"
"DOTA_WatchTournaments_Region_SEA"	"Sydøstasien"
"DOTA_WatchTournament_BestOf3"	"Bedst af 3"
"DOTA_WatchTournament_BestOf5"	"Bedst af 5"
"DOTA_WatchTournament_Website"	"Vis turneringswebside"
"DOTA_WatchTournament_Compendium"	"Vis kompendium"
"DOTA_WatchTournament_Page"	"Side {i:page_cur} / {i:page_max}"
"DOTA_WatchTournament_Spectators"	"{i:spectators} tilskuere"
"DOTA_EquippedItem_Button_SingleItemShuffle"	"Udstyr"
"DOTA_Feed_Title"	"Vennefeed"
"DOTA_Armory_Category_EffigyBlocks"	"Afbildningsblokke"
"DOTA_Armory_Category_Leagues"	"Ligagenstande"
"DOTA_Armory_Category_Charms"	"Amuletter"
"DOTA_Armory_Category_CharmFragments"	"Amuletfragmenter"
"DOTA_Armory_Category_MegaKills"	"Megadrab"
"DOTA_Armory_Category_Treasures"	"Skatte"
"DOTA_Armory_Category_Gifts"	"Gaver"
"DOTA_Armory_Category_Bundles"	"Bundter"
"DOTA_Armory_Category_Compendiums"	"Kompendier"
"DOTA_Armory_Category_Tools"	"Værktøjer"
"DOTA_Armory_ActiveFilterLabel"	"Filter:"
"DOTA_Armory_EditFilter"	"Rediger filter"
"DOTA_Armory_Filter_Tradeable"	"KAN BYTTES"
"DOTA_Armory_Filter_Equipped"	"UDSTYRET"
"DOTA_Armory_Filter_HasSockets"	"HAR INDFATNINGER"
"DOTA_Armory_Filter_IsJunk"	"MARKERET SOM SKROT"
"DOTA_Armory_Filter_IsBundle"	"ER BUNDT"
"DOTA_Armory_Filter_IsGift"	"GIVET TIL MIG I GAVE"
"DOTA_Armory_Filter_Rarity"	"SJÆLDENHED"
"DOTA_Armory_Filter_Quality"	"KVALITET"
"DOTA_Armory_Filter_Tags"	"TAGS"
"DOTA_Armory_Filter_Delete"	"Slet filter"
"DOTA_Armory_Filter_CreateNew"	"Ny filter..."
"DOTA_Armory_Filter_FilterName"	"Filternavn"
"DOTA_Armory_Filter_Required"	"PÅKRÆVET"
"DOTA_tooltip_econ_item_tags"	"Tags"
"Compendium_LeagueID"	"Liga-ID"
"Compendium_InvalidLeagueID"	"Ugyldigt eller intet liga-ID angivet."
"Compendium_Unsupported"	"Kompendium ikke understøttet"
"Compendium_Unsupported_Desc"	"Dette kompendium er en ældre version, der ikke er understøttet."
"Compendium_TestingBadLeagueID"	"Manglende eller ugyldigt \"league_id\"-nøgle i kompendium-datafilen."
"DOTA_GlobalItems_CursorPacks"	"Markørpakker"
"DOTA_Workshop_Materials"	"Materialer"
"DOTA_Workshop_Meshes"	"Meshes"
"DOTA_Workshop_EditTarget"	"Rediger mål"
"DOTA_Workshop_Err_AddToZip"	"Kunne ikke tilføje fil til zip: %1"
"DOTA_Workshop_Err_BadPath"	"Ugyldig sti \"%1\""
"DOTA_Workshop_UnrecognizedTemplate"	"Ukendt værkstedsskabelon"
"DOTA_Popup_Item_Received_Header_Unknown"	"Du har modtaget en genstand!"
"DOTA_Popup_Item_Received_Header_Dropped"	"Du har modtaget en genstand!"
"DOTA_Popup_Item_Received_Header_Crafted"	"Du har smedet en genstand!"
"DOTA_Popup_Item_Received_Header_Traded"	"Du har byttet dig til en genstand!"
"DOTA_Popup_Item_Received_Header_Purchased"	"Du har købt en genstand!"
"DOTA_Popup_Item_Received_Header_FoundInCrate"	"Du har modtaget en genstand!"
"DOTA_Popup_Item_Received_Header_Gifted"	"Du har modtaget en gave!"
"DOTA_Popup_Item_Received_Header_Support"	"Kundesupport har givet dig en genstand!"
"DOTA_Popup_Item_Received_Header_Promotion"	"Du modtog en butikspromoveret genstand!"
"DOTA_Popup_Item_Received_Header_Earned"	"Du har optjent en genstand!"
"DOTA_Popup_Item_Received_Header_Refunded"	"Du fik refunderet en genstand!"
"DOTA_Popup_Item_Received_Header_GiftWrapped"	"Du pakkede en genstand ind!"
"DOTA_Popup_Item_Received_Header_Foreign"	"Du fandt en genstand i et andet spil!"
"DOTA_Popup_Item_Received_Header_CollectionReward"	"Du indløste en samlingspræmie!"
"DOTA_Popup_Item_Received_Header_PreviewItem"	"Du tester en ny genstand!"
"DOTA_Popup_Item_Received_Header_PreviewItemPurchased"	"Du har købt en genstand!"
"DOTA_Popup_Item_Received_Header_PeriodicScoreReward"	"Du har optjent en genstand!"
"DOTA_Popup_Item_Received_Header_Recycling"	"Du har smedet en genstand!"
"DOTA_Popup_Item_Received_Header_RecipeOutput"	"Du har smedet en genstand!"
"DOTA_Popup_Item_Received_Header_CommunityMarketPurchase"	"Du har købt en genstand!"
"DOTA_Popup_Item_Received_Header_GemExtract"	"Du har udtrukket en genstand!"
"DOTA_Popup_Item_Received_Header_CompendiumReward"	"Du har modtaget en kompendium-belønning!"
"DOTA_Popup_Item_Received_Button_Accept"	"Accepter"
"DOTA_Popup_Item_Received_Button_AcceptAll"	"Accepter alle ({d:item_n})"
"dota_casters"	"Broadcastere"
"LobbySetting_League"	"Liga"
"LobbySetting_League_Value"	"{s:lobbysetting_league}"
"DOTA_WatchLive_Activate"	"Aktiver billet"
"DOTA_WatchLive_LoadMore"	"Indlæs flere"
"DOTA_WatchReplays_Pending"	"Afventer..."
"DOTA_WatchReplays_Downloading"	"Downloader...{i:download_pct}%"
"LoadingScreenCastersInfo"	"Broadcastere: {i:casters_loaded}/{i:casters_total}"
"DOTA_Armory_ContextMenu_EquipSet"	"Udstyr sæt"
"DOTA_Armory_Tag1_Default"	"Tag 1"
"DOTA_Armory_Tag2_Default"	"Tag 2"
"DOTA_Armory_Tag3_Default"	"Tag 3"
"DOTA_Armory_Tag4_Default"	"Tag 4"
"DOTA_Armory_Tag5_Default"	"Tag 5"
"DOTA_Armory_Tag6_Default"	"Tag 6"
"DOTA_Armory_Tag7_Default"	"Tag 7"
"DOTA_Armory_Tag8_Default"	"Tag 8"
"DOTA_Workshop_TextureName_normal"	"Normal"
"DOTA_Treasure_MarketPurchase"	"På markedet"
"DOTA_Treasure_HelpHeader"	"Hver skat indeholder {d:items_per_treasure} af disse genstande"
"DOTA_Treasure_FilterAvailable"	"Tilgængelig"
"DOTA_Treasure_FilterAll"	"Alle"
"DOTA_Workshop_ExtraMiscTags"	"Ekstra tags"
"DOTA_Trophies_ViewMyCollection"	"Min samling"
"DOTA_Trophies_ViewActive"	"Aktiv"
"DOTA_Custom_Game_About"	"Om"
"DOTA_Custom_Game_Updates"	"Opdateringer"
"DOTA_EventName_International2014"	"The International 2014"
"DOTA_EventName_International2015"	"The International 2015"
"DOTA_Profile_SaveChanges"	"Gem ændringer"
"dota_lobby_broadcast_channel_title"	"Broadcast-kanaler"
"dota_settings_shadowquality_off"	"Slået fra"
"dota_lobby_host"	"Lobby-vært: {s:lobby_host_name}"
"dota_lobby_row_region"	"{s:region}"
"dota_lobby_browser_header_region"	"Region"
"dota_lobby_browser_all_regions"	"Alle regioner"
"DOTA_Armory_Category_CompendiumCoins"	"Mønter"
"dota_profile_recent_games_option_show_custom_games"	"Vis tilpassede spil"
"dota_profile_recent_game_result_uncalibrated_ranked"	"Kalibrerer"
"dota_profile_recent_game_result_win_ranked"	"{i:ranked_mmr} (+{i:ranked_mmr_delta})"
"dota_profile_recent_game_result_loss_ranked"	"{i:ranked_mmr} ({i:ranked_mmr_delta})"
"DOTA_tooltip_econ_item_gift_dedication"	"{s:gift_dedication}"
"DOTA_econ_item_details_original_name_label"	"Oprindelige navn:"
"DOTA_econ_item_details_extract_gem"	"Udtræk ædelsten"
"DOTA_econ_item_details_description_header"	"Beskrivelse"
"DOTA_econ_item_details_description_edit"	"Rediger"
"DOTA_Workshop_SubmitNew"	"Indsend"
"DOTA_Workshop_SelectImportType"	"Hvad udgiver du?"
"UI_File_Filter_PNG"	"PNG-filer (*.png)"
"DOTA_Teams_WindowTitle"	"HOLD"
"DOTA_TeamManagement_FullName"	"Fulde holdnavn"
"DOTA_TeamManagement_Country"	"Land"
"DOTA_TeamKickLabel"	"Smid ud"
"DOTA_TeamKickMember"	"Smid holdmedlem ud"
"DOTA_TeamConfirmKickMember"	"Smid dette holdmedlem ud?"
"DOTA_TeamCreateNewTeam"	"Opret nyt hold"
"DOTA_TeamsMyTeams"	"Mine hold"
"DOTA_TeamsManageTeams"	"Administrer hold"
"DOTA_TeamImagesBrowse"	"Gennemse"
"DOTA_TeamTeamID"	"Hold-ID:"
"DOTA_TeamRoster"	"Holdliste"
"DOTA_TeamImages"	"Billeder"
"DOTA_TeamInvitePlayer"	"Inviter spiller"
"DOTA_TeamLeaveTeam"	"Forlad dette hold"
"DOTA_TeamJoinTeam"	"Tilslut hold"
"DOTA_TeamDisbandTeam"	"Opløs hold"
"DOTA_TeamInviteAPlayer"	"Indtast en vens navn..."
"DOTA_JoinChatChannel_Custom"	"Bruger"
"DOTA_JoinChatChannel_CustomGame"	"Tilpassede spil"
"DOTA_Chat_ChannelDistance"	"{s:channel_distance} km"
"DOTA_Chat_CustomGameChannelName"	"{g:dota_custom_game_name:channel_name}"
"DOTA_ChatTarget_Prompt_CustomGame"	"Til [{g:dota_custom_game_name:custom_game_id}]:"
"DOTA_ChatTarget_Format_CustomGame"	"{g:dota_custom_game_name:custom_game_id}"
"DOTA_PlayerContextMenu_Ignore"	"Ignorer bruger"
"DOTA_Frontpage_LastMatch_Title"	"Din sidste kamp"
"DOTA_Frontpage_LastMatch_Mode"	"Tilstand"
"DOTA_Frontpage_LastMatch_Duration"	"Varighed"
"DOTA_Frontpage_LastMatch_Result"	"Resultat"
"DOTA_Frontpage_LastMatch_Items"	"Genstande"
"DOTA_Frontpage_FriendCustom_Title"	"Tilpasset spil"
"DOTA_Frontpage_FriendCustom_IsPlaying"	"spiller"
"dota_profile_oi_cancel"	"Annuller"
"DOTA_tooltip_econ_item_leaguename"	"{s:league_name}"
"DOTA_tooltip_econ_item_matchevent"	"{s:tournament_event}"
"DOTA_tooltip_econ_item_matchid"	"KAMP-ID: {s:tournament_matchID}"
"DOTA_tooltip_econ_item_matchdate"	"MODTOG: {t:l:tournament_date}"
"DOTA_tooltip_econ_item_team1_name"	"{s:team1_name}"
"DOTA_tooltip_econ_item_unknown_team"	"Ukendt hold"
"DOTA_tooltip_econ_item_team2_name"	"{s:team2_name}"
"DOTA_tooltip_econ_item_VS"	"MOD"
"DOTA_tooltip_econ_item_event_description"	"{s:event_description}"
"DOTA_Compendium_Coin_Bank"	"{d:coin_bank}"
"DOTA_Compendium_Coin_Plus"	"+"
"DOTA_Compendium_Coins_Gained"	"{d:coins_gained}"
"DOTA_Workshop_Imported_S1NormalOverwrite_Title"	"Overskriv fil?"
"DOTA_Workshop_Items_Err_EmptyName"	"Nyt genstandsnavn må ikke være tomt"
"DOTA_Workshop_Items_Err_EmptyDescription"	"Ny genstandsbeskrivelse må ikke være tom"
"DOTA_Workshop_ItemImport_HeroName_Label"	"Helt:"
"DOTA_Workshop_ItemImport_CreateItem_Name"	"Genstandsnavn:"
"DOTA_Workshop_ItemImport_CreateItem_Description"	"Beskrivelse:"
"DOTA_Workshop_ItemImport_UpdateItem_Find_Label"	"Find:"
"DOTA_Workshop_ItemSubmit_Create_IDLabel"	"Ny genstand: %1 \"%2\""
"DOTA_Workshop_ItemSubmit_Update_IDLabel"	"Opdater genstand: %1 \"%2\""
"DOTA_Workshop_ItemSubmit_Update_UICheckBoxes_Label"	"Opdater %1"
"DOTA_Workshop_ItemSubmit_Update_UICheckBox_Particles"	"Partikler"
"DOTA_Workshop_ItemSubmit_Update_UICheckBox_Portrait"	"Portræt"
"DOTA_Workshop_ItemSubmit_Update_UICheckBox_Wearable"	"Udstyrbar"
"DOTA_Workshop_Items_Loading"	"Indlæser..."
"DOTA_Workshop_Items_No_Free_Item_Index_Title"	"Intet ledigt genstandsindeks!"
"DOTA_Workshop_Items_Duplicate_Item_Title"	"Denne genstand eksisterer allerede!"
"DOTA_ItemPicker_Title"	"Vælg en genstand"
"DOTA_ItemPicker_Action"	"Vælg"
"DOTA_WatchTournaments_Search"	"Søg efter turneringer..."
"LoadingScreenGameMode"	"{s:game_mode}"
"LoadingScreenMatchID"	"KampID: {s:match_id}"
"Compendium_TOC"	"Indholdsfortegnelse"
"DOTA_Compendium_Level_Number"	"{d:compendium_level}"
"DOTA_Compendium_Level_Points"	"{d:compendium_points}"
"DOTA_Workshop_Attachment_Reset"	"Nulstil"
"DOTA_Workshop_PreviewAspectRatio"	"Billedformat"
"DOTA_ReforgeItem_Action"	"Omsmed"
"DOTA_Workshop_Select"	"Vælg"
"DOTA_ShareParty_Available"	"Tilslut gruppe"
"DOTA_ShareLobby_Available"	"Tilslut lobby"
"dota_settings_application"	"Applikation"
"DOTA_HeroLoadout_GlobalFilterName"	"Global"
"DOTA_Armory_Filter_InScratchpad"	"I SAMLING"
"DOTA_Profile_NoLeaguePasses"	"Ingen turneringspas"
"DOTA_TournamentBracket_MatchList_Timestamp"	"{T:t:timestamp}"
"DOTA_WatchLive_Game_ProInfo"	"{g:dota_persona:pro:account_id} {s:hero_name}"
"DOTA_WatchLive_Game_TimeAndScore"	"{t:d:duration} / {i:radiant_score} - {i:dire_score}"
"DOTA_WatchLive_Game_Round"	" "
"DOTA_WatchLive_Game_LoadMore"	"Indlæs flere"
"competitive_team_identity_checkbox"	"Spil som {s:team_identity_tag}"
"ranked_mmr_team_label"	"Hold"
"ranked_mmr_team_value"	"{d:team_identity_rank}"
"dota_matchmaking_region_ping_time_approx"	"Ping: ~{i:ping_ms}ms"
"dota_matchmaking_region_ping_time_min"	"Ping: >{i:ping_ms}ms"
"DOTA_NotEquippedItem_Label"	"Ikke udstyret"
"DOTA_CacheTreasure_MissingCompendiumOK"	"Flere oplysninger"
"DOTA_View_Details_Arrow"	"Vis oplysninger >>"
"DOTA_UI_Play"	"Spil"
"DOTA_Custom_Game_Of_The_Day"	"Dagens spil"
"DOTA_Custom_Game_Games_With_Lobbies"	"Åbne lobbyer"
"DOTA_WatchTournament_MatchDetails"	"Kampoplysninger"
"DOTAWatchDownloads_MatchID"	"KampID {s:match_id}"
"DOTAWatchDownloads_Teams"	"{s:team_1} mod {s:team_2}"
"DOTAWatchDownloads_DeleteTitle"	"Slet gengivelse?"
"dota_settings_hide_tips_on_loading_screens"	"Skjul tips på indlæsningsskærme"
"LoadingScreen_TipText"	"{s:tip}"
"DOTA_econ_item_details_original_item_name"	"{s:original_item_name}"
"DOTA_econ_item_details_gift_clear_attributes"	"Ryd gave"
"DOTA_Purchase_Popup_Title"	"{s:purchase_item_title}"
"DOTA_Purchase_Popup_Body"	"{s:purchase_item_body}"
"DOTA_Purchase_Popup_Purchase_Button"	"Køb"
"DOTA_Purchase_Popup_SaleAmount"	"-{i:item_sale_amount}%"
"DOTA_Purchase_Popup_RegularSetPrice"	"{s:item_regular_price}"
"DOTA_Purchase_Popup_SetPrice"	"{s:item_price}"
"DOTA_Generic_Popup_Title"	"{s:generic_popup_title}"
"DOTA_Generic_Popup_Body"	"{s:generic_popup_body}"
"Customization_Name"	"Navn"
"Customization_Name_Tool"	"Navneskilt"
"Customization_Description"	"Beskrivelse"
"Customization_Gifter_Attributes"	"Gaveoplysninger"
"DOTA_ItemRemoveAttribute_Title"	"Fjern {s:item_attribute}?"
"DOTA_Leaf_Halloween2015_Title"	"Haunted Colosseum"
"DOTA_Leaf_Halloween2015_SubTitle"	"Et nyt tilpasset spil fra Valve"
"FrontPage_Halloween2015_Haunted_Colosseum_Header"	"Nyt tilpasset spil"
"FrontPage_Halloween2015_Haunted_Colosseum_Title"	"Haunted Colosseum"
"FrontPage_Halloween2015_Haunted_Colosseum_Desc"	"Et nyt tilpasset spil fra Valve"
"DOTA_ItemChangeName_NeedTool_Title"	"Køb et navneskilt?"
"DOTA_ItemRemoveName_Title"	"Fjern navn?"
"DOTA_ItemRemoveGift_Title"	"Fjern gaveoplysninger?"
"DOTA_Custom_Game_Last_Updated_String"	"Opdateret {s:last_updated_date_string}"
"DOTAWatchDownloads_Search"	"Søg efter turneringer..."
"DOTA_OwnedItemDetails_DefaultSet"	"Standardsæt"
"DOTA_Workshop_SMDWarning"	"ADVARSEL: SMD-filunderstøttelse bliver snart fjernet."
"DOTA_Workshop_Err_NonexistentFile"	"Ikke-eksisterende fil: \"%1\""
}
