"dota"
{
"DOTA_Accept"	"Принять"
"DOTA_Cancel"	"Отмена"
"DOTA_Console"	"Консоль"
"DOTA_Create"	"Создать"
"DOTA_Decline"	"Отклонить"
"DOTA_Error"	"Ошибка"
"DOTA_Join"	"Присоединиться"
"DOTA_Leave"	"Покинуть"
"DOTA_New"	"Новое"
"DOTA_Ok"	"OK"
"DOTA_Sale"	"Скидка"
"DOTA_Close"	"Закрыть"
"DOTA_Continue"	"Продолжить"
"DOTA_Add"	"Добавить"
"DOTA_Edit"	"Изменить"
"DOTA_Enable"	"Включить"
"DOTA_Disable"	"Выключить"
"DOTA_Refresh"	"Обновить"
"DOTA_Loading"	"Загрузка"
"DOTA_None"	"Нет"
"DOTA_Customize"	"Переодеть"
"DOTA_AcceptChanges"	"Принять изменения"
"dota_team_radiant"	"Силы Света"
"dota_team_dire"	"Силы Тьмы"
"Unknown"	"Неизвестно"
"UI_Yes"	"Да"
"UI_No"	"Нет"
"UI_File_Filter_Any"	"Все файлы (*.*)"
"DOTA_MainMenu_Heroes"	"Предметы"
"DOTA_MainMenu_Watch"	"Просмотр"
"DOTA_MainMenu_Learn"	"Обучение"
"DOTA_MainMenu_Mods"	"Пользовательские игры"
"DOTA_TabName_GlobalItems"	"Общие"
"DOTA_TabName_Treasury"	"Сокровищницы"
"DOTA_TabName_Armory"	"Арсенал"
"DOTA_ConfirmQuit"	"Выход"
"DOTA_ConfirmQuitDesc"	"Выйти из игры?"
"DOTA_ConfirmQuitDescUnsafe"	"Если вы покинете игру до ее окончания, то испортите ее остальным игрокам. Вы действительно хотите выйти из игры?"
"DOTA_InvalidPersonaName"	"[неизвестно]"
"DOTA_Friends_WindowTitle"	"ДРУЗЬЯ"
"DOTA_FriendsCategory_ReadyToPlay"	"<font color='#63C290'><b></b>{d:friend_count}</font> в открытых играх"
"DOTA_FriendsCategory_PlayingDota"	"<font color='#ACEBA9'>{d:friend_count}</font> в Dota 2"
"DOTA_FriendsCategory_Online"	"<font color='#6a9dcc'>{d:friend_count}</font> в сети"
"DOTA_FriendsCategory_Pending"	"<font color='#eeee82'>{d:friend_count}</font> ожидает"
"DOTA_FriendsCategory_Offline"	"<font color='#676666'>{d:friend_count}</font> не в сети"
"DOTA_Friends_Empty"	"Ваш список друзей пуст"
"DOTA_FriendsMenu_Tooltip_NoneReady"	"Друзья"
"DOTA_UserName"	"{g:dota_persona:user_account_id}"
"DOTA_UserNamePro"	"{g:dota_persona_pro:user_account_id}"
"DOTA_UserNickname"	"{g:dota_persona_nickname:user_account_id}"
"DOTA_UserRichPresence"	"{s:user_rich_presence}"
"DOTA_ProfileCard_StatTitle_SoloRank"	"Один. MMR"
"DOTA_ProfileCard_StatTitle_PartyRank"	"Груп. MMR"
"DOTA_ProfileCard_StatTitle_Wins"	"Побед"
"DOTA_ProfileCard_StatTitle_Commends"	"Похвал"
"DOTA_ProfileCard_StatTitle_GamesPlayed"	"Матчей"
"DOTA_ProfileCard_StatTitle_FirstMatchDate"	"В игре с"
"DOTA_ProfileCard_StatValue_Int"	"{d:stat_value}"
"DOTA_ProfileCard_StatValue_Date"	"{t:s:stat_value}"
"DOTA_ProfileCard_StatValue_String"	"{s:stat_value}"
"DOTA_ProfileCard_SlotTab_Trophies"	"Трофеи"
"DOTA_ProfileCard_SlotTab_Items"	"Арсенал"
"DOTA_ProfileCard_SlotTab_Heroes"	"Герои"
"DOTA_ProfileCard_SlotTab_Emoticons"	"Смайлики"
"DOTA_ProfileCard_NoTrophies"	"Нет трофеев."
"DOTA_ProfileCard_NoItems"	"Нет предметов."
"DOTA_ProfileCard_HeroOnly"	"Герой"
"DOTA_ProfileCard_HeroShowWins"	"Победы"
"DOTA_ProfileCard_HeroShowWinsAndLosses"	"Победы/поражения"
"DOTA_ProfileCard_ItemSearchPrefix"	"Искать:"
"DOTA_ProfileCard_ItemSearchPlaceholder"	"По названию"
"DOTA_ProfileCard_ItemArmoryLink"	"Открыть арсенал"
"DOTA_HeroTooltip_HeroName"	"{s:hero_name}"
"DOTA_HeroTooltip_HeroRecord"	"{s:hero_wins_string}, {s:hero_losses_string}"
"DOTA_ProfileCard_HeroSearchPlaceholder"	"Искать по имени героя"
"DOTA_Wins_Singular"	"1 победа"
"DOTA_Wins_Plural"	"Побед — {d:hero_wins}"
"DOTA_Losses_Singular"	"1 поражение"
"DOTA_Losses_Plural"	"поражений — {d:hero_losses}"
"DOTA_Profile_TotalGames"	"Всего игр"
"DOTA_Profile_Solo_MMR"	"Одиночный рейтинг"
"DOTA_Profile_Team_MMR"	"Рейтинг команды"
"DOTA_Profile_Party_MMR"	"Групповой рейтинг"
"DOTA_Profile_VictoryCount"	"Побед"
"DOTA_Profile_ProfilePage"	"Профиль"
"DOTA_Profile_TrophyPage"	"Трофеи"
"DOTA_Profile_RecentGamesPage"	"Недавние игры"
"DOTA_Profile_HeroPage"	"Герои"
"DOTA_Profile_PlayStyle"	"Стиль игры"
"DOTA_Profile_MostRecent"	"Данные по последним играм ({s:num_style_games})"
"DOTA_Profile_RecentActivity"	"Недавние действия"
"DOTA_Profile_Fighting"	"Сражение"
"DOTA_Profile_Fighting_TooltipTitle"	"Сражение"
"DOTA_Profile_Fighting_Tooltip"	"Активное участие в битвах с вражескими героями."
"DOTA_Profile_Farming"	"Добыча золота"
"DOTA_Profile_Farming_TooltipTitle"	"Добыча золота"
"DOTA_Profile_Farming_Tooltip"	"Получение золота за убийство существ."
"DOTA_Profile_Supporting"	"Поддержка"
"DOTA_Profile_Supporting_TooltipTitle"	"Поддержка"
"DOTA_Profile_Supporting_Tooltip"	"Поддержка своей команды лечением, вардами и предметами."
"DOTA_Profile_Pushing"	"Осада"
"DOTA_Profile_Pushing_TooltipTitle"	"Осада"
"DOTA_Profile_Pushing_Tooltip"	"Осада вражеских башен и отвлечение внимания противников."
"DOTA_Profile_Versatility"	"Гибкость"
"DOTA_Profile_Versatility_TooltipTitle"	"Гибкость"
"DOTA_Profile_Versatility_Tooltip"	"Разнообразие в выборе героев."
"DOTA_Profile_Tooltip_Value"	"{s:CurrentStatValue}"
"DOTA_Profile_Tooltip_Comparison"	"{s:CurrentComparisonValue}"
"DOTA_Profile_StatsCompare"	"Сравнить со мной"
"DOTA_Profile_Self"	"Я"
"DOTA_Profile_GPM"	"ЗВМ в среднем"
"DOTA_Profile_XPM"	"ОВМ в среднем"
"DOTA_Profile_LH"	"добито в среднем"
"DOTA_Profile_Rampages"	"буйств"
"DOTA_Profile_TripleKills"	"тройных убийств"
"DOTA_Profile_FirstBlood"	"первых убийств"
"DOTA_Profile_FirstBled"	"первых смертей"
"DOTA_Profile_CourierKills"	"убийств курьера"
"DOTA_Profile_Aegises"	"краж Aegis"
"DOTA_Profile_CheeseEaten"	"поеданий Cheese"
"DOTA_Profile_CreepStack"	"стакнутых лагерей"
"DOTA_Profile_GPMValue"	"{s:GPM}"
"DOTA_Profile_XPMValue"	"{s:XPM}"
"DOTA_Profile_LHValue"	"{s:LH}"
"DOTA_Profile_RampagesValue"	"{d:Rampages}"
"DOTA_Profile_TripleKillsValue"	"{d:TripleKills}"
"DOTA_Profile_FirstBloodValue"	"{d:FirstBlood}"
"DOTA_Profile_FirstBledValue"	"{d:FirstBled}"
"DOTA_Profile_CourierKillsValue"	"{d:CourierKills}"
"DOTA_Profile_AegisesValue"	"{d:Aegises}"
"DOTA_Profile_CheeseEatenValue"	"{d:CheeseEaten}"
"DOTA_Profile_CreepStackValue"	"{d:CreepStack}"
"DOTA_Profile_GPMLocalValue"	"{s:GPMLocal}"
"DOTA_Profile_XPMLocalValue"	"{s:XPMLocal}"
"DOTA_Profile_LHLocalValue"	"{s:LHLocal}"
"DOTA_Profile_RampagesLocalValue"	"{d:RampagesLocal}"
"DOTA_Profile_TripleKillsLocalValue"	"{d:TripleKillsLocal}"
"DOTA_Profile_FirstBloodLocalValue"	"{d:FirstBloodLocal}"
"DOTA_Profile_FirstBledLocalValue"	"{d:FirstBledLocal}"
"DOTA_Profile_CourierKillsLocalValue"	"{d:CourierKillsLocal}"
"DOTA_Profile_AegisesLocalValue"	"{d:AegisesLocal}"
"DOTA_Profile_CheeseEatenLocalValue"	"{d:CheeseEatenLocal}"
"DOTA_Profile_CreepStackLocalValue"	"{d:CreepStackLocal}"
"DOTA_RecentGames_Title"	"Последние игры"
"DOTA_RecentGames_TimeStamp"	"Дата/время"
"DOTA_RecentGames_HeroSelection"	"Герой"
"DOTA_RecentGames_GameResult"	"Исход"
"DOTA_RecentGames_GameLength"	"Длительность"
"DOTA_RecentGames_Team"	"Команда"
"DOTA_RecentGames_GameType"	"Тип"
"DOTA_RecentGames_Items"	"Предметы"
"DOTA_RecentGame_Timestamp_Entry"	"{t:s:timestamp} {t:t:timestamp}"
"DOTA_RecentGame_Duration"	"{t:d:duration}"
"DOTA_RecentGame_Downloading"	"Загружено: {s:DownloadPercent}"
"DOTA_RecentGame_Watch"	"Смотреть запись"
"DOTA_RecentGame_NoReplay"	"Записи нет"
"DOTA_RecentGame_Expired"	"Истек срок хранения"
"DOTA_RecentGame_Finding"	"Поиск…"
"DOTA_RecentGame_Download"	"Загрузить запись"
"DOTA_RecentGame_Pending"	"Запись обрабатывается"
"DOTA_RecentGame_Unavailable"	"Запись недоступна"
"DOTA_RecentGame_MatchID"	"ID матча: №{s:match_id}"
"DOTA_No_Team_Name"	"--"
"DOTA_TrophyCount"	"Трофеев: {d:trophy_count}"
"DOTA_TrophiesCount"	"Трофеев: {d:trophy_count}"
"DOTA_TrophyCount_Number"	"{d:trophy_count}"
"DOTA_TrophyCount_NoNum"	"Трофей"
"DOTA_TrophiesCount_NoNum"	"Трофеев"
"DOTA_Trophies_ViewAll"	"Посмотреть все"
"DOTA_TrophyName"	"{s:trophy_name}"
"DOTA_TrophyCategory"	"{s:trophy_category}"
"DOTA_TrophyDescription"	"{s:trophy_description}"
"DOTA_TrophyXP"	"{d:trophy_xp} очков трофеев"
"DOTA_NextTrophy"	"Следующая награда:"
"DOTA_NewPlayerQuestion_Title"	"ДОБРО ПОЖАЛОВАТЬ В DOTA 2"
"DOTA_PlayerOriginQuestion_Question"	"Чтобы мы узнали вас получше, скажите, насколько вы знакомы с Dota 2 и подобными ей играми:"
"DOTA_PlayerOriginQuestion_BeginnerButton"	"Я новичок."
"DOTA_PlayerOriginQuestion_RTSButton"	"Я играл в стратегии в реальном времени."
"DOTA_PlayerOriginQuestion_MOBAButton"	"Я играл в игру, похожую на Dota 2."
"DOTA_PlayerOriginQuestion_Dota2Button"	"Я уже играл в Dota 2."
"DOTA_PlayerOriginQuestion_MOBAExplanation"	"Выберите игру, в которой вы чувствуете себя наиболее комфортно:"
"DOTA_OtherGames_LOL"	"League of Legends"
"DOTA_OtherGames_DOTA"	"Первая DotA"
"DOTA_OtherGames_HON"	"Heroes of Newerth"
"DOTA_OtherGames_Smite"	"Smite"
"DOTA_OtherGames_Other"	"Другая игра"
"DOTA_PlayerOriginQuestion_ConfirmationButton"	"СЫГРАЕМ"
"DOTA_PlayerOriginQuestion_ConfirmationTutorial"	"Как новичку в Dota, вам могут быть интересны обучающие материалы, расположенные во вкладке Игра > Обучение. Это важный, первый шаг на пути к превосходству над другими игроками со всего мира."
"DOTA_PlayerOriginQuestion_ConfirmationSettings"	"Ваши привязки клавиш и настройки установлены на уровне игроков с вашим опытом. Вы можете изменить их в любой момент, нажав на иконку настроек."
"DOTA_Tutorial_SkipButton"	"Пропустить обучение"
"DOTA_ConfirmSkip"	"Пропустить введение в Dota 2?"
"DOTA_ConfirmSkipDesc"	"Вы уверены, что хотите пропустить обучение Dota 2?"
"DOTA_Tutorial_Start_Quest"	"НАЧАТЬ ЗАДАНИЕ"
"DOTA_Tutorial_Quest0_Title"	"ЗАДАНИЕ №1"
"DOTA_Tutorial_Quest0_TitleDesc"	"ГЕРОЙ ДАЛЬНЕГО БОЯ"
"DOTA_Tutorial_Quest0DetailsDesc"	"Это задание займет около\n10 минут."
"DOTA_Tutorial_QuestDetailsLearn"	"Вы узнаете о:"
"DOTA_Tutorial_Quest0DetailsLesson"	"Перемещении героя\nПолучении уровней\nПрименении способностей\nПредметах\nОсновах боя\nДобивании"
"DOTA_Tutorial_Quest1_Title"	"ЗАДАНИЕ №2"
"DOTA_Tutorial_Quest1_TitleDesc"	"СРАЖЕНИЕ НА ЛИНИИ"
"DOTA_Tutorial_Quest1DetailsDesc"	"Это задание займет около\n10 минут."
"DOTA_Tutorial_Quest1DetailsLesson"	"Дальний бой\nСпособности, действующие по площади\nМини-карта\nБашни\nКурьеры и тайник\nТелепортация"
"DOTA_Tutorial_Quest2_Title"	"ЗАДАНИЕ №3"
"DOTA_Tutorial_Quest2_TitleDesc"	"СРАЖЕНИЕ НА ЛИНИИ"
"DOTA_Tutorial_Quest2DetailsDesc"	"Это задание займет\n10 - 15 минут."
"DOTA_Tutorial_Quest2DetailsLesson"	"Бой на линии\nЗащита башен и нападение на них\nНачальные предметы"
"DOTA_Challenges_Title"	"Обучение"
"DOTA_ChallengeGroup_0_Title"	"Механика"
"DOTA_ChallengeGroup_1_Title"	"Обучающие матчи с ботами"
"DOTA_ChallengeGroup_1_Desc"	"Начните отсюда!"
"DOTA_ChallengeGroup_2_Title"	"Матчи с ботами"
"DOTA_ChallengeGroup_More"	"Позже"
"DOTA_ChallengeGroup_Locked"	"Закрыто"
"DOTA_LearnMechanics_Title"	"Механика"
"DOTA_LearnMechanics_SubTitle"	"Изучите основы игры: управление героем, получение золота и опыта, покупку предметов и многое другое. Если вы не имеете опыта в играх, похожих на Dota, вам сюда."
"DOTA_Mechanics_0_Title"	"Механика 1"
"DOTA_Mechanics_0_Desc"	"Перемещение героя\nПолучение уровней\nПрименение способностей\nПредметы\nПростой бой\nДобивание"
"DOTA_Mechanics_1_Title"	"Механика 2"
"DOTA_Mechanics_1_Desc"	"Дальний бой\nСпособности, действующие по площади\nМини-карта\nБашни\nКурьеры и тайник\nСвитки телепортации"
"DOTA_LearnGuidedBotMatches_Title"	"Обучающие матчи с ботами"
"DOTA_LearnGuidedBotMatches_SubTitle"	"Вступите в обучающую битву против героев под управлением компьютера. Мы проведем вас шаг за шагом через каждую стадию игры, и вы превратите своего героя в неудержимую силу."
"DOTA_GuidedBotMatches_0_Title"	"Luna"
"DOTA_GuidedBotMatches_0_Desc"	"Малая дистанция боя\nВысокий урон атаки\nВысокая скорость передвижения\nУмеренно уязвима\nОпирается на ловкость"
"DOTA_GuidedBotMatches_1_Title"	"Sven"
"DOTA_GuidedBotMatches_1_Desc"	"Ближний бой\nНевероятно высокий урон атаки\nУстойчив к урону\nУязвим к замедлению\nПолагается на силу"
"DOTA_GuidedBotMatches_2_Title"	"Lina"
"DOTA_GuidedBotMatches_2_Desc"	"Большая дистанция атаки\nНевероятно высокий урон способностей\nКороткая перезарядка\nОчень уязвима\nПолагается на интеллект"
"DOTA_LearnBotMatches_Title"	"Матчи с ботами"
"DOTA_LearnBotMatches_SubTitle"	"Потренируйтесь в непринужденной обстановке, где союзниками и противниками управляет компьютер."
"DOTA_BotMatches_0_Title"	"Легкие боты"
"DOTA_BotMatches_0_Desc"	"Изучите нового героя."
"DOTA_BotMatches_1_Title"	"Средние боты"
"DOTA_BotMatches_1_Desc"	"Освойтесь."
"DOTA_BotMatches_2_Title"	"Сложные боты"
"DOTA_BotMatches_2_Desc"	"Испытайте себя."
"DOTA_BotMatches_3_Title"	"Безумные боты"
"DOTA_BotMatches_3_Desc"	"Приготовьтесь к боли."
"FileOpenDialog_Open"	"Открыть"
"FileOpenDialog_Save"	"Сохранить"
"FileOpenDialog_Select"	"Выбрать"
"FileOpenDialog_FileType_Folder"	"Папка"
"DOTA_FindMatch"	"Найти игру"
"DOTA_FindingMatch"	"Поиск матча ({s:find_match_time})"
"DOTA_FindMatchTime"	"{s:find_match_time}"
"DOTA_Searching"	"Поиск"
"DOTA_StartSoloBotMatch"	"Игра с ботами"
"DOTA_Create_Lobby"	"Создать лобби"
"DOTA_Join_Lobby"	"Войти в лобби"
"DOTA_LobbyStartGame"	"Начать игру"
"DOTA_ReturnToLobby"	"Вернуться в лобби"
"DOTA_FindMatchStatus"	"{s:searching_matchtype} / {s:searching_gamemodes} / {s:searching_region}"
"DOTA_FindGameModesMany"	"Режимы игры: "
"DOTA_FindRegionsMany"	"Регионы: "
"DOTA_GameMode_AllPick"	"All Pick"
"DOTA_GameMode_SingleDraft"	"Single Draft"
"DOTA_GameMode_CaptainsMode"	"Captains Mode"
"DOTA_GameMode_RandomDraft"	"Random Draft"
"DOTA_GameMode_AbilityDraft"	"Ability Draft"
"DOTA_GameMode_LeastPlayed"	"Least Played"
"DOTA_GameMode_AllRandom"	"All Random"
"DOTA_GameMode_LimitedHeroes"	"Limited Heroes"
"DOTA_GameMode_CaptainsDraft"	"Captains Draft"
"DOTA_GameMode_AllRandomDeathMatch"	"All Random Death Match"
"DOTA_ImmediatePurchase_SendFailed"	"Не удалось отправить запрос на покупку. Возможно, серверы Dota отключены. Повторите попытку позже."
"DOTA_ImmediatePurchase_Timeout"	"Истекло время ожидания ответа на запрос на покупку. Пожалуйста, повторите попытку позднее."
"DOTA_ImmediatePurchase_InitFailed"	"Не удалось запустить покупку через Perfect World. Пожалуйста, повторите попытку позже."
"DOTA_ImmediatePurchase_InsufficientFundsPW"	"На вашем аккаунте Perfect World недостаточно средств для совершения покупки. Пожалуйста, пополните баланс и повторите попытку."
"DOTA_ImmediatePurchase_Success_Title"	"Покупка совершена"
"DOTA_ImmediatePurchase_Success_Text"	"Покупка успешно совершена! Вскоре ваши предметы появятся в арсенале."
"DOTA_ImmediatePurchase_Cancelled_Title"	"Покупка отменена"
"DOTA_ImmediatePurchase_UnbundleTimeout"	"Превышено время ожидания для запроса о распаковке набора. Пожалуйста, повторите попытку позже."
"DOTA_ImmediatePurchase_UnbundleFailure"	"Не удалось распаковать набор. Пожалуйста, повторите попытку позже."
"DOTA_ImmediatePurchase_LateCancel"	"Покупка была отменена ранее. Деньги с вашего счета не списаны."
"DOTA_ConfirmPurchaseTitle"	"Подтверждение"
"DOTA_ConfirmPurchaseText"	"Вы уверены, что желаете приобрести этот предмет?"
"DOTA_PurchaseInProgress_Title"	"Покупка"
"DOTA_PurchaseInProgress_Text"	"Ваш запрос на покупку обрабатывается."
"DOTA_UnbundleInProgress_Title"	"Распаковка"
"DOTA_UnbundleInProgress_Text"	"Ваш набор распаковывается."
"DOTA_ConfirmUnbundleTitle"	"Подтверждение"
"DOTA_ConfirmUnbundleText"	"Чтобы использовать предметы из набора, их нужно распаковать. Продолжить?"
"DOTA_RequestingBalance_Title"	"Проверка баланса"
"DOTA_RequestingBalance_Text"	"Запрашивается баланс вашей учетной записи Perfect World…"
"DOTA_PartnerPurchaseRecharge_Title"	"Пополнение баланса"
"DOTA_PartnerPurchaseRecharge_Text"	"Переход к пополнению баланса…"
"DOTA_PartnerPurchase_Purchase"	"{g:dota_item_price:item_def}"
"DOTA_PartnerPurchase_Recharge"	"Пополнить счет аккаунта"
"DOTA_PartnerPurchase_Balance"	"Баланс: {m:balance}"
"DOTA_PartnerRecharge_Close"	"Вернуться к покупке"
"RequestBalanceBadAccount"	"Не удалось запросить баланс: аккаунт не найден."
"RequestBalanceAccountNotLinked"	"Не удалось запросить баланс: ваш аккаунт не связан с Perfect World."
"RequestBalanceUnsupportedPartner"	"Не удалось запросить баланс: ваш аккаунт не связан с известным нам партнером."
"StoreCheckout_Error_Title"	"Ошибка"
"StoreCheckout_NoItems"	"Ваша корзина пуста!"
"StoreCheckout_TooManyItems"	"В вашей корзине слишком много предметов!"
"StoreCheckout_Loading"	"Покупка…"
"StoreCheckout_Unavailable"	"В данный момент покупка невозможна."
"StoreCheckout_Cancelling"	"Отмена..."
"StoreCheckout_Fail"	"В данный момент магазин закрыт."
"StoreCheckout_InvalidParam"	"Программная ошибка! Координатору игры был передан неверный параметр. Попробуйте совершить покупку еще раз."
"StoreCheckout_InternalError"	"Произошла ошибка при инициализации или обновлении перевода. Подождите несколько минут и повторите попытку, либо обратитесь в службу поддержки."
"StoreCheckout_ContactSupport"	"Во время покупки произошла ошибка. Пожалуйста, обратитесь за помощью в службу поддержки."
"StoreCheckout_NotApproved"	"Координатор игры не смог утвердить операцию через Steam. Пожалуйста, попробуйте совершить покупку через некоторое время."
"StoreCheckout_NotLoggedin"	"Чтобы совершить покупку, вы должны подключиться к Steam."
"StoreCheckout_WrongCurrency"	"Валюта, выбранная для оплаты, не совпадает с валютой в вашем кошельке."
"StoreCheckout_NoAccount"	"В настоящее время ваш счет в Steam недоступен. Пожалуйста, попробуйте совершить покупку через некоторое время."
"StoreCheckout_InsufficientFunds"	"У вас недостаточно средств на счету, чтобы совершить эту покупку."
"StoreCheckout_TimedOut"	"Время, отведенное на перевод средств, истекло. Пожалуйста, попробуйте совершить покупку еще раз."
"StoreCheckout_SteamAccountDisabled"	"Ваш аккаунт Steam заблокирован, вы не можете делать покупки."
"StoreCheckout_SteamAccountNoPurchase"	"Операции с кошельком Steam недоступны для данного аккаунта."
"StoreCheckout_OldPriceSheet"	"Каталог товаров устарел. Запрашивается новая версия."
"StoreCheckout_TransactionNotFound"	"Координатор игры не нашел идентификатор сделки. Пожалуйста, попробуйте совершить покупку снова."
"StoreCheckout_TransactionCancelled"	"Операция отменена. Средства не были списаны."
"StoreCheckout_TransactionCompleted"	"Операция совершена!\nНаслаждайтесь покупками!"
"StoreCheckout_CompleteButUnfinalized"	"Невозможно подтвердить покупку. При ее успешном завершении вы получите товар с небольшой задержкой."
"StoreCheckout_NotEnoughRoom"	"В арсенале недостаточно места для покупки такого количества предметов."
"StoreCheckout_ContactSupport_Dialog_Title"	"Предупреждение"
"StoreCheckout_ContactSupport_Dialog_Btn"	"Связаться"
"StoreCheckout_LimitedQuantityItemsUnavailable"	"Товар, который вы пытаетесь купить, уже распродан или недоступен."
"StoreCheckout_Nexon_InsufficientFunds"	"У вас недостаточно средств, чтобы совершить покупку."
"StoreCheckout_Nexon_FundsLocked"	"Включена блокировка на наличные Nexon."
"npc_dota_hero_abaddon_hype"	"Abaddon, способный лечиться за счет вражеских атак, может пережить почти любое нападение. Он всегда готов нестись в гущу битвы, закрывая щитом союзников и запуская свою обоюдоострую спираль во врага или товарища."
"npc_dota_hero_alchemist_hype"	"Alchemist, синтезирующий дополнительные средства за каждое убийство, с легкостью получит необходимое вооружение. Он сражается во имя своей жадности, используя едкую кислоту и запас нестабильных химикатов."
"npc_dota_hero_ancient_apparition_hype"	"Ancient Apparition, способный запустить мощный заряд льда через поле битвы, может заморозить раненых врагов до смерти, где бы те ни находились. Он держит врагов в напряжении, замедляя их и усиляя своих союзников."
"npc_dota_hero_antimage_hype"	"Если Anti-Mage наберет полную силу, мало кто сможет его остановить. Он способен забирать у врагов ману каждым ударом или телепортироваться на небольшие расстояния, что не позволяет врагам загнать его в угол."
"npc_dota_hero_axe_hype"	"Axe рубит одного врага за другим, всегда находясь впереди своей команды. Он не дает противникам ретироваться, а затем отвечает на их удары смертоносным взмахом топора. Круша ослабленных врагов, он всегда несется вперед."
"npc_dota_hero_bane_hype"	"Bane наводит ужас на врагов своим арсеналом обездвиживающих способностей. Погружая врагов в заразительные кошмары или захватывая их на месте, он дает союзникам достаточно времени, чтобы прикончить противника."
"npc_dota_hero_batrider_hype"	"Взмыв в небеса, Batrider может нанести удар с любой стороны. Захватив противника своим лассо, он поднимается над верхушками деревьев и тащит жертву по тропе огня прямо к своим беспощадным союзникам."
"npc_dota_hero_beastmaster_hype"	"Beastmaster никогда не выходит на охоту неподготовленными. Он призывает на помощь изрыгающего яд борова и зоркого ястреба, прорубает свой путь через лес топорами, а его оглушительный рев служит сигналом к нападению на врагов."
"npc_dota_hero_bloodseeker_hype"	"Bloodseeker ставит противников перед непростым выбором. Окропив обширную территорию кровью, он вынуждает врагов отступать, а под его чудовищным ультом жертва либо стоит на месте, либо погибает."
"npc_dota_hero_bounty_hunter_hype"	"Bounty Hunter незаметно крадется по следам своих врагов и не спускает с них глаз. Когда его жертва падает замертво, он и его союзники получают хорошую прибыль."
"npc_dota_hero_brewmaster_hype"	"Грозный воитель Brewmaster способен изменить ход сражения, обернувшись тремя духами стихий с уникальными способностями, а в своей изначальной форме он погружает врагов в хмельной хаос замедляющими ударами и мощными взмахами своего посоха."
"npc_dota_hero_bristleback_hype"	"Bristleback всегда готов к сражению. Уменьшая весь урон, который ему наносят сзади и сбоку, он безрассудно бросается в бой и поливает врагов смертоносными иглами и замедляющими соплями."
"npc_dota_hero_broodmother_hype"	"Скрываясь от чужих глаз в своей паутине, Broodmother взращивает армию пауков, которые идут в наступление на базу врага. Если по пути попадется жертва, она присоединяется к своим отпрыскам и нападает, замедляя врагов выводящими из строя укусами и утоляя свой неугасимый голод."
"npc_dota_hero_centaur_hype"	"Centaur Warrunner умело наносит и принимает урон. Он ведет команду в наступление, оглушает своим топотов врагов и мгновенно отвечает на каждый удар, ускоряя как союзников, так и смерть неприятелей."
"npc_dota_hero_chaos_knight_hype"	"Chaos Knight — сам по себе армия. Он способен призывать кавалерию своих копий и разрушать строения врага, а когда покажутся защитники, он расколет реальность и перенесет себя и свои копии на расстояние, достаточное для рокового взмаха дубины."
"npc_dota_hero_chen_hype"	"Обратив лесных существ в свою веру, Chen ведет свою импровизированную армию на помощь команде. Он насылает зверей на противников, союзников отправляет в безопасное место, а в крайнем случае излечивает их, где бы они ни были."
"npc_dota_hero_clinkz_hype"	"Невидимый Clinkz рыщет по полю битвы, и от внезапного нападения не спастись никому. Этот скорый лучник накрывает врагов дождем огненных стрел, а затем вбирает в себя жизнь лесных существ и готовится нанести следующий удар."
"npc_dota_hero_rattletrap_hype"	"Притягиваясь ко врагам своим крюком, Clockwerk отделяет жертву и разрывает ее на части дезориентирующей шрапнелью. Разведывая поле битвы своими ракетами, он всегда находит цель, в которую нужно влететь."
"npc_dota_hero_crystal_maiden_hype"	"Способная предоставлять ману союзникам и не давать врагам уйти от гибели, Crystal Maiden — полезное дополнение к любой команде. А когда представляется случай, она может уничтожить врагов своим сокрушительным ультом."
"npc_dota_hero_dark_seer_hype"	"Ловкий стратег Dark Seer мастерски манипулирует местоположением своих врагов. Он способен затянуть неприятелей в гущу союзников и обратить мощь врагов против них самих своей отражающей стеной."
"npc_dota_hero_dazzle_hype"	"Рожденный поддерживать своих сторонников, Dazzle не дает соратникам умереть, пока те убивают врагов. Его необычные заклинания вплетаются в броню, ослабляя противников и усиливая союзников."
"npc_dota_hero_death_prophet_hype"	"Своей армией призраков Death Prophet уничтожает как противников, так и их постройки. Возглавив наступление и выпуская одну смертоносную волну за другой, она может повергнуть врагов в отчаяние."
"npc_dota_hero_disruptor_hype"	"Disruptor мастерски разрушает планы врагов. Он способен создать непроходимый барьер и спустить на попавшихся в ловушку врагов заглушающую бурю, а если противник предпримет что-то неожиданное, то Disruptor вернет его туда, где тот стоял раньше."
"npc_dota_hero_doom_bringer_hype"	"Doom забирает жизни своих врагов разными способами. Пожирая существ, он перенимает их способности, а также он способен наслать на врага адское пламя, не дающее тому использовать способности и предметы."
"npc_dota_hero_dragon_knight_hype"	"Страх сковывает любого, кто видит Dragon Knight в его ужасающей драконьей форме. Сильный и изворотливый, он ведет своих союзников к победе, сжигая и оглушая всех стоящих на пути врагов."
"npc_dota_hero_earthshaker_hype"	"Внезапные атаки Earthshaker не дают врагам убежать, разделяют их силы и разрывают под ними землю, а всех, кому удалось выжить, он добивает взмахами своего могучего тотема."
"DOTA_AbilityTooltip_Name"	"{s:name}"
"DOTA_AbilityTooltip_Level"	"Уровень {s:level}"
"DOTA_AbilityTooltip_TargetType"	"ДЕЙСТВУЕТ НА: {s:targettype}"
"DOTA_AbilityTooltip_CastType"	"СПОСОБНОСТЬ: {s:casttype}"
"DOTA_AbilityTooltip_DamageType"	"ТИП УРОНА: {s:damagetype}"
"DOTA_AbilityTooltip_SpellImmunityType"	"СКВОЗЬ НЕВОСПРИИМЧИВОСТЬ К МАГИИ: {s:spellimmunity}"
"DOTA_AbilityTooltip_Description"	"{s:description}"
"DOTA_AbilityTooltip_ScepterDescription"	"{s:scepterdescription}"
"DOTA_AbilityTooltip_ExtraDescription"	"{s:extradescription}"
"DOTA_AbilityTooltip_Attributes"	"{s:attributes}"
"DOTA_AbilityTooltip_Cooldown"	"{s:cooldown}"
"DOTA_AbilityTooltip_ManaCost"	"{s:manacost}"
"DOTA_AbilityTooltip_Lore"	"{s:lore}"
"DOTA_AbilityTooltip_UpgradeLevel"	"Следующее улучшение на {d:upgradelevel}-м уровне"
"DOTA_AbilityTooltip_BuildHeader"	"Руководство по способности"
"DOTA_AbilityTooltip_BuildComment"	"{s:buildcomment}"
"DOTA_PersonaTooltip_Title"	"{g:dota_persona:account_id}"
"DOTA_PersonaTooltip_TitlePro"	"{g:dota_persona_pro:account_id}"
"DOTA_PendingInvites"	"Приглашения в группу"
"DOTA_PendingInvitesTooltip_None"	"Нет ожидающих приглашений"
"DOTA_PendingInvitesTooltip_1"	"Приглашений: 1"
"DOTA_PendingInvitesTooltip_N"	"Приглашений: {d:pending_invite_count}"
"DOTA_PendingInvitesTooltip_Leader"	"Принять/отклонить приглашения."
"DOTA_PendingInvitesTooltip_NonLeader"	"Просмотреть приглашения."
"DOTA_PendingInvitesCancelAll"	"Отменить все приглашения"
"DOTA_PendingInvitesNotPartyLeader"	"Только руководитель группы может управлять приглашениями"
"DOTA_ChatTab_NotInChannelMessage"	"Вас никто не слышит."
"DOTA_ChatTab_ToggleGlobal"	"Показывать сообщения из этого канала во всех вкладках."
"DOTA_ChatTab_Close"	"Закрыть вкладку."
"DOTA_ChatTab_Leave"	"Покинуть канал."
"DOTA_JoinChatChannel_Title"	"Войти в канал"
"DOTA_JoinChatChannel_Description"	"Создать канал чата или войти в существующий."
"DOTA_JoinChatChannel_AddToCurrentTab"	"Добавить в текущую вкладку «{s:current_tab_name}»"
"DOTA_JoinChatChannel_CreateNewTab"	"Создать вкладку:"
"DOTA_Chat_ChannelName"	"{s:channel_name}"
"DOTA_Chat_ChannelMemberCount_Singular"	"Участников: 1"
"DOTA_Chat_ChannelMemberCount_Plural"	"Участников: {d:channel_member_count}"
"DOTA_EditChatTab_Title"	"Настроить вкладку"
"DOTA_EditChatTab_Description"	"Выберите сообщения, которые нужно показывать в этой вкладке."
"DOTA_EditChatTab_AddNewChannel"	"Добавить новый канал…"
"DOTA_EditChatTab_TabName"	"Название вкладки:"
"DOTA_EditChatTab_ChannelToggleDisabled"	"{s:target} должен находиться хотя бы в одной из вкладок."
"DOTA_EditChatTab_Target"	"{s:target}"
"DOTA_Chat_TimestampFormat"	"{t:t:timestamp}"
"DOTA_Chat_Autocomplete_Title"	"{s:autocomplete_title}"
"DOTA_Chat_Autocomplete_NoMatches"	"Совпадений нет"
"DOTA_Chat_Autocomplete_WhisperFriends"	"Шепнуть другу"
"DOTA_Chat_Autocomplete_InviteFriends"	"Пригласить друга"
"DOTA_Chat_Autocomplete_Channels"	"Каналы"
"DOTA_Chat_Autocomplete_Commands"	"Команды"
"DOTA_Chat_Autocomplete_CommandName"	"/{s:command_name}"
"DOTA_Chat_Autocomplete_CommandDescription"	"{s:command_description}"
"dota_suggest_invite_format"	"Пожалуйста, пригласите {s:invite_persona} в группу."
"dota_suggest_invite_format_leader"	"Пожалуйста, пригласите {s:invite_persona} в группу. <a href=\"event:DOTAInviteToParty({s:invite_persona_steamid})\" class=\"InviteButton\">Пригласить</a>"
"dota_suggest_invite_format_lobby"	"Пожалуйста, пригласите {s:invite_persona} в группу."
"dota_suggest_invite_format_lobby_leader"	"Пожалуйста, пригласите {s:invite_persona} в группу. <a href=\"event:DOTAInviteToLobby({s:invite_persona_steamid})\" class=\"InviteButton\">Пригласить</a>"
"DOTA_ChatMessage_Default"	"<span class=\"{s:target_class}\"><span class=\"ChatTarget\">(<a href=\"{s:target_link}\">{s:target}</a>)</span> <span class=\"ChatPersona\">[{s:persona}]</span>: {s:message}</span>"
"DOTA_ChatMessage_WhisperTo"	"<span class=\"{s:target_class}\">Для <span class=\"ChatPersona\">[{s:event_crest}{s:persona}]</span>: {g:dota_filtered_string:message}</span>"
"DOTA_ChatMessage_WhisperFrom"	"<span class=\"{s:target_class}\">От <span class=\"ChatPersona\">[{s:event_crest}{s:persona}]</span>: {g:dota_filtered_string:message}</span>"
"DOTA_ChatMessage_System"	"<span class=\"{s:target_class}\"><span class=\"ChatTarget\">({s:target})</span>: {g:dota_filtered_string:message}</span>"
"DOTA_ChatTarget_Format_Default"	"{s:target}"
"DOTA_ChatTarget_Prompt_Default"	"Для ({s:target}):"
"DOTA_ChatTarget_Format_Whisper"	"{s:persona}"
"DOTA_ChatTarget_Prompt_Whisper"	"Для [{s:persona}]:"
"DOTA_ChatTarget_Party"	"Группа"
"DOTA_ChatTarget_Lobby"	"Лобби"
"DOTA_ChatTarget_Team"	"Команда"
"DOTA_ChatTarget_Guild"	"Гильдия"
"DOTA_ChatTarget_Fantasy"	"Фэнтези-лига"
"DOTA_ChatTarget_Console"	"Консоль"
"DOTA_ChatTarget_Whisper"	"Шепот"
"DOTA_ChatTarget_Invalid"	"Нет канала"
"DOTA_ChatTarget_GameAll"	"Всем"
"DOTA_ChatTarget_GameAllies"	"Союзникам"
"DOTA_ChatTarget_GameCoaching"	"Обучение"
"DOTA_ChatTarget_GameSpectator"	"Зрителям"
"DOTA_ChatTargetMenu_Title"	"{s:target}"
"DOTA_ChatTargetMenu_ToggleEnabled"	"{s:toggle_enabled}"
"DOTA_ChatTargetMenu_NotActive"	"(нет действующих)"
"DOTA_Chat_Placeholder"	"Общаться можно здесь. Команды начинаются с символа «/»."
"DOTA_Chat_MissedMessages"	"{s:missed_message_count}"
"DOTA_ChatCommand_Party"	"p"
"DOTA_ChatCommand_Party_Name"	"Группа"
"DOTA_ChatCommand_Party_Description"	"Общение со своей группой."
"DOTA_ChatCommand_Lobby"	"l"
"DOTA_ChatCommand_Lobby_Name"	"Лобби"
"DOTA_ChatCommand_Lobby_Description"	"Общение в текущем лобби."
"DOTA_ChatCommand_Channel"	"c"
"DOTA_ChatCommand_Channel_Name"	"Канал"
"DOTA_ChatCommand_Channel_Description"	"Сообщение указанному каналу чата."
"DOTA_ChatCommand_Whisper"	"w"
"DOTA_ChatCommand_Whisper_Name"	"Шепнуть"
"DOTA_ChatCommand_Whisper_Description"	"Шепнуть другу незаметно от остальных."
"DOTA_ChatCommand_Reply"	"r"
"DOTA_ChatCommand_Reply_Name"	"Ответить"
"DOTA_ChatCommand_Reply_Description"	"Ответить на шёпот друга."
"DOTA_ChatCommand_Help"	"?"
"DOTA_ChatCommand_Help_Name"	"Справка"
"DOTA_ChatCommand_Help_Description"	"Показать справку по командам."
"DOTA_ChatCommand_InviteToParty"	"partyinvite"
"DOTA_ChatCommand_InviteToParty_Name"	"Пригласить в группу"
"DOTA_ChatCommand_InviteToParty_Description"	"Пригласить друга в свою группу."
"DOTA_ChatCommand_LeaveParty"	"leaveparty"
"DOTA_ChatCommand_LeaveParty_Name"	"Покинуть группу"
"DOTA_ChatCommand_LeaveParty_Description"	"Покинуть свою группу."
"DOTA_ChatCommand_JoinChannel"	"joinchannel"
"DOTA_ChatCommand_JoinChannel_Name"	"Войти в канал"
"DOTA_ChatCommand_JoinChannel_Description"	"Создать канал чата или войти в существующий канал."
"DOTA_ChatCommand_LeaveChannel"	"leavechannel"
"DOTA_ChatCommand_LeaveChannel_Name"	"Покинуть канал"
"DOTA_ChatCommand_LeaveChannel_Description"	"Выйти из указанного канала чата."
"DOTA_ChatCommand_GameAll"	"all"
"DOTA_ChatCommand_GameAll_Name"	"Всем"
"DOTA_ChatCommand_GameAll_Description"	"Общение со всеми в игре."
"DOTA_ChatCommand_GameAllies"	"союзникам"
"DOTA_ChatCommand_GameAllies_Name"	"Союзникам"
"DOTA_ChatCommand_GameAllies_Description"	"Общение со своими союзниками."
"DOTA_ChatCommand_GameCoaching"	"coach"
"DOTA_ChatCommand_GameCoaching_Name"	"Обучение"
"DOTA_ChatCommand_GameCoaching_Description"	"Общение со своим учеником или тренером."
"DOTA_ChatCommand_GameSpectator"	"spectator"
"DOTA_ChatCommand_GameSpectator_Name"	"Зрителям"
"DOTA_ChatCommand_GameSpectator_Description"	"Общение с другими зрителями."
"DOTA_ChatCommand_Clear"	"clear"
"DOTA_ChatCommand_Clear_Name"	"Очистить"
"DOTA_ChatCommand_Clear_Description"	"Стереть содержимое этой вкладки."
"DOTA_Chat_UnknownCommandMessage"	"Неизвестная команда чата «{s:chat_command}»"
"DOTA_ChatHelp_Targets"	"Получатели"
"DOTA_ChatHelp_Commands"	"Команды"
"DOTA_ChatHelp_NameFormat"	"{s:command_name}:"
"DOTA_ChatHelp_CommandFormat"	"/{s:command}"
"DOTA_Chat_JoinedParty"	"Вошел в группу к {s:party_members}"
"DOTA_Chat_LeftParty"	"Группа распущена."
"DOTA_Chat_MemberJoinedParty"	"Игрок вошел в группу к {s:party_members}"
"DOTA_Chat_MemberLeftParty"	"Игрок покинул группу ({s:party_members})"
"DOTA_Chat_InvitedToJoinParty"	"Приглашены: {s:party_members}"
"DOTA_Chat_RequestedToJoinParty"	"Хочет присоединиться к {s:party_members}"
"DOTA_Chat_PartyMemberSeparator"	", "
"DOTA_Feature_Under_Construction_Title"	"В разработке"
"DOTA_Feature_Under_Construction_Text"	"Эта функция находится в разработке и еще не доступна."
"DOTA_Treasure_Purchase_Under_Construction_Text"	"Покупка сокровищниц пока что не доступна, но покупки из магазина Dota 2 поддерживаются. Взгляните на наборы предметов в левой части списка доступных предметов."
"DOTA_Marketplace_Purchase_Under_Construction_Text"	"Покупка с Торговой площадки пока что не доступна, но покупки из магазина Dota 2 поддерживаются. Взгляните на наборы предметов в левой части списка доступных предметов."
"DOTA_PartyJoinRequest_Title"	"Запрос на присоединение к группе"
"DOTA_PartyJoinRequest_Description"	"{g:dota_persona:b:inviter} хочет войти в вашу группу."
"DOTA_PartyMergeRequest_Title"	"Запрос на объединение групп"
"DOTA_PartyMergeRequest_Description"	"{g:dota_persona:b:inviter} хочет объединить свою группу с вашей."
"DOTA_PartyMergeRequestLowPriWarning"	"Примечание: приняв запрос, вы поместите свою группу в низкий приоритет."
"DOTA_PartyInvite_Title"	"Приглашение в группу"
"DOTA_Invite_IOfN"	"{d:received_invite_index} / {d:received_invite_count}"
"DOTA_PartyInvite_Description"	"{g:dota_persona:b:inviter} приглашает вас в группу."
"DOTA_PartyInvite_LowPriority_Title"	"Приглашение в группу с низким приоритетом"
"DOTA_PartyInvite_LowPriority_Description"	"{g:dota_persona:b:inviter} приглашает вас в группу с низким приоритетом."
"DOTA_PartyInvite_BlockPartyLeader"	"Заблокировать все связи с {g:dota_persona:b:inviter}"
"DOTA_LobbyInvite_BlockInviter"	"Заблокировать все связи с этим игроком"
"DOTA_PartyInvite_BlockNonFriendInvites"	"Запретить приглашения от игроков не из списка друзей"
"DOTA_PartyInvite_BlockNonFriendInvitesDescription"	"Можно изменить в настройках (вкладка «Настройки», раздел «Профиль»)."
"DOTA_PartyInvite_Expired"	"Запрос истек или более не действителен."
"DOTA_PartyInvite_Coach"	"Тренер:"
"DOTA_PartyVisTooltip_TitleOpen"	"Ищет игроков"
"DOTA_PartyVisTooltip_TitleNotOpen"	"Не ищет игроков"
"DOTA_PartyVisTooltip_SoloNotOpen"	"Нажмите для смены состояния."
"DOTA_PartyVisTooltip_SoloOpen"	"Друзья могут попросить присоединиться к вам.<br/>Нажмите для смены состояния."
"DOTA_PartyVisTooltip_LeaderOpen"	"Друзья участников группы принимаются автоматически.<br/>Нажмите, чтобы сделать группу закрытой."
"DOTA_PartyVisTooltip_LeaderOpenManualAccept"	"Друзья участников группы могут попросить присоединиться.<br/>Нажмите, чтобы сделать группу закрытой."
"DOTA_PartyVisTooltip_LeaderNotOpen"	"Друзья участников группы могут попросить присоединиться.<br/>Нажмите, чтобы сделать группу открытой. Друзья смогут легко найти ее."
"DOTA_PartyVisTooltip_NotOpenHidden"	"В соответствии с настройками приватности вы не показываете друзьям, что находитесь в этой группе<br/>Внимание: возможно, друзья других участников группы видят ее и могут попросить присоединиться к ней."
"DOTA_PartyVisTooltip_NonLeaderOpen"	"Запросы друзей.<br/>Нажмите, чтобы сделать группу закрытой."
"DOTA_PartyVisTooltip_NonLeaderNotOpen"	"Друзья членов группы могут просить пригласить их.<br/>Только лидер группы может принимать эти запросы.<br/>Нажмите, чтобы сделать группу открытой. Друзья смогут легко найти ее."
"DOTA_TogglePartyOpenMic_Tooltip"	"Говорить с группой без нажатия"
"DOTA_PartySettings"	"Настройки группы"
"DOTA_PartySettings_OpenParty"	"Разрешить запросы на присоединение к группе"
"DOTA_PartySettings_BroadcastToFriends"	"Показывать друзьям, что я в группе"
"DOTA_PartySettings_OpenState_NotOpen"	"Руководитель группы не разрешил запросы на вход в нее."
"DOTA_PartySettings_OpenState_NotOpenLeader"	"Эта группа закрыта от запросов на присоединение."
"DOTA_PartySettings_OpenState_OpenButHiddenFromFriends"	"В эту группу можно запросить вход. Ваши друзья ее не видят, но, возможно, она видна друзьям других участников группы."
"DOTA_PartySettings_OpenState_Open"	"Группа открыта для запросов на вход и видна вашим друзьям. Она также видна друзьям остальных участников группы."
"DOTA_LobbyInvite_Title"	"Приглашение в лобби"
"DOTA_LobbyInvite_Description"	"{g:dota_persona:inviter} приглашает вас в лобби."
"DOTA_PartyJoinedLobby_Title"	"Вы в лобби"
"DOTA_PartyJoinedLobby_Generic"	"{s:party_leader} помещает вас в лобби."
"DOTA_PartyJoinedLobby_Custom"	"{s:party_leader} помещает вас в лобби игры {s:custom_game}."
"DOTA_PartyLeader"	"Лидер группы"
"DOTA_LobbyKicked_Header"	"Вас исключили из лобби."
"DOTA_LobbyKicked_Message"	"Лидер лобби выгнал вас."
"DOTA_PlayerContextMenu_ViewProfile"	"Посмотреть профиль"
"DOTA_PlayerContextMenu_ChatWithPlayer"	"Отправить сообщение"
"DOTA_PlayerContextMenu_InviteToParty"	"Пригласить в группу"
"DOTA_PlayerContextMenu_SuggestInviteToParty"	"Предложить пригласить"
"DOTA_PlayerContextMenu_KickFromParty"	"Выгнать из группы"
"DOTA_PlayerContextMenu_SetPartyLeader"	"Сделать лидером группы"
"DOTA_PlayerContextMenu_LeaveParty"	"Покинуть группу"
"DOTA_PlayerContextMenu_CoachParty"	"Стать тренером группы"
"DOTA_PlayerContextMenu_StopCoachingParty"	"Перестать быть тренером"
"DOTA_PlayerContextMenu_AddFriend"	"Добавить в друзья"
"DOTA_PlayerContextMenu_RemoveFriend"	"Удалить из друзей"
"DOTA_PlayerContextMenu_AcceptFriendRequest"	"Принять запрос дружбы"
"DOTA_PlayerContextMenu_IgnoreFriendRequest"	"Игнорировать запрос"
"DOTA_PlayerContextMenu_Spectate"	"Смотреть игру"
"DOTA_PlayerContextMenu_InviteToLobby"	"Пригласить в лобби"
"DOTA_PlayerContextMenu_SuggestInviteToLobby"	"Предложить пригласить"
"DOTA_PlayerContextMenu_KickFromLobby"	"Выгнать из лобби"
"DOTA_PlayerContextMenu_KickFromLobbyTeam"	"Выгнать из команды"
"DOTA_FeaturedHero_UnableToLoad"	"Не удалось загрузить избранных героев."
"DOTA_FeaturedHero_ViewGrid"	"Сетка"
"DOTA_FeaturedHero_HeroName"	"{s:hero_name}"
"DOTA_FeaturedHero_ItemName"	"{g:dota_item_name:item_def}"
"DOTA_FeaturedHeroReason_NewHero"	"Недавно выпущенный герой"
"DOTA_FeaturedHeroReason_NewItem"	"Новый предмет редкости {s:item_rarity}"
"DOTA_FeaturedHeroReason_FrequentlyPlayedHero"	"Так как вы им играли"
"DOTA_FeaturedHeroReason_FeaturedItem"	"Избранный предмет"
"DOTA_FeaturedHeroReason_PopularItem"	"Популярный товар"
"DOTA_FeaturedHeroReason_SaleItem"	"Со скидкой"
"DOTA_NewFeaturedHero_WinterWyvern"	"На крыльях холодного ветра летит древний дракон."
"DOTA_HeroSelectorCategory_Default"	"Все герои"
"DOTA_HeroSelectorCategory_NewItems"	"С новыми предметами"
"DOTA_HeroSelectorCategory_Favorites"	"Избранные"
"DOTA_HeroSelectorCategory_MostPlayed"	"Наиболее выбираемые"
"DOTA_HeroSelectorCategory_LeastPlayed"	"Наименее выбираемые"
"DOTA_HeroSelectorCategory_HaveItems"	"Для которых у меня есть предметы"
"DOTA_HeroSelectorCategory_PrimaryAttribute_Strength"	"Сила"
"DOTA_HeroSelectorCategory_PrimaryAttribute_Agility"	"Ловкость"
"DOTA_HeroSelectorCategory_PrimaryAttribute_Intelligence"	"Интеллект"
"DOTA_HeroSelectorCategory_AttackRange_Melee"	"Ближ. бой"
"DOTA_HeroSelectorCategory_AttackRange_Ranged"	"Дальн. бой"
"DOTA_HeroSelector_SelectHero_Label"	"Выбрать"
"DOTA_HeroSelector_ClearFilters"	"Сбросить фильтры"
"DOTA_OwnedItemSet_Selector_Title"	"Имеющиеся"
"DOTA_EquippedItemSet_Selector_Title"	"Надетые"
"DOTA_OwnedItemSet_Available_Title"	"Доступные"
"DOTA_FeaturedItemSet_Selector_Title"	"Избранные"
"DOTA_AllItemSet_Selector_Title"	"Все"
"DOTA_ConfirmLANLobby_title"	"ЛОКАЛЬНОЕ ЛОББИ"
"DOTA_ConfirmLANLobby_desc"	"На вашем компьютере запущен сервер локальной игры. Системные требования к ПК на время этой игры будут выше."
"DOTA_ConfirmLANLobbyDisconnect_title"	"Покинуть локальное лобби?"
"DOTA_ConfirmLANLobbyDisconnect_desc"	"Игра этого лобби размещена на вашем компьютере, отключение завершит игру для всех игроков. Продолжить?"
"DOTA_ConfirmLANLobbyDisconnect_ok"	"Да, отключиться"
"DOTA_Lobby_Settings_General"	"ОСНОВНЫЕ НАСТРОЙКИ ЛОББИ"
"DOTA_Lobby_Settings_Required"	"ОБЯЗАТЕЛЬНО"
"DOTA_Lobby_Settings_Confirm"	"{s:lobby_confirm_label}"
"DOTA_Lobby_Settings_Game_Mode"	"РЕЖИМ ИГРЫ"
"DOTA_Lobby_Settings_Region"	"РАСПОЛОЖЕНИЕ СЕРВЕРА"
"DOTA_Lobby_Settings_Password"	"ПАРОЛЬ ЛОББИ"
"DOTA_Lobby_Settings_Game_Name"	"НАЗВАНИЕ ИГРЫ"
"DOTA_Lobby_Settings_Advanced"	"РАСШИРЕННЫЕ НАСТРОЙКИ ЛОББИ"
"DOTA_Lobby_Settings_Competitive"	"СОРЕВНОВАТЕЛЬНЫЕ"
"DOTA_Lobby_Settings_Starting_Team"	"ПРАВО ПЕРВОГО ВЫБОРА"
"DOTA_Lobby_Settings_Starting_Team_Random"	"СЛУЧАЙНО"
"DOTA_Lobby_Settings_Starting_Team_Radiant"	"СВЕТ"
"DOTA_Lobby_Settings_Starting_Team_Dire"	"ТЬМА"
"DOTA_Lobby_Settings_Penalty_Radiant"	"ШТРАФНОЕ ВРЕМЯ - СВЕТ"
"DOTA_Lobby_Settings_Penalty_Dire"	"ШТРАФНОЕ ВРЕМЯ - ТЬМА"
"DOTA_Lobby_Settings_Penalty_Level_0"	"Нет"
"DOTA_Lobby_Settings_Penalty_Level_1"	"-30 сек. на запрет"
"DOTA_Lobby_Settings_Penalty_Level_2"	"-70 сек. на запрет"
"DOTA_Lobby_Settings_Penalty_Level_3"	"-110 сек. на запрет"
"DOTA_Lobby_Settings_Penalty_Tooltip"	"В режиме Captain's Mode снижает время на запрет героя этой командой."
"DOTA_Lobby_Settings_Series_Type"	"СЕРИЯ ИГР"
"DOTA_Lobby_Settings_No_Series"	"ОДНА ИГРА"
"DOTA_Lobby_Settings_Series_Best_of_3"	"ДО 2 ПОБЕД"
"DOTA_Lobby_Settings_Series_Best_of_5"	"ДО 3 ПОБЕД"
"DOTA_Lobby_Settings_Gameplay_Rules"	"ПРАВИЛА ИГРЫ"
"DOTA_Lobby_Settings_Enable_Cheats"	"ВКЛЮЧИТЬ ЧИТЫ"
"DOTA_Lobby_Settings_All_Chat"	"ОБЩИЙ ЧАТ"
"DOTA_Lobby_Settings_Fill_Bots"	"ИСПОЛЬЗОВАТЬ БОТОВ"
"DOTA_Lobby_Settings_Bot_Difficulty"	"УРОВЕНЬ СЛОЖНОСТИ БОТОВ"
"DOTA_Lobby_Settings_Bot_Difficulty_Passive"	"ПАССИВНЫЙ"
"DOTA_Lobby_Settings_Bot_Difficulty_Easy"	"НИЗКИЙ"
"DOTA_Lobby_Settings_Bot_Difficulty_Medium"	"СРЕДНИЙ"
"DOTA_Lobby_Settings_Bot_Difficulty_Hard"	"ВЫСОКИЙ"
"DOTA_Lobby_Settings_Bot_Difficulty_Unfair"	"НЕЧЕСТНЫЙ"
"DOTA_Lobby_Settings_Version"	"ВЕРСИЯ"
"DOTA_Lobby_Settings_Version_Latest"	"ПОСЛЕДНЯЯ"
"DOTA_Lobby_Settings_Version_Tournament"	"ТУРНИРНАЯ"
"DOTA_Lobby_Settings_Spectator_Section"	"НАБЛЮДЕНИЕ"
"DOTA_Lobby_Settings_Dota_TV_Delay"	"ЗАДЕРЖКА DOTA TV"
"DOTA_Lobby_Settings_Dota_TV_Delay_2_Minutes"	"2 минуты"
"DOTA_Lobby_Settings_Dota_TV_Delay_5_Minutes"	"5 минут"
"DOTA_Lobby_Settings_Dota_TV_Delay_10_Seconds"	"10 секунд"
"DOTA_Lobby_Settings_Spectators"	"ЗРИТЕЛИ"
"DOTA_Lobby_Settings_Spectators_Enabled"	"РАЗРЕШЕНЫ"
"DOTA_Lobby_Settings_Spectators_Disabled"	"ЗАПРЕЩЕНЫ"
"dota_lobby_settings_hide_password"	"Скрыть пароль"
"dota_lobby_settings_local_host"	"Локальный"
"DOTA_Lobby_Settings_Visibility"	"Видимость лобби"
"DOTA_Lobby_Settings_Visibility_Public"	"Публичное"
"DOTA_Lobby_Settings_Visibility_Friends"	"Только для друзей"
"DOTA_Lobby_Settings_Visibility_Unlisted"	"Скрытое"
"DOTA_Lobby_Settings_Visibility_Tooltip"	"Видимость лобби. Публичные лобби видны в браузере лобби и списке друзей. Лобби «только для друзей» видны исключительно им, хотя можно приглашать других игроков. Скрытые лобби не видны ни в браузере, ни в друзьях."
"DOTA_TeamUnsetHeader"	"Команда не выбрана"
"DOTA_TeamUnsetMessage"	"Как минимум у одной из команд отсутствует название/логотип. Всё равно начать игру?"
"DOTA_LeagueUnsetHeader"	"Турнир не выбран"
"DOTA_LeagueUnsetMessage"	"Для этого лобби не выбрана лига, но вы можете ее назначить. Всё равно начать игру?"
"DOTA_LobbyAllowSpectatingHeader"	"Не удается запустить игру из лобби"
"DOTA_LobbyAllowSpectatingMessage"	"Если в лобби присутствуют зрители, игра должна быть видна им. Разрешите присутствие зрителей в настройках лобби."
"dota_radiant"	"Силы Света"
"dota_dire"	"Силы Тьмы"
"dota_lobby_team_name_radiant"	"{s:team_name_good_guys}"
"dota_lobby_team_name_dire"	"{s:team_name_bad_guys}"
"dota_lobby_no_team"	"Нет команды"
"dota_lobby_broadcast_default_channel_name"	"Название канала"
"dota_lobby_broadcast_join"	"Войти"
"dota_lobby_broadcast_leave"	"Покинуть"
"dota_lobby_broadcast_create"	"Создать новый канал"
"dota_lobby_broadcast_no_channels"	"Каналы трансляций отсутствуют"
"dota_popup_broadcast_channel_edit_title"	"Настроить канал трансляции"
"dota_lobby_broadcast_default_channel_name_custom"	"{s:custom_title}"
"dota_popup_broadcast_channel_edit_channel_name"	"Название канала"
"dota_popup_broadcast_channel_edit_country"	"Страна"
"dota_popup_broadcast_channel_edit_language"	"Язык"
"dota_popup_broadcast_channel_edit_save"	"Сохранить эти настройки и применять их при входе в пустой канал"
"DOTA_Lobby_Broadcaster_Channel_Other_Language"	"Другой язык"
"lobby_slot_error_header"	"Невозможно сменить слот"
"generic_gc_timeout"	"Время доставки сообщения истекло."
"lobby_slot_success_header"	"Готово"
"lobby_slot_denied"	"Вам не разрешено занять этот слот."
"lobby_slot_cameramanalready"	"У канала трансляции может быть только один оператор"
"lobby_slot_cameramanon"	"Вы являетесь оператором"
"lobby_slot_cameramanoff"	"Вы больше не оператор"
"lobby_slot_error"	"Не удалось сменить слот в лобби."
"lobby_create_timeout"	"Не удалось создать лобби."
"find_match_error"	"Не удалось начать поиск игры."
"DOTA_DialogVariableTest1"	"Простая: {s:var}"
"DOTA_DialogVariableTest2"	"Денежная: {m:money}"
"DOTA_DialogVariableTest3"	"Ссылка на предмет: {g:dota_item_link:item_def}"
"DOTA_DialogVariableTest4"	"Стоимость предмета: {g:dota_item_price:item_def}"
"DOTA_DialogVariableTest5"	"Имя профиля по ID: {g:dota_persona:account_id}, проф. псевдоним: {g:dota_persona:pro:account_id}"
"DOTA_DialogVariableTest6"	"Простая в теге span: <span class=\"TextSpan\">{s:var}</span>"
"LobbySetting_GameMode"	"Режим игры"
"LobbySetting_GameMode_Value"	"{s:lobbysetting_gamemode}"
"LobbySetting_Bots"	"Боты"
"LobbySetting_Bots_Value"	"{s:lobbysetting_bots}"
"LobbySetting_Password"	"Пароль"
"LobbySetting_Password_Value"	"{s:lobbysetting_password}"
"LobbySetting_Server"	"Сервер"
"LobbySetting_Server_Value"	"{s:lobbysetting_server}"
"LobbySetting_Cheats"	"Читы"
"LobbySetting_Cheats_Value"	"{s:lobbysetting_cheats}"
"LobbySetting_Spectators"	"Зрители"
"LobbySetting_Spectators_Value"	"{s:lobbysetting_spectators}"
"LobbySetting_Visibility"	"Видимость"
"LobbySetting_Visibility_Value"	"{s:lobbysetting_visibility}"
"dota_lobby_lan_title"	"ЛОКАЛЬНОЕ ЛОББИ"
"dota_lobby_coaches_none"	"Нет тренеров"
"dota_lobby_coaches"	"Тренеры:"
"DOTA_Custom_Game"	"Пользовательская игра"
"DOTA_Custom_Game_Info"	"Информация"
"DOTA_Custom_Game_View_Details"	"Подробнее об игре"
"DOTA_Custom_Game_Author"	"от {g:dota_persona:author}"
"DOTA_Custom_Game_Lobby_Count"	"{d:lobby_count} лобби"
"DOTA_Custom_Game_Lobby_Count_Plural"	"{d:lobby_count} лобби"
"DOTA_Custom_Game_Friend_Lobbies_Alert"	"Друзей с открытым лобби игры: {d:friend_count}"
"DOTA_Custom_Game_Friend_Lobbies_Alert_Plural"	"Друзей с открытым лобби игры: {d:friend_count}"
"DOTA_Custom_Game_Quick_Join"	"Быстрая игра"
"DOTA_Custom_Game_View_Lobbies"	"Список лобби"
"DOTA_Custom_Game_Find_Lobby"	"Найти лобби"
"DOTA_Custom_Game_Create_Lobby"	"Создать лобби"
"DOTA_Custom_Game_Game_Page"	"Страница игры"
"DOTA_Custom_Game_Workshop_Page"	"Страница в Мастерской"
"DOTA_Custom_Game_Download_Queued"	"Загрузка в очереди"
"DOTA_Custom_Game_Downloading"	"Загрузка…"
"DOTA_Custom_Game_Downloading_Percent"	"Загрузка - {d:lobby_download_percent}%"
"DOTA_Custom_Game_Needs_Update"	"Требуется обновление"
"DOTA_Custom_Game_Play"	"Играть в {s:game_mode_name}"
"DOTA_Custom_Game_Uninstall"	"Удалить"
"DOTA_Custom_Game_Install"	"Установить"
"DOTA_Custom_Game_Installed"	"Установлено"
"DOTA_Custom_Game_Not_Installed"	"Не установлено"
"DOTA_Custom_Game_Connect"	"Войти в лобби"
"DOTA_Custom_Game_FileSize"	"{d:file_size} МБ"
"DOTA_Custom_Game_Name"	"{s:game_mode_name}"
"DOTA_Custom_Game_Released_By"	"Выпущена {s:release_date};</b> Автор: <b>{g:dota_persona:author}</b>"
"DOTA_Custom_Game_Subscription"	"Подписчиков: {s:subscriptions_count}"
"DOTA_Custom_Game_Subscriptions"	"Подписчиков: {s:subscriptions_count}"
"DOTA_Custom_Game_Rating"	"Оценка"
"DOTA_Custom_Game_Release_Date"	"Выпущена"
"DOTA_Custom_Game_Playing_Now"	"В игре: {s:player_count}"
"DOTA_Custom_Game_Ratings_Count"	"({d:ratings_count})"
"DOTA_Custom_Game_Description"	"{s:game_description}"
"DOTA_Custom_Game_Last_Updated"	"Обновлено {s:last_updated_date}"
"DOTA_Custom_Game_Update_Note_Title"	"{s:timestamp}"
"DOTA_Custom_Game_Screenshots"	"Скриншоты"
"DOTA_Custom_Game_Map_Label"	"Карта"
"DOTA_Custom_Game_Map_Any"	"Любая"
"DOTA_Custom_Game_Update"	"Обновить"
"DOTA_Custom_Game_Spectate"	"Наблюдать"
"DOTA_Custom_Game_Already_In_Lobby"	"Закончите текущую игру, прежде чем начать эту."
"DOTA_Custom_Game_Friends_Playing"	"Друзей в пользовательских играх"
"DOTA_Custom_Game_Friends_In_Lobbies"	"В открытых лобби: {d:friends_in_open_lobbies}"
"DOTA_Custom_Game_Friends_In_Game"	"Друзей в польз. игре: {d:friends_in_game}"
"DOTA_Custom_Games_Friends_Play"	"Во что играют ваши друзья"
"DOTA_Custom_Game_Invite_Friend"	"Пригласить друга"
"DOTA_Custom_Game_Tooltip_Subscribers"	"Подписчиков: {d:subscriber_count}"
"DOTA_Custom_Game_Tooltip_Subscriber"	"Подписчиков: {d:subscriber_count}"
"DOTA_Custom_Game_Most_Popular"	"Самые популярные"
"DOTA_Custom_Game_Installed_Games"	"Установленные игры"
"DOTA_Custom_Game_Favorite_Games"	"Показывать избранное"
"DOTA_Custom_Game_Add_Favorite"	"Добавить в избранное"
"DOTA_Custom_Game_VotePrompt"	"Следует ли другим игрокам узнать об этой игре больше?"
"DOTA_Custom_Game_DetailsPrompt"	"Узнать больше об этой игре, а также установить и запустить ее можно на ее странице."
"DOTA_Custom_Game_Vote_Box_Title"	"Голосование в Мастерской"
"DOTA_Custom_Game_Vote_Box_Desc"	"Помогите малоизвестным играм набрать популярность."
"DOTA_Custom_Game_Vote_Start"	"Голосовать"
"DOTA_Custom_Game_VoteThanks"	"Спасибо за голосование!"
"DOTA_Custom_Game_Vote_PrevLabel"	"Пред. игра"
"DOTA_Custom_Game_Vote_NextLabel"	"След. игра"
"DOTA_Custom_Game_Vote_ControlsLabel"	"Голосование в Мастерской"
"DOTA_Custom_Game_Vote_YesLabel"	"Да, продвинуть ее!"
"DOTA_Custom_Game_Vote_NoLabel"	"Не-а, нужна доработка."
"DOTA_Custom_Game_Vote_SkipLabel"	"Пропустить эту игру."
"DOTA_Custom_Game_Vote_Up"	"Хорошая игра"
"DOTA_Custom_Game_Vote_Down"	"Нужна доработка"
"Video_Support_Coming_Soon"	"Поддержка видео скоро выйдет"
"DOTA_Custom_Game_Leave_Lobby"	"Покинуть лобби"
"DOTA_Custom_Game_Suggested_Title"	"Предложенные игры"
"DOTA_Custom_Game_Suggested_Info"	"В этот список входят игры, набирающие известность или хорошие отзывы.<br><br>Выборка обновляется раз в 30 минут, предоставляя всему сообществу по 15 игр одновременно."
"DOTA_Custom_Game_Addon_Restricted"	"Невозможно сделать это в игре с выключенными дополнениями."
"DOTA_Custom_Game_Search"	"Искать пользовательские игры"
"DOTA_Custom_Lobby_Create_Button"	"Создать лобби польз. игры"
"DOTA_Custom_Lobby_Settings_Title"	"Создать лобби"
"DOTA_Custom_Lobby_Settings_Mode"	"Режим игры"
"DOTA_Custom_Lobby_Settings_Map"	"Карта"
"DOTA_Custom_Lobby_LobbyName"	"Описание (необязательно)"
"DOTA_Custom_Lobby_List_Desc"	"Список закрытых (защищенных паролем) лобби и всех текущих пользовательских игр."
"DOTA_Custom_Lobby_Public"	"Открытое"
"DOTA_Custom_Lobby_Passworded"	"Игроки могут войти в лобби только по приглашению или паролю."
"DOTA_Custom_Lobby_Join_Failed_Title"	"Не удалось войти"
"DOTA_Custom_Lobby_Join_Failed_Reason"	"{s:join_error}"
"DOTA_Custom_Lobby_Join_Failed_Prompt"	"Хотите найти открытое лобби игры {s:game_name}?"
"DOTA_Lobby_Failed_Pings"	"Не удалось получить информацию о задержке. Убедитесь, что интернет-соединение и серверы Dota 2 работают."
"DOTA_Custom_Lobby_Create_Private_Button"	"Создать закрытое лобби"
"DOTA_Custom_Lobby_Find_Private_Button"	"Найти закрытое лобби"
"DOTA_Custom_Lobby_Find_Private_Title"	"Найти закрытое лобби"
"DOTA_Custom_Lobby_Find_Private_Desc"	"Введите пароль закрытого лобби:"
"DOTA_Custom_Lobby_List_Game_Header"	"Игра"
"DOTA_Custom_Lobby_List_Name_Header"	"Описание"
"DOTA_Custom_Lobby_List_Players_Header"	"Игроков"
"DOTA_Custom_Lobby_List_Map_Header"	"Карта"
"DOTA_Custom_Lobby_List_Region_Header"	"Регион"
"DOTA_Custom_Lobby_List_Connection_Header"	"Соединение"
"DOTA_Custom_Lobby_List_Status_Header"	"Установлено"
"DOTA_Custom_Lobby_List_Game"	"{s:lobby_game}"
"DOTA_Custom_Lobby_List_Lobby_Name"	"{s:lobby_name}"
"DOTA_Custom_Lobby_List_Players"	"{s:lobby_players} / {s:lobby_max_players}"
"DOTA_Custom_Lobby_List_Map"	"{s:lobby_map}"
"DOTA_Custom_Lobby_List_Region"	"{s:lobby_region}"
"DOTA_Custom_Lobby_List_Connection"	"…"
"DOTA_Custom_Lobby_List_Status"	"{s:lobby_status}"
"DOTA_Custom_Lobby_List_Connect"	"{s:connect_button_text}"
"DOTA_Custom_Lobby_Game_Name"	"{s:game_name}"
"DOTA_Custom_Lobby_Map_Name"	"Карта: {s:map_name}"
"DOTA_Custom_Lobby_Player_Count"	"Игроков: {d:player_count} / {d:max_player_count}"
"DOTA_Custom_Lobby_Player_Count_Short"	"{d:player_count} / {d:max_player_count}"
"DOTA_Custom_Lobby_Visibility"	"Видимость лобби"
"DOTA_Custom_Join_Chat"	"Войти в чат"
"DOTA_Custom_Join_Chat_Member_Count"	"({d:ChatMemberCount})"
"DOTA_Custom_Leave_Chat"	"Покинуть чат"
"DOTA_Custom_Game_Vote_Up_Tooltip"	"Проголосовать за эту игру в мастерской Steam"
"DOTA_Page_Number"	"Страница: {d:current_page} / {d:num_pages}"
"DOTA_TabName_ModsOverview"	"Обзор"
"DOTA_TabName_ModsSubscribed"	"Библиотека"
"DOTA_TabName_ModsWorkshop"	"Мастерская"
"DOTA_TabName_ModsBrowse"	"Просмотр"
"DOTA_WatchTabName_Live"	"Прямой эфир"
"DOTA_WatchTabName_Featured"	"Избранное"
"DOTA_WatchTabName_Replays"	"Записи"
"DOTA_WatchTabName_Tournaments"	"Турниры"
"DOTA_WatchTabName_Downloads"	"Загрузки"
"DOTA_WatchLive_Search"	"Поиск по героям"
"DOTA_WatchLive_DataPending"	"Поиск игр в прямом эфире..."
"DOTA_WatchLive_DataError"	"Не удалось загрузить игры в прямом эфире"
"DOTA_WatchLive_NoGames"	"Нет игр в прямом эфире"
"DOTA_WatchLive_Connecting"	"Ожидание информации об игре…"
"DOTA_WatchLive_HeroFilter"	"Герой: {s:hero_filter_name}"
"DOTA_WatchLive_CountSpec"	"Зрителей: {i:num_spectating}"
"DOTA_WatchLive_CountSpecFriend"	"Зрителей: {i:num_spectating} (друзей: {i:num_friends_spectating})"
"DOTA_WatchLive_CountSpecFriends"	"Зрителей: {i:num_spectating} (друзей: {i:num_friends_spectating})"
"DOTA_WatchLive_CountFriends"	"Друзей: {i:num_friends_playing}"
"DOTA_WatchLive_ParticipantsVs"	"{s:team_1} против {s:team_2}"
"DOTA_WatchLive_ParticipantsMMR"	"Средний рейтинг: {i:mmr}"
"DOTA_WatchLive_ParticipantsUnranked"	"Нерейтинговая"
"DOTA_WatchLive_Participants1"	"{s:friend_1}"
"DOTA_WatchLive_Participants2"	"{s:friend_1} и {s:friend_2}"
"DOTA_WatchLive_Participants3"	"{s:friend_1}, {s:friend_2} и {s:friend_3}"
"DOTA_WatchLive_Participants4Plus"	"{s:friend_1}, {s:friend_2}, {s:friend_3} и еще {i:friend_count_over_3}…"
"DOTA_WatchLive_MatchType_MM_Kills"	"{s:game_mode}"
"DOTA_WatchLive_MatchType_MM"	"{s:game_mode}"
"DOTA_WatchLiveDotaTV"	"Смотреть в Dota TV"
"DOTA_WatchLivePurchase"	"Купить билет на турнир {g:dota_item_price:ticket_itemdef}"
"DOTA_WatchLiveSpectatorFriends1"	"Зритель: {g:dota_persona:spectator_friend_1}"
"DOTA_WatchLiveSpectatorFriends2"	"Зрители: {g:dota_persona:spectator_friend_1} и {g:dota_persona:spectator_friend_2}"
"DOTA_WatchLiveSpectatorFriends3"	"Зрители: {g:dota_persona:spectator_friend_1}, {g:dota_persona:spectator_friend_2} и {g:dota_persona:spectator_friend_3}"
"DOTA_WatchLiveSpectatorFriends4Plus"	"Зрители: {g:dota_persona:spectator_friend_1}, {g:dota_persona:spectator_friend_2}, {g:dota_persona:spectator_friend_3} и еще {i:spectator_friend_count_over_3} друзей"
"DOTA_WatchLiveSpectatorCount"	"Зрителей: {i:spectator_count}"
"DOTA_WatchLivePreGame"	"Подготовка"
"DOTA_WatchLive_ElapsedTime"	"Время:"
"DOTA_WatchLive_Spectating"	"Зрителей:"
"DOTA_WatchReplays_TournamentsHeader"	"ПОПУЛЯРНЫЕ ТУРНИРНЫЕ МАТЧИ"
"DOTA_WatchReplays_FriendsHeader"	"ИГРЫ ДРУЗЕЙ"
"DOTA_WatchReplays_Popular"	"ПОПУЛЯРНЫЕ МАТЧИ"
"DOTA_WatchReplays_SavedForLater"	"ОТЛОЖЕННЫЕ НА ПОТОМ"
"DOTA_WatchReplays_ParticipantsVs"	"{s:team_1} против {s:team_2}"
"DOTA_WatchReplays_MatchType_League"	"{s:league_name}"
"DOTA_WatchReplays_MatchType_Public"	"Матч №{s:match_id} - {s:game_mode}"
"DOTA_WatchReplays_Recommendations"	"{i:recommendations}"
"DOTA_WatchReplays_Recommendations1"	"{g:dota_persona:friend_1} + {i:recommendations}"
"DOTA_WatchReplays_Recommendations2"	"{g:dota_persona:friend_1}, {g:dota_persona:friend_2} + {i:recommendations}"
"DOTA_WatchReplays_Recommendations3Plus"	"{g:dota_persona:friend_1} + еще {i:friend_count_over_1} друзей + {i:recommendations}"
"DOTA_WatchReplays_Friends1"	"Участники: {g:dota_persona:b:friend_1}"
"DOTA_WatchReplays_Friends2"	"Участники: {g:dota_persona:b:friend_1} и {g:dota_persona:friend_2}"
"DOTA_WatchReplays_Friends3Plus"	"{g:dota_persona:b:friend_1} и {g:dota_persona:b:friend_2}. Еще друзей: {i:friend_count_over_2}"
"DOTA_WatchReplays_Views"	"Просмотров: {i:views}"
"DOTA_WatchReplays_Price"	"{g:dota_item_price:ticket_itemdef}"
"DOTA_WatchReplays_SharedMatch"	"{g:dota_persona:shared_by} говорит: «{s:shared_text}»"
"DOTA_WatchReplays_SharedHighlight"	"{g:dota_persona:shared_by} поделился интересным моментом"
"DOTA_WatchReplays_Duration"	"{s:minutes}:{s:seconds}"
"DOTA_WatchReplays_Tag"	"«{s:recommendation_text}»"
"DOTA_WatchTournaments_FeaturedTitle"	"{s:tournament_featured_title}"
"DOTA_WatchTournaments_FeaturedDates"	"{s:tournament_featured_start} - {s:tournament_featured_end}"
"DOTA_WatchTournaments_FeaturedDescription"	"{s:tournament_featured_description}"
"DOTA_WatchTournaments_FeaturedTeams"	"Команды"
"DOTA_WatchTournaments_PrizePool"	"Призовой фонд:"
"DOTA_WatchTournaments_PrizePoolAmt"	"{s:tournament_featured_prize_pool}"
"DOTA_WatchTournaments_Purchase"	"Билет на турнир - {s:tournament_featured_price}"
"DOTA_WatchTournament_TournamentName"	"{s:tournament_name}"
"DOTA_WatchTournament_Price"	"{s:price}"
"DOTA_Replays_Search"	"Поиск по номеру матча"
"DOTA_Watch_GameStatus"	"Состояние игры"
"DOTA_Watch_Pending"	"Ожидание начала просмотра игры…"
"DOTA_Watch_GameServerNotFound"	"Не найден сервер, на котором проходит игра."
"DOTA_Watch_Unavailable"	"В данный момент просмотр игры невозможен."
"DOTA_Watch_LobbyNotFound"	"Лобби не найдено."
"DOTA_Watch_MissingLeagueSubscription"	"Эта игра является частью платного турнира, к которому у вас нет доступа."
"vs"	"VS"
"dota_matchmaking_language_title"	"Выберите язык подбора игр"
"dota_matchmaking_language_primary_label"	"Ваш основной язык для подбора игр:"
"dota_matchmaking_language_primary"	"{s:environment_language}"
"dota_matchmaking_language_primary_invalid"	"Ваш язык ({s:environment_language}) недоступен в подборе игр в Dota 2."
"dota_matchmaking_language_select_secondary"	"Вы можете выбрать дополнительный язык:"
"dota_matchmaking_language_select_primary"	"Выберите язык для подбора игр:"
"dota_matchmaking_language_no_selection"	"Не выбран"
"dota_matchmaking_language_english"	"Английский"
"dota_matchmaking_language_russian"	"Русский"
"dota_matchmaking_language_chinese"	"Китайский"
"dota_matchmaking_language_schinese"	"Китайский"
"dota_matchmaking_language_korean"	"Корейский"
"dota_matchmaking_language_koreana"	"Корейский"
"dota_matchmaking_language_spanish"	"Испанский"
"dota_matchmaking_language_portuguese"	"Португальский"
"GameUI_Language_English"	"Английский"
"GameUI_Language_German"	"Немецкий"
"GameUI_Language_French"	"Французский"
"GameUI_Language_Italian"	"Итальянский"
"GameUI_Language_Korean"	"Корейский"
"GameUI_Language_Spanish"	"Испанский"
"GameUI_Language_Simplified_Chinese"	"Упрощенный китайский"
"GameUI_Language_Traditional_Chinese"	"Традиционный китайский"
"GameUI_Language_Russian"	"Русский"
"GameUI_Language_Thai"	"Тайский"
"GameUI_Language_Japanese"	"Японский"
"GameUI_Language_Portuguese"	"Португальский"
"GameUI_Language_Polish"	"Польский"
"GameUI_Language_Danish"	"Датский"
"GameUI_Language_Dutch"	"Голландский"
"GameUI_Language_Finnish"	"Финский"
"GameUI_Language_Norwegian"	"Норвежский"
"GameUI_Language_Swedish"	"Шведский"
"GameUI_Language_Hungarian"	"Венгерский"
"GameUI_Language_Czech"	"Чешский"
"GameUI_Language_Romanian"	"Румынский"
"GameUI_Language_Turkish"	"Турецкий"
"GameUI_Language_Brazilian"	"Бразильский португальский"
"GameUI_Language_Bulgarian"	"Болгарский"
"GameUI_Language_Greek"	"Греческий"
"GameUI_Language_Ukrainian"	"Украинский"
"client_version_out_of_date_title"	"Требуется обновление"
"client_version_out_of_date"	"Клиент игры устарел. Пожалуйста, закройте и перезапустите Dota 2, чтобы загрузить последнюю версию."
"dota_matchmaking_region_title"	"Выберите регионы подбора игр"
"dota_matchmaking_region_auto"	"Автоматически выбрать регион, подходящий моему местоположению"
"dota_matchmaking_region_select"	"Выберите до трех регионов подбора игры. Чем они ближе к вам, тем лучше."
"limited_heroes_abandon_header"	"Режим «Limited Heroes»"
"limited_heroes_abandon_explanation"	"Вы не понесете наказания за отключение от игр в режиме «Limited Heroes», так как контроль над вашим героем передастся боту. Но если вы забросите игру в другом режиме, то можете оказаться в очереди с низким приоритетом."
"dota_abandon_dialog_title"	"Покинуть игру"
"dota_abandon_dialog_confirm"	"Вы уверены, что хотите покинуть эту игру?"
"dota_abandon_dialog_yes"	"Да, покинуть игру."
"dota_leave_dialog_title"	"Покинуть игру"
"dota_leave_dialog_confirm"	"Вы действительно хотите покинуть эту игру?"
"dota_leave_dialog_yes"	"Да, покинуть игру."
"dota_accept_match_title"	"Ваша игра готова"
"dota_accept_match_readyup_title"	"Ожидание игроков"
"dota_accept_match_accept"	"Принять"
"dota_accept_match_accept_low_pri"	"Принять (низ. приоритет)"
"dota_accept_match_accept_button"	"{s:accept}"
"dota_accept_match_decline"	"Отклонить"
"dota_accept_match_subtitle"	"{s:subtitle}"
"dota_finding_match_players"	"(в поиске: {s:searching_player_count})"
"dota_finding_match_time"	"Время поиска игры: {s:find_match_time}"
"dota_finding_match_accept_count"	"Приняли: {s:match_num_accepted} / {s:match_num_total}"
"dota_finding_match_generic"	"Обычная игра"
"dota_finding_match_ranked"	"Рейтинговая игра"
"dota_finding_match_bot"	"Игра с ботами"
"dota_finding_match_bot_passive"	"Игра с пассивными ботами"
"dota_finding_match_bot_easy"	"Игра с легкими ботами"
"dota_finding_match_bot_medium"	"Игра со средними ботами"
"dota_finding_match_bot_hard"	"Игра со сложными ботами"
"dota_finding_match_bot_unfair"	"Игра с нечестными ботами"
"dota_finding_match_team"	"Командная рейтинговая игра"
"dota_finding_1v1_match_casual"	"Игра 1 на 1"
"dota_finding_match_practice_lobby"	"Игра в лобби"
"dota_safe_to_abandon_inline"	"Эту игру можно покинуть"
"dota_match_connected"	"Вы подключены к игре"
"dota_match_local_game"	"Вы подключены к локальной игре"
"dota_match_connecting"	"Подключение к игре…"
"dota_match_in_progress"	"Идет игра"
"dota_match_finished"	"Игра завершена"
"matchmaking_waiting_for_players"	"Ожидание других игроков"
"matchmaking_player_declined"	"Игрок отказался от участия"
"dota_match_wait_for_host"	"Ожидание сервера"
"dota_match_find_server"	"Поиск сервера"
"ranked_disabled"	"Рейтинговый подбор временно недоступен."
"ranked_mmr"	"Ваш рейтинг подбора игр"
"ranked_mmr_solo_label"	"Одиночный"
"ranked_mmr_solo_value"	"{i:solo_mmr}"
"ranked_mmr_solo_calibrating"	"Н/Д - игр осталось: {i:solo_calibrating_games}"
"ranked_mmr_solo_no_data"	"Игр до калибровки: {i:solo_calibrating_required_games}"
"ranked_mmr_party_label"	"Групповой"
"ranked_mmr_party_value"	"{i:party_mmr}"
"ranked_mmr_party_calibrating"	"Н/Д - игр осталось: {i:party_calibrating_games}"
"ranked_mmr_party_no_data"	"Игр до калибровки: {i:party_calibrating_required_games}"
"ranked_mmr_locked_explain"	"Рейтинговый подбор игр:\nОткрывается на 50 уровне трофея опыта.\nСоревновательный режим, который показывает MMR (рейтинг подбора игр) каждого игрока."
"matchmaking_account_disabled"	"Вам закрыт вход в чаты и подбор игр за плохое поведение. Подождите {t:r:match_denied_time}."
"matchmaking_match_disabled_party"	"Вы не сможете искать игру, потому что {s:match_denied_player_name} отклонил готовую игру или покинул предыдущую игру. Подождите {t:r:match_denied_time}."
"matchmaking_low_priority_party"	"{s:match_denied_player_name} покинул слишком много игр или получил слишком много жалоб. Осталось игр с низким приоритетом: {d:match_denied_games}"
"matchmaking_match_disabled_local"	"Вы не сможете искать игру, потому что отклонили готовую игру или покинули предыдущую игру. Подождите {t:r:match_denied_time}."
"matchmaking_low_priority_local"	"Вы покинули слишком много игр или получили слишком много жалоб. Осталось игр с низким приоритетом: {d:match_denied_games}"
"dota_ready_up_count"	"{s:ready_up_ready}/{s:ready_up_lobby_members}"
"dota_play_normal_match"	"Обычная игра"
"dota_play_ranked_match"	"Рейтинговая игра"
"dota_play_practice_1v1"	"Тренировка 1 на 1"
"dota_play_practice_with_bots"	"Тренировка с ботами"
"dota_play_practice_1v1_playtab"	"ТРЕНИРОВКА 1 НА 1"
"dota_play_1v1_desc"	"Потренируйтесь с другим игроком в игре на центральной линии. Игра окончится, когда один из игроков умрет дважды или потеряет башню."
"dota_play_practice_1v1_party_warning"	"Группы не могут участвовать в играх 1 на 1."
"dota_play_button_label"	"{s:play_button_label}"
"dota_play"	"Играть"
"dota_play_searching"	"Поиск матча"
"dota_play_connecting"	"Загрузка хоста…"
"dota_play_lobby_find_server"	"Поиск сервера"
"dota_play_find_match_label"	"{s:find_match_label}"
"dota_reconnect"	"Переподключиться"
"dota_abandon_game"	"Покинуть игру"
"dota_safe_leave_game"	"Покинуть игру"
"dota_disconnect"	"Отключиться"
"dota_play_unavailable"	"Недоступно"
"dota_leaver_consequence_tooltip_header"	"Последствия"
"dota_leaver_consequences"	"{s:leaver_consequences}"
"dota_leaver_consequences_details"	"{s:leaver_consequences_details}"
"dota_leaver_view_tooltip"	"Подробнее"
"dota_leaver_consequence_header_failure_to_reconnect"	"Если вы не переподключитесь к игре, то:"
"dota_leaver_consequence_header_leave_match"	"Если вы покинете эту игру, то:"
"dota_leaver_consequence_LetDownTeammates"	"Ваши товарищи по команде окажутся в невыгодном положении."
"dota_leaver_consequence_SmallMatchmakingCooldown"	"Вы будете лишены возможности подбора игр на некоторое время."
"dota_leaver_consequence_CreditWithAbandon"	"Вам засчитается преждевременный выход из игры."
"dota_leaver_consequence_ForcedLossForLeaver"	"Вам засчитается поражение."
"dota_leaver_consequence_ForcedLossForLeaversParty"	"Поражение будет засчитано <b>всем в вашей группе</b>."
"dota_leaver_consequence_ForcedLossForLeaversTeam"	"<b>Вашей команде</b> %s1 будет засчитано поражение."
"dota_leaver_consequence_MMRLossForLeaver"	"Ваш рейтинг подбора игр (MMR) уменьшится."
"dota_leaver_consequence_MMRLossForLeaversParty"	"Рейтинг подбора игр (MMR) <b>всех участников вашей группы</b> уменьшится."
"dota_leaver_consequence_MMRLossForLeaversTeam"	"Рейтинг подбора игр <b>вашей команды</b> %s1 уменьшится."
"dota_leaver_consequence_MatchDiscardedForOtherPlayers"	"Остальным игрокам не засчитается ни победа, ни поражение."
"dota_leaver_consequence_NotDecrementLowPriGamesRemaining"	"Эта игра не будет считаться завершенной вами."
"dota_reconnect_popup_title"	"Переподключиться?"
"dota_reconnect_popup_message"	"Заполнительный текст — желаете ли вы вернуться в игру?"
"dota_matchmaking_regions_refresh"	"Обновить"
"dota_matchmaking_region_ping"	"{s:region_ping}"
"dota_matchmaking_region_offline"	"На техобслуживании"
"dota_matchmaking_region_unknown_ping"	"Задержка: -"
"dota_matchmaking_region_ping_time"	"Задержка: {i:ping_ms} мс"
"DOTA_VAC_Verification_Header"	"Античит Valve (VAC)"
"DOTA_VAC_Verification_Header_Solo"	"Не удалось начать поиск игры, поскольку ваш компьютер блокирует систему VAC. Пожалуйста, убедитесь, что клиент Steam установлен правильно и вы не используете программы, конфликтующие с VAC."
"DOTA_VAC_Verification_Header_Party"	"Не удалось начать поиск игры, поскольку компьютер одного или нескольких членов группы блокирует систему VAC. Пожалуйста, убедитесь, что клиент Steam установлен правильно и вы не используете программы, конфликтующие с VAC."
"DOTA_VAC_Verification_Button1"	"Подробнее"
"DOTA_VAC_Verification_Button2"	"Закрыть"
"dota_matchmaking_regions_button"	"{s:regions_selected}"
"dota_region_automatic"	"Регион: автоматически"
"dota_regions_selected"	"Регионов:"
"dota_lobby_region_invalid"	"Нет"
"dota_play_no_language_selected"	"ВЫБРАТЬ ЯЗЫК"
"dota_play_language"	"{s:match_language}"
"dota_play_language_many"	"ЯЗЫКОВ: {i:match_language_count}"
"dota_ready_fail"	"ИГРА НЕ ПРИНЯТА"
"dota_ready_fail_desc"	"Вы были удалены из очереди, так как игра была готова, но вы не ответили."
"dota_all_chat_label"	"[ВСЕМ]"
"dota_chatwheel_label_Ok"	"Хорошо"
"dota_chatwheel_label_Care"	"Осторожно"
"dota_chatwheel_label_GetBack"	"Отходим"
"dota_chatwheel_label_NeedWards"	"Нужны варды"
"dota_chatwheel_label_Stun"	"Оглушай"
"dota_chatwheel_label_Help"	"На помощь"
"dota_chatwheel_label_Push"	"Наступаем"
"dota_chatwheel_label_GoodJob"	"Хорошо сыграно"
"dota_chatwheel_label_Missing"	"Враг ушел"
"dota_chatwheel_label_Missing_Top"	"Враг ушел сверху"
"dota_chatwheel_label_Missing_Mid"	"Враг ушел с центра"
"dota_chatwheel_label_Missing_Bottom"	"Враг ушел снизу"
"dota_chatwheel_label_Go"	"Вперед!"
"dota_chatwheel_label_Initiate"	"Начинай!"
"dota_chatwheel_label_Follow"	"За мной"
"dota_chatwheel_label_Group_Up"	"Сгруппируйтесь"
"dota_chatwheel_label_Spread_Out"	"Рассредоточьтесь"
"dota_chatwheel_label_Split_Farm"	"Разделяемся для фарма"
"dota_chatwheel_label_Attack"	"Атакуем сейчас!"
"dota_chatwheel_label_BRB"	"Скоро вернусь"
"dota_chatwheel_label_Dive"	"Под башню!"
"dota_chatwheel_label_OMW"	"Уже иду"
"dota_chatwheel_label_Get_Ready"	"Приготовьтесь"
"dota_chatwheel_label_Bait"	"Заманивайте"
"dota_chatwheel_label_Heal"	"Полечите"
"dota_chatwheel_label_Mana"	"Мана"
"dota_chatwheel_label_OOM"	"Нет маны"
"dota_chatwheel_label_Skill_Cooldown"	"Перезарядка"
"dota_chatwheel_label_Ulti_Ready"	"Ульт готов"
"dota_chatwheel_label_Enemy_Returned"	"Враг вернулся"
"dota_chatwheel_label_All_Missing"	"Все ушли"
"dota_chatwheel_label_Enemy_Incoming"	"Нас атакуют"
"dota_chatwheel_label_Invis_Enemy"	"Невидимый враг"
"dota_chatwheel_label_Enemy_Had_Rune"	"У врага руна"
"dota_chatwheel_label_Split_Push"	"Атакуем по разным линиям"
"dota_chatwheel_label_Coming_To_Gank"	"Иду на ганк"
"dota_chatwheel_label_Request_Gank"	"Нужен ганк"
"dota_chatwheel_label_Fight_Under_Tower"	"Под башню"
"dota_chatwheel_label_Deny_Tower"	"Добивай башню"
"dota_chatwheel_label_Buy_Courier"	"Купите курьера"
"dota_chatwheel_label_Upgrade_Courier"	"Улучшите курьера"
"dota_chatwheel_label_Need_Detection"	"Нам нужна просветка"
"dota_chatwheel_label_They_Have_Detection"	"У них просветка"
"dota_chatwheel_label_Buy_TP"	"Купите телепорт"
"dota_chatwheel_label_Reuse_Courier"	"Используйте курьера еще раз"
"dota_chatwheel_label_Deward"	"Уничтожьте варды"
"dota_chatwheel_label_Building_Mek"	"Собираю Mekansm"
"dota_chatwheel_label_Building_Pipe"	"Собираю Pipe of Insight"
"dota_chatwheel_label_Stack_And_Pull"	"Стакните и сделайте отвод"
"dota_chatwheel_label_Pull"	"Отведите крипов"
"dota_chatwheel_label_Pulling"	"Отвожу крипов"
"dota_chatwheel_label_Stack"	"Стакайте нейтралов"
"dota_chatwheel_label_Jungling"	"Ухожу в лес"
"dota_chatwheel_label_Roshan"	"Рошан"
"dota_chatwheel_label_Affirmative"	"Подтверждаю"
"dota_chatwheel_label_Wait"	"Подождите"
"dota_chatwheel_label_Pause"	"Нужна пауза"
"dota_chatwheel_label_Current_Time"	"Текущее время"
"dota_chatwheel_label_Check_Runes"	"Проверьте руны"
"dota_chatwheel_label_Smoke_Gank"	"Ганкаем в смоке!"
"dota_chatwheel_label_GLHF"	"Удачи"
"dota_chatwheel_label_Nice"	"Отлично"
"dota_chatwheel_label_Thanks"	"Спасибо"
"dota_chatwheel_label_Sorry"	"Извините"
"dota_chatwheel_label_No_Give_Up"	"Не сдаемся"
"dota_chatwheel_label_Just_Happened"	"Такие дела"
"dota_chatwheel_label_Game_Is_Hard"	"Трудная игра"
"dota_chatwheel_label_New_Meta"	"Новая мета"
"dota_chatwheel_label_My_Bad"	"Виноват"
"dota_chatwheel_label_Regret"	"Сожалею"
"dota_chatwheel_label_Relax"	"Расслабься"
"dota_chatwheel_label_GG"	"GG"
"dota_chatwheel_label_GGWP"	"GGWP"
"dota_chatwheel_label_All_GG"	"(Всем) GG"
"dota_chatwheel_label_All_GGWP"	"(Всем) GGWP"
"dota_chatwheel_label_What_To_Buy"	"Что купить?"
"dota_chatwheel_label_Im_Retreating"	"Отступаю"
"dota_chatwheel_label_Space_Created"	"Я отвлек противников"
"dota_chatwheel_label_Whoops"	"Ой"
"dota_chatwheel_label_Tower_then_Back"	"Сносим башню и отходим"
"dota_chatwheel_label_Barracks_then_Back"	"Сносим казармы и отходим"
"dota_chatwheel_label_Ward_Bottom_Rune"	"Вард на нижнюю руну"
"dota_chatwheel_label_Ward_Top_Rune"	"Вард на верхнюю руну"
"dota_chatwheel_label_Zeus_Ult"	"Зевс, ультуй"
"dota_chatwheel_header_positioning"	"Местоположение"
"dota_chatwheel_header_status"	"Состояние"
"dota_chatwheel_header_enemy"	"Противник"
"dota_chatwheel_header_lane"	"Линия"
"dota_chatwheel_header_items"	"Предметы"
"dota_chatwheel_header_neutrals"	"Нейтральные"
"dota_chatwheel_header_misc"	"Разное"
"dota_chatwheel_header_flavor"	"По вкусу"
"dota_chatwheel_message_Ok"	"Хорошо."
"dota_chatwheel_message_Care"	"Осторожно!"
"dota_chatwheel_message_GetBack"	"Назад!"
"dota_chatwheel_message_NeedWards"	"Нам нужны варды."
"dota_chatwheel_message_Stun"	"Оглушай!"
"dota_chatwheel_message_Help"	"Помогите!"
"dota_chatwheel_message_Push"	"Атакуем строения!"
"dota_chatwheel_message_GoodJob"	"Хорошо сыграно!"
"dota_chatwheel_message_Missing"	"Врага нет на линии!"
"dota_chatwheel_message_Missing_Top"	"Враг ушел сверху!"
"dota_chatwheel_message_Missing_Mid"	"Враг ушел с центра!"
"dota_chatwheel_message_Missing_Bottom"	"Враг ушел снизу!"
"dota_chatwheel_message_Go"	"Вперед!"
"dota_chatwheel_message_Initiate"	"Начинайте!"
"dota_chatwheel_message_Follow"	"За мной"
"dota_chatwheel_message_Group_Up"	"Сгруппируйтесь"
"dota_chatwheel_message_Spread_Out"	"Рассредоточьтесь"
"dota_chatwheel_message_Split_Farm"	"Рассредоточьтесь и фармите"
"dota_chatwheel_message_Attack"	"Атакуем!"
"dota_chatwheel_message_BRB"	"Скоро вернусь"
"dota_chatwheel_message_Dive"	"Под башню!"
"dota_chatwheel_message_OMW"	"Уже иду"
"dota_chatwheel_message_Get_Ready"	"Приготовьтесь"
"dota_chatwheel_message_Bait"	"Заманивайте"
"dota_chatwheel_message_Heal"	"Полечите"
"dota_chatwheel_message_Mana"	"Нужна мана"
"dota_chatwheel_message_OOM"	"Закончилась мана"
"dota_chatwheel_message_Skill_Cooldown"	"Способности на перезарядке"
"dota_chatwheel_message_Ulti_Ready"	"Ульт готов"
"dota_chatwheel_message_Enemy_Returned"	"Противник вернулся"
"dota_chatwheel_message_All_Missing"	"Все вражеские герои отсутствуют!"
"dota_chatwheel_message_Enemy_Incoming"	"Враг приближается!"
"dota_chatwheel_message_Invis_Enemy"	"Рядом невидимый враг!"
"dota_chatwheel_message_Enemy_Had_Rune"	"Враг забрал руну"
"dota_chatwheel_message_Split_Push"	"Атакуем по разным линиям"
"dota_chatwheel_message_Coming_To_Gank"	"Собираюсь совершить ганк"
"dota_chatwheel_message_Request_Gank"	"Нужен ганк"
"dota_chatwheel_message_Fight_Under_Tower"	"Сражайтесь под башней"
"dota_chatwheel_message_Deny_Tower"	"Добивайте башню!"
"dota_chatwheel_message_Buy_Courier"	"Пожалуйста, купите курьера"
"dota_chatwheel_message_Upgrade_Courier"	"Кто-нибудь может улучшить курьера?"
"dota_chatwheel_message_Need_Detection"	"Нам нужны средства обнаружения"
"dota_chatwheel_message_They_Have_Detection"	"Они видят невидимых"
"dota_chatwheel_message_Buy_TP"	"Купите мне свиток телепортации"
"dota_chatwheel_message_Reuse_Courier"	"Используйте курьера снова"
"dota_chatwheel_message_Deward"	"Уничтожьте варды, пожалуйста"
"dota_chatwheel_message_Building_Mek"	"Собираю Mekansm"
"dota_chatwheel_message_Building_Pipe"	"Собираю Pipe of Insight"
"dota_chatwheel_message_Stack_And_Pull"	"Стакните и сделайте отвод"
"dota_chatwheel_message_Pull"	"Отведите крипов, пожалуйста"
"dota_chatwheel_message_Pulling"	"Отвожу крипов"
"dota_chatwheel_message_Stack"	"Стакайте нейтралов"
"dota_chatwheel_message_Jungling"	"Иду в лес"
"dota_chatwheel_message_Roshan"	"Рошан"
"dota_chatwheel_message_Affirmative"	"Подтверждаю"
"dota_chatwheel_message_Wait"	"Подождите"
"dota_chatwheel_message_Pause"	"Поставьте паузу, пожалуйста!"
"dota_chatwheel_message_Current_Time"	"Текущее игровое время"
"dota_chatwheel_message_Check_Runes"	"Проверьте руны, пожалуйста"
"dota_chatwheel_message_Smoke_Gank"	"Давайте ганкнем!"
"dota_chatwheel_message_GLHF"	"Удачи и веселой игры"
"dota_chatwheel_message_Nice"	"Отлично"
"dota_chatwheel_message_Thanks"	"Спасибо!"
"dota_chatwheel_message_Sorry"	"Прошу прощения"
"dota_chatwheel_message_No_Give_Up"	"Не сдавайтесь!"
"dota_chatwheel_message_Just_Happened"	"Такие дела"
"dota_chatwheel_message_Game_Is_Hard"	"Тяжелая игра"
"dota_chatwheel_message_New_Meta"	"Новая мета"
"dota_chatwheel_message_My_Bad"	"Виноват"
"dota_chatwheel_message_Regret"	"Я сожалею о своем поступке"
"dota_chatwheel_message_Relax"	"Успокойся, всё в порядке"
"dota_chatwheel_message_MissingHero"	"%s1 нет на линии!"
"dota_chatwheel_message_ReturnedHero"	"%s1 на месте!"
"dota_chatwheel_message_GG"	"GG"
"dota_chatwheel_message_GGWP"	"GG, WP"
"dota_chatwheel_message_All_GG"	"Хорошая игра"
"dota_chatwheel_message_All_GGWP"	"GG, WP"
"dota_chatwheel_message_What_To_Buy"	"Что мне купить?"
"dota_chatwheel_message_Im_Retreating"	"Отступаю"
"dota_chatwheel_message_Space_Created"	"Я отвлек противников"
"dota_chatwheel_message_Whoops"	"Ой"
"dota_chatwheel_message_Tower_then_Back"	"Сносим башню и отходим"
"dota_chatwheel_message_Barracks_then_Back"	"Сносим казармы и отходим"
"dota_chatwheel_message_Ward_Bottom_Rune"	"Поставьте вард на нижнюю руну"
"dota_chatwheel_message_Ward_Top_Rune"	"Поставьте вард на верхнюю руну"
"dota_chatwheel_message_Zeus_Ult"	"Зевс, ультуй!"
"dota_settings_hotkeys"	"Горячие клавиши"
"dota_settings_options"	"Настройки"
"dota_settings_audio"	"Звук"
"dota_settings_voice"	"Голос"
"dota_settings_voice_level"	"Текущая громкость"
"dota_settings_voice_steam_link"	"Настройки устройства записи определены при помощи <a href=\"event:DOTAShowSteamVoiceSettings()\">настроек голоса Steam</a>."
"dota_settings_volume"	"Громкость"
"dota_settings_video"	"Видео"
"dota_settings_resetkeys"	"Сбросить клавиши…"
"dota_settings_legacykeys"	"Классические"
"dota_settings_abilities"	"Способности"
"dota_settings_abilities_hero"	"Герой"
"dota_settings_abilities_neutrals"	"Нейтралы"
"dota_settings_abilities_courier"	"Курьер"
"dota_settings_abilities_primary1"	"1"
"dota_settings_abilities_primary2"	"2"
"dota_settings_abilities_primary3"	"3"
"dota_settings_abilities_secondary1"	"4"
"dota_settings_abilities_secondary2"	"5"
"dota_settings_abilities_neutral1"	"1"
"dota_settings_abilities_neutral2"	"2"
"dota_settings_abilities_neutral3"	"3"
"dota_settings_abilities_neutral4"	"4"
"dota_settings_abilities_courier1"	"1"
"dota_settings_abilities_courier2"	"2"
"dota_settings_abilities_courier3"	"3"
"dota_settings_abilities_courier4"	"4"
"dota_settings_abilities_courier5"	"5"
"dota_settings_abilities_courier6"	"6"
"dota_settings_abilities_ultimate"	"У"
"dota_settings_cast"	"Применение"
"dota_settings_autocast"	"Автомат."
"dota_settings_quickcast"	"Быстрое"
"dota_settings_mirror"	"Использовать клавиши с панели героя"
"dota_settings_abilitylearn"	"Изучить способность"
"dota_settings_upgradestats"	"Повысить характеристики"
"dota_settings_unitactions"	"Действия юнитов"
"dota_settings_attack"	"Атаковать"
"dota_settings_move"	"Идти"
"dota_settings_stop"	"Остановиться"
"dota_settings_holdposition"	"Удерживать позицию"
"dota_settings_selecthero"	"Выбрать героя"
"dota_settings_selectall"	"Выбрать всех юнитов"
"dota_settings_selectallothers"	"Выбрать всех прочих юнитов"
"dota_settings_selectcourier"	"Выбрать курьера"
"dota_settings_courierdeliver"	"Курьер — доставить предметы"
"dota_settings_courierhaste"	"Курьер — ускорение"
"dota_settings_useactionitem"	"Предмет действия"
"dota_settings_herotaunt"	"Насмешка"
"dota_settings_items"	"Предметы"
"dota_settings_openshop"	"Открыть лавку"
"dota_settings_purchasequickbuy"	"Быстрая покупка"
"dota_settings_purchasesticky"	"Купить закрепленный предмет"
"dota_settings_grabstashitems"	"Забрать предметы из тайника"
"dota_settings_camera"	"Камера"
"dota_settings_cameraactions"	"Действия камеры"
"dota_settings_cameraup"	"Сдвинуть камеру вперед"
"dota_settings_cameradown"	"Сдвинуть камеру назад"
"dota_settings_cameraleft"	"Сдвинуть камеру налево"
"dota_settings_cameraright"	"Сдвинуть камеру направо"
"dota_settings_cameragrip"	"Захват камеры"
"dota_settings_recentevent"	"Показать последнее событие"
"dota_settings_inspectheroinworld"	"Подробный просмотр"
"dota_settings_chat"	"Чат"
"dota_settings_phrases"	"Фразы"
"dota_settings_chatwheel_page"	"Колесо чата"
"dota_settings_chatteam"	"Командный чат"
"dota_settings_chatglobal"	"Общий чат"
"dota_settings_chatvoice_party"	"Голос (группе)"
"dota_settings_chatvoice_team"	"Голос (команде)"
"dota_settings_chatwheel_show"	"Колесо чата"
"dota_settings_playeractions"	"Действия игрока"
"dota_settings_activateglyph"	"Укрепить строения"
"dota_settings_scoreboardtoggle"	"Таблица счета"
"dota_settings_pause"	"Пауза"
"dota_settings_screenshot"	"Скриншот"
"dota_settings_console"	"Консоль"
"dota_settings_controlgroups"	"Подконтрольные группы"
"dota_settings_controlgroupsadditional"	"Доп. контрольные группы"
"dota_settings_controlgroupcycle"	"Переключение между юнитами"
"dota_settings_group1"	"1-я группа"
"dota_settings_group2"	"2-я группа"
"dota_settings_group3"	"3-я группа"
"dota_settings_group4"	"4-я группа"
"dota_settings_group5"	"5-я группа"
"dota_settings_group6"	"6-я группа"
"dota_settings_group7"	"7-я группа"
"dota_settings_group8"	"8-я группа"
"dota_settings_group9"	"9-я группа"
"dota_settings_group10"	"10-я группа"
"dota_settings_advancedpanel_goto"	"Дополнительные"
"dota_settings_standardpanel_goto"	"Стандартные"
"dota_settings_spectatorandreplay"	"Режим наблюдения"
"dota_settings_spectatorandreplay_pt2"	"Режим наблюдения"
"dota_settings_spectatorcameraup"	"Зритель - камера вперед"
"dota_settings_spectatorcameradown"	"Зритель - камера назад"
"dota_settings_spectatorcameraleft"	"Зритель - камера налево"
"dota_settings_spectatorcameraright"	"Зритель - камера направо"
"dota_settings_spectatorcameragrip"	"Зритель - захват камеры"
"dota_settings_spectatorpause"	"Зритель - пауза"
"dota_settings_spectatorchat"	"Чат зрителей"
"dota_settings_spectatorscoreboard"	"Зритель - таблица счета"
"dota_settings_spectatorbroadcastermenu"	"Открыть меню комментатора"
"dota_settings_spectatorincreasereplayspeed"	"Увеличить скорость показа"
"dota_settings_spectatordecreasereplayspeed"	"Уменьшить скорость показа"
"dota_settings_spectatorstatsitem"	"Зритель - предметы игроков"
"dota_settings_spectatorstatsgold"	"Зритель - разница в золоте"
"dota_settings_spectatorstatsxp"	"Зритель - разница в опыте"
"dota_settings_spectatorstatsfantasy"	"Зритель - фэнтези-статистика"
"dota_settings_spectatorfowboth"	"Зритель - туман войны обеих команд"
"dota_settings_spectatorfowradient"	"Зритель - туман войны сил Света"
"dota_settings_spectatorfowdire"	"Зритель - туман войны сил Тьмы"
"dota_settings_statsdropdown"	"Панель статистики"
"dota_settings_spectatordropdown_sort"	"Поменять сортировку"
"dota_settings_spectatordropdown_close"	"Очистить категорию"
"dota_settings_spectatordropdown_kda"	"Убийства / Смерти / Помощь"
"dota_settings_spectatordropdown_lasthits_denies"	"Добито/Отнято"
"dota_settings_spectatordropdown_level"	"Уровень героев"
"dota_settings_spectatordropdown_xp_per_min"	"Опыт в минуту"
"dota_settings_spectatordropdown_gold"	"Текущее золото"
"dota_settings_spectatordropdown_totalgold"	"Общая ценность"
"dota_settings_spectatordropdown_gold_per_min"	"Золото в минуту"
"dota_settings_spectatordropdown_buyback"	"Состояние выкупа"
"dota_settings_spectatordropdown_fantasy"	"Фэнтези-очки"
"dota_settings_coaching"	"Тренировка"
"dota_settings_spectatorcoach_viewtoggle"	"Смотреть от лица ученика"
"dota_settings_keyboardtemplate"	"Выберите раскладку клавиатуры"
"dota_settings_or"	"Или"
"dota_settings_cancel"	"Отмена"
"dota_settings_apply"	"Применить"
"dota_settings_game"	"Игра"
"dota_settings_autoattack"	"Автоатака"
"dota_settings_attackafterspell"	"Автоатака после применения способности"
"dota_settings_autopurchase"	"Автозакупка предметов"
"dota_settings_autoselect"	"Автовыбор призванных существ"
"dota_settings_doubletapself"	"Применение на себя двойным нажатием"
"dota_settings_unifiedorders"	"Приказ всем юнитам"
"dota_settings_teleportrequireshalt"	"Остановка телепортации клавишей"
"dota_settings_herofinder"	"Подсветка героя клавишей Alt"
"dota_settings_alwaysshownames"	"Показывать имена игроков над их здоровьем"
"dota_settings_showhitpoints"	"Отображать здоровье числом"
"dota_settings_forceshophotkeys"	"Покупка горячими клавишами"
"dota_settings_usebroadcastermenu"	"Использовать статистику комментатора"
"dota_settings_colorblind"	"Режим цветовой слепоты"
"dota_settings_reducedflash"	"Слабые вспышки"
"dota_settings_minimap"	"Мини-карта"
"dota_settings_minimapsimplecolors"	"Простые цвета на мини-карте"
"dota_settings_minimaphidebackground"	"Скрыть фон мини-карты"
"dota_settings_minimapshowheroicon"	"Иконки героев на мини-карте"
"dota_settings_minimapalwaysshowname"	"Всегда отображать имена и иконки на мини-карте"
"dota_settings_minimapflip"	"Мини-карта справа"
"dota_settings_cameradecel"	"Замедление камеры"
"dota_settings_cameraspeed"	"Скорость камеры"
"dota_settings_camerareversegrip"	"Инвертировать движение камеры"
"dota_settings_cameraedgepan"	"Прокрутка по краю экрана"
"dota_settings_camerascreenshake"	"Дрожание экрана"
"dota_settings_cameraresetonspawn"	"Камера на герое при возрождении"
"dota_settings_cameradeadcolorshift"	"Изменение цвета камеры при смерти"
"dota_settings_profile"	"Профиль"
"dota_settings_hideprofile"	"Скрыть профили Dota 2 и Steam"
"dota_settings_exposematchdata"	"Общедоступная история матчей"
"dota_settings_ignorenonfriendparties"	"Блокировать приглашения в группы не от друзей"
"dota_settings_ignorenonfriendguilds"	"Блокировать приглашения в гильдии не от друзей"
"dota_settings_allowtradeinvitesheader"	"Предлагать обмен могут:"
"dota_settings_trade_guildandfriends"	"Друзья и согильдийцы"
"dota_settings_trade_friends"	"Только друзья"
"dota_settings_trade_anyone"	"Все"
"dota_settings_network"	"Соединение"
"dota_settings_networkquality"	"Качество соединения"
"dota_settings_networkquality_low"	"Низкое"
"dota_settings_networkquality_high"	"Высокое"
"dota_settings_usenativeresolution"	"Использовать разрешение экрана"
"dota_settings_customresolution"	"Расширенные настройки"
"dota_settings_resolution"	"Разрешение"
"dota_settings_rendering"	"Обработка"
"dota_settings_aspectratio"	"Соотношение сторон"
"dota_settings_aspectratio43"	"4:3"
"dota_settings_aspectratio169"	"16:9"
"dota_settings_aspectratio1610"	"16:10"
"dota_settings_resolution_size"	"Размер"
"dota_settings_resolution_display_mode"	"Режим отображения"
"dota_settings_fullscreen"	"На весь экран"
"dota_settings_window"	"В окне"
"dota_settings_borderless"	"В окне без рамки"
"dota_settings_videodefaults"	"Видео по умолчанию"
"dota_settings_basicvideosettings"	"Использовать простые настройки"
"dota_settings_fastestvideo"	"Скорость"
"dota_settings_appearancevideo"	"Внешний вид"
"dota_settings_advancedvideosettings"	"Использовать дополнительные настройки"
"dota_settings_antialiasing"	"Сглаживание"
"dota_settings_specular"	"Отражения"
"dota_settings_bloom"	"Свечение"
"dota_settings_waterquality"	"Высокое качество воды"
"dota_settings_fog"	"Атмосферный туман"
"dota_settings_animateportrait"	"Анимированные портреты"
"dota_settings_additivelight"	"Доп. обработка света"
"dota_settings_worldlight"	"Освещение мира"
"dota_settings_ambientocclusion"	"Глобальное затенение"
"dota_settings_ambientcreatures"	"Фауна"
"dota_settings_normal_maps"	"Рельефное текстурирование"
"dota_settings_vsync"	"Вертикальная синхронизация"
"dota_settings_renderquality"	"Качество обработки экрана"
"dota_settings_shadowquality"	"Подробные тени"
"dota_settings_shadowquality_low"	"Низкое"
"dota_settings_shadowquality_med"	"Среднее"
"dota_settings_shadowquality_high"	"Высокое"
"dota_settings_texturequality"	"Качество текстур"
"dota_settings_texturequality_low"	"Низкое"
"dota_settings_texturequality_med"	"Среднее"
"dota_settings_texturequality_high"	"Высокое"
"dota_settings_mastervolume"	"Общая громкость"
"dota_settings_gamevolume"	"Громкость игры"
"dota_settings_musicvolume"	"Громкость музыки"
"dota_settings_voicevolume"	"Громкость голоса"
"dota_settings_gamevoicevolume"	"Громкость речи юнитов"
"dota_settings_openmic"	"Отметьте «Без нажатия», чтобы общаться с членами группы"
"dota_settings_openmicthreshold"	"Нижний предел громкости"
"dota_settings_audiodefaults"	"Звук по умолчанию"
"dota_settings_defaultaudio"	"По умолчанию"
"dota_settings_sounddevice"	"Звуковое устройство:"
"dota_settings_speakerconfig"	"Настройка колонок:"
"dota_settings_headphones"	"Наушники"
"dota_settings_2speakers"	"2 динамика"
"dota_settings_4speakers"	"4 динамика"
"dota_settings_5speakers"	"Динамики 5.1"
"dota_settings_7speakers"	"Динамики 7.1"
"dota_settings_captions"	"Субтитры"
"dota_settings_playsoundinbackground"	"Звук при свернутой игре"
"dota_settings_chatsounds"	"Звук сообщений в чате"
"dota_settings_mutecobroadcasters"	"Заглушить сокомментаторов"
"dota_settings_highqualityaudio"	"Звук высокого качества"
"dota_settings_enhancestereo"	"Улучшенное стерео"
"dota_settings_unitspeeh"	"Речь юнитов"
"dota_settings_unitspeech_off"	"Нет"
"dota_settings_unitspeech_events"	"События"
"dota_settings_unitspeech_all"	"Все"
"OS_Default_Device"	"Устройство по умолчанию"
"DOTA_Keybind_ARROW"	"Стрелочки (по умолчанию)"
"DOTA_Keybind_WASD"	"WASD"
"DOTA_Keybind_MMO"	"MMO"
"DOTA_Keybind_LEGACY"	"Классические"
"DOTA_Keybind_LOL"	"League of Legends"
"DOTA_Keybind_HON"	"Heroes of Newerth
"
"DOTA_Keybind_SMITE"	"Smite"
"DOTA_Hotkeys_Tooltip_LearnAbility"	"Войти в режим изучения способностей, если у вас есть не потраченные очки навыков."
"DOTA_Hotkeys_Tooltip_LearnStats"	"Добавить по два очка ко всем характеристикам, если у вас есть не потраченные очки навыков."
"DOTA_Hotkeys_Tooltip_HeroAttack"	"Двигаться к указанному месту, но атаковать врага при его появлении/атаковать союзника, если его можно добить."
"DOTA_Hotkeys_Tooltip_HeroMove"	"Двигаться к указанному месту или следовать за юнитом, не атакуя его."
"DOTA_Hotkeys_Tooltip_HeroStop"	"Прервать текущее действие."
"DOTA_Hotkeys_Tooltip_HeroHold"	"Прервать текущее действие и стоять на одном месте."
"DOTA_Hotkeys_Tooltip_HeroSelect"	"Выбрать героя."
"DOTA_Hotkeys_Tooltip_SelectAll"	"Выбрать всех подконтрольных юнитов."
"DOTA_Hotkeys_Tooltip_SelectAllOthers"	"Выбрать всех подконтрольных юнитов (герой не будет выбран)."
"DOTA_Hotkeys_Tooltip_CourierSelect"	"Выбрать курьера."
"DOTA_Hotkeys_Tooltip_CourierDeliver"	"Приказать курьеру доставить вам предметы из тайника."
"DOTA_Hotkeys_Tooltip_CourierHaste"	"Ускорить курьера (если возможно)."
"DOTA_Hotkeys_Tooltip_UseActionItem"	"Использовать предмет действия."
"DOTA_Hotkeys_Tooltip_HeroTaunt"	"Использовать насмешку героя. Для этого ее необходимо надеть."
"DOTA_Hotkeys_Tooltip_ShopToggle"	"Открыть панель лавки."
"DOTA_Hotkeys_Tooltip_PurchaseQuickbuy"	"Приобрести следующий предмет из быстрой покупки (если хватает золота)."
"DOTA_Hotkeys_Tooltip_PurchaseSticky"	"Приобрести закрепленный предмет (если хватает золота)."
"DOTA_Hotkeys_Tooltip_GrabStashItems"	"Передать все предметы из тайника герою."
"DOTA_Hotkeys_Tooltip_RecentEvent"	"Передвинуть камеру на место недавнего игрового события."
"DOTA_Hotkeys_Tooltip_InspectHeroInWorld"	"Посмотреть на юнита вблизи."
"DOTA_Hotkeys_Tooltip_ChatTeam"	"Отправить сообщение всем в вашей команде."
"DOTA_Hotkeys_Tooltip_ChatGlobal"	"Отправить сообщение всем в текущей игре (для сообщения команде нужно будет зажать клавишу SHIFT)."
"DOTA_Hotkeys_Tooltip_ChatVoiceParty"	"Общайтесь со всеми членами группы, используя микрофон. Отметьте «Без нажатия», чтобы общаться и в главном меню."
"DOTA_Hotkeys_Tooltip_ChatVoiceTeam"	"Общайтесь с остальными членами команды, используя микрофон."
"DOTA_Hotkeys_Tooltip_ChatWheel"	"Открыть колесо чата, позволяющее легко общаться с помощью набора частых фраз."
"DOTA_Hotkeys_Tooltip_CameraGrip"	"Для перемещения камеры нужно зажать эту клавишу или среднюю кнопку мыши."
"DOTA_Hotkeys_Tooltip_ActivateGlyph"	"Укрепить союзные строения и сделать их неуязвимыми на 5 секунд."
"DOTA_Hotkeys_Tooltip_ScoreboardToggle"	"Открыть внутриигровую таблицу результатов."
"DOTA_Hotkeys_Tooltip_Pause"	"Приостановить или возобновить игру."
"DOTA_Hotkeys_Tooltip_ScreenshotSettings"	"Сделать скриншот происходящего в игре."
"DOTA_Hotkeys_Tooltip_Console"	"Открыть консоль (только для опытных пользователей)."
"DOTA_Hotkeys_Tooltip_ControlGroupCycle"	"Переключиться на следующего юнита выбранной группы."
"DOTA_Hotkeys_Tooltip_Group"	"Выбрать установленную группу юнитов. Чтобы запомнить подконтрольную группу, выберите нужных юнитов и нажмите CTRL и одну из горячих клавиш групп."
"DOTA_Hotkeys_Tooltip_Legacy"	"Использовать все горячие клавиши из Dota 1. Клавиши способностей каждого героя будут разными."
"DOTA_Hotkeys_Tooltip_Quickcast"	"Быстрое применение способности сработает на области под курсором мыши по нажатии соответствующей клавиши."
"DOTA_Hotkeys_Tooltip_Autocast"	"Автоматическое применение способности, когда она будет готова. Действует не на все способности."
"DOTA_Hotkeys_Tooltip_Cast"	"Горячие клавиши для использования способностей героя."
"DOTA_Hotkeys_Tooltip_ItemCast"	"Горячие клавиши для использования предметов в инвентаре."
"DOTA_Hotkeys_Tooltip_ItemQuickcast"	"Быстрое применение предмета сработает на области под курсором мыши по нажатии соответствующей клавиши."
"DOTA_Settings_Tooltip_Autoattack"	"Автоматически подходить к ближайшим врагам и атаковать их."
"DOTA_Settings_Tooltip_AutoattackAfterSpell"	"Если опция отключена, после использования заклинания герой будет оставаться на месте, ожидая следующего приказа."
"DOTA_Settings_Tooltip_AutoPurchase"	"Приобрести следующий предмет из списка рекомендуемого сразу, как только у вас появится нужное количество золота для покупки."
"DOTA_Settings_Tooltip_AutoSelectSummons"	"Когда герой призовет новых юнитов, они сразу же будут выделены."
"DOTA_Settings_Tooltip_DoubleTap"	"Двойное нажатие по способности или предмету либо назначенной им клавише позволит применить их на себя, если возможно."
"DOTA_Settings_Tooltip_UnifiedOrders"	"При нажатой клавише Ctrl приказ будет отдан всем юнитам под вашим контролем."
"DOTA_Settings_Tooltip_TeleportStop"	"Отдав приказ во время телепортации, вы ее не отмените. Действует только на Town Portal Scroll или Boots of Travel."
"DOTA_Settings_Tooltip_BroadcasterStats"	"При просмотре игры будет показана выбранная комментатором статистика."
"DOTA_Settings_Tooltip_Deceleration"	"Скорость, с которой камера приходит в состояние покоя после движения. Большее число соответствует более быстрой остановке."
"DOTA_Settings_Tooltip_Screenshake"	"Некоторые заклинания и оглушения трясут камеру."
"DOTA_Settings_Tooltip_CameraRespawn"	"Возвращает камеру на вашего героя после того, как он возродится."
"DOTA_Settings_Tooltip_HideProfile"	"Ваш профиль Dota 2 не будет доступен никому. Ваш профиль Steam не будет доступен из Dota 2."
"DOTA_Settings_Tooltip_ShareMatchData"	"Предоставляет данные матчей из ваших публичных игр сторонним лицам."
"DOTA_Settings_Tooltip_NetworkQuality"	"Если у вас медленное интернет-соединение, выберите «НИЗКИЙ» — это может улучшить производительность сети."
"DOTA_Settings_Tooltip_MinimapSimple"	"Цвета на мини-карте определяются командой, а не игроком."
"DOTA_Settings_Tooltip_MinimapDrawHeroes"	"Если зажать клавишу Alt, вместо имени героя на мини-карте будет показана его иконка."
"DOTA_Settings_Tooltip_MinimapNamesIcon"	"Всегда показывать иконку или имя героя на мини-карте, при зажатой клавише Alt будут отображаться крестики и круги."
"DOTA_Settings_Tooltip_ShopHotkeys"	"Когда магазин открыт, его горячие клавиши заменят другие функции этих клавиш."
"DOTA_Settings_LegacyKeysActive"	"Включены классические клавиши из первой Dota. Чтобы изменить настройки клавиш, выключите классические настройки."
"DOTA_create_bot_practice_desc"	"Сыграйте против искусственного интеллекта. Вы можете использовать поиск игры, чтобы в вашей команде были люди, или заполнить пустые места ботами."
"DOTA_Lobby_BotDifficulty"	"Сложность ботов"
"DOTA_Lobby_BotDifficulty_no_bot"	"Без ботов"
"DOTA_Lobby_BotDifficulty_passive"	"Пассивный"
"DOTA_Lobby_BotDifficulty_easy"	"Легкий"
"DOTA_Lobby_BotDifficulty_medium"	"Средний"
"DOTA_Lobby_BotDifficulty_hard"	"Сложный"
"DOTA_Lobby_BotDifficulty_unfair"	"Нечестный"
"DOTA_Lobby_BotTeam"	"Выбрать команду"
"DOTA_create_bot_practice_solo"	"Одиночная"
"DOTA_create_bot_practice_solo_desc"	"Локальная тренировка против ботов. Она не использует подбор игр, и вы сможете покинуть ее в любое время."
"DOTA_create_bot_practice_coop"	"Совместная"
"DOTA_create_bot_practice_coop_desc"	"Играйте против ботов с живыми игроками. <font color='#dd6666'>ВНИМАНИЕ:</font> покинув эту игру, вы понесете наказание."
"DOTA_Lobby_BotDifficulty_bot_passive"	"Пассивный бот"
"DOTA_Lobby_BotDifficulty_bot_easy"	"Легкий бот"
"DOTA_Lobby_BotDifficulty_bot_medium"	"Средний бот"
"DOTA_Lobby_BotDifficulty_bot_hard"	"Сложный бот"
"DOTA_Lobby_BotDifficulty_bot_unfair"	"Нечестный бот"
"dota_lobby_title"	"{s:lobby_name}"
"dota_lobby_title_local_game"	"Локальное лобби"
"dota_lobby_title_default"	"Лобби"
"lobby_row_player_name"	"{s:player_name}"
"dota_lobby_row_game_name"	"{s:game_name}"
"dota_lobby_row_slots"	"{s:slots}"
"dota_lobby_row_game_mode"	"{s:game_mode}"
"dota_lobby_row_join"	"Занять"
"dota_lobby_row_leave"	"Покинуть"
"dota_lobby_coaches_title"	"Тренеры"
"dota_lobby_browser_all_game_modes"	"Все режимы игры"
"dota_lobby_browser_title"	"Поиск лобби"
"dota_lobby_browser_num_available"	"(доступно: {d:lobbies_available})"
"dota_lobby_browser_no_lobbies"	"Лобби отсутствуют"
"dota_lobby_browser_no_matching_lobbies"	"Не найдено лобби по вашему запросу"
"dota_lobby_browser_updating"	"Обновление списка лобби…"
"dota_lobby_browser_search_placeholder"	"Поиск лобби"
"dota_lobby_browser_game_mode"	"Режим игры"
"dota_lobby_browser_refresh"	"Обновить"
"dota_lobby_browser_filter_title"	"Сортировка лобби"
"dota_lobby_submit_filter"	"Принять"
"dota_popup_lobby_password_title"	"Введите пароль"
"DOTA_AttackCapability_Melee"	"Ближний бой"
"DOTA_AttackCapability_Ranged"	"Дальний бой"
"DOTA_Item_OnMarket"	"Торговая площадка"
"DOTA_Items_DefaultSet"	"Стандартный набор"
"DOTA_Items_SetEquipped_Label"	"Надето"
"DOTA_EquippedItem_Label"	"Надето"
"DOTA_PreviewingItem_Label"	"Предпросмотр"
"DOTA_EquippedItem_Rarity"	"{s:equipped_econ_set_rarity}"
"DOTA_EquippedItem_SetName"	"{s:equipped_econ_set_name}"
"DOTA_EquippedItem_DefaultSet"	"Стандартный набор"
"DOTA_EquippedItem_PartialSet"	"Частичный набор"
"DOTA_EquippedItem_Style"	"Стилей: {i:equipped_econ_set_style_count}"
"DOTA_EquippedItem_Button_Details"	"{s:equipped_details_button_text}"
"DOTA_EquippedItem_Customize"	"Переодеть"
"DOTA_EquippedItem_CustomSet"	"Свой набор"
"DOTA_EquippedItem_Equip"	"Надеть"
"DOTA_EquippedItem_Unpack_And_Equip"	"Распаковать и надеть"
"DOTA_EquippedItem_Details"	"Подробнее о {s:equipped_econ_set_type_name}"
"DOTA_EquippedItem_Purchase_Button"	"Купить"
"DOTA_EquippedItem_Marketplace_Button"	"Торговая площадка"
"DOTA_EquippedItem_BundleName"	"В комплекте «{s:equipped_econ_set_bundle}»"
"DOTA_EquippedItem_FilterText"	"Предпросмотр"
"DOTA_EquippedItem_SaleAmount"	"-{i:equipped_econ_set_sale_amount}%"
"DOTA_EquippedItem_RegularSetPrice"	"{s:equipped_econ_regular_set_price}"
"DOTA_EquippedItem_SetPrice"	"{s:equipped_econ_set_price}"
"DOTA_EquippedItem_TreasurePrice"	"{s:equipped_econ_treasure_price}"
"DOTA_HeroDemo_Button"	"Демо: {s:econ_item_category_name}"
"DOTA_HeroDemo_Button_Tooltip"	"Запустить демо-режим, позволяющий опробовать способности и предметы героя."
"DOTA_HeroDemo_Button_Return"	"Вернуться к демо"
"DOTA_HeroDemo_Button_Return_Tooltip"	"Вернуться в демо-режим и загрузить выбранного героя или предметы."
"DOTA_HeroDemo_Button_DBQuit"	"Закрыть демо"
"DOTA_EquippedItem_Bundle"	"Комплект"
"DOTA_EquippedItem_ItemSet"	"Набор"
"DOTA_EquippedItem_Item"	"Предмет"
"DOTA_EconItemSet_Name"	"{s:econ_set_name}"
"DOTA_EconItemSet_Rarity"	"{s:econ_set_rarity}"
"DOTA_EconItemSet_Status"	"{s:econ_set_status}"
"DOTA_EconItemSet_Price"	"{s:econ_set_price}"
"DOTA_EconItemSet_SaleAmount"	"-{i:econ_sale_amount}%"
"DOTA_EconItemSet_DeveloperOnly"	"Приватный"
"DOTA_EconItemSet_Tooltip_InBundle"	"Входит в комплект предметов"
"DOTA_EconItemSet_Tooltip_PartialSet"	"Содержит только часть полного набора предметов"
"DOTA_EconItemSet_Tooltip_MultipleStyles"	"Несколько стилей"
"DOTA_HeroRole_Carry"	"Carry"
"DOTA_HeroRole_Support"	"Support"
"DOTA_HeroRole_Nuker"	"Nuker"
"DOTA_HeroRole_Disabler"	"Disabler"
"DOTA_HeroRole_Jungler"	"Jungler"
"DOTA_HeroRole_Durable"	"Durable"
"DOTA_HeroRole_Escape"	"Escape"
"DOTA_HeroRole_LaneSupport"	"Lane Support"
"DOTA_HeroRole_Pusher"	"Pusher"
"DOTA_HeroRole_Initiator"	"Initiator"
"DOTA_HeroRole_Description_Carry"	"Становятся мощными к поздним стадиям игры, если получат значительное преимущество в золоте."
"DOTA_HeroRole_Description_Support"	"Могут не уделять много внимания получению золота и предметов. Помогают команде своими способностями."
"DOTA_HeroRole_Description_Nuker"	"Могут быстро убивать вражеских героев мощными заклинаниями с короткой перезарядкой."
"DOTA_HeroRole_Description_Disabler"	"Выводят врагов из строя хотя бы одним из своих заклинаний."
"DOTA_HeroRole_Description_Jungler"	"Эффективно получают золото и опыт, убивая нейтральных крипов в лесу в ранней стадии игры."
"DOTA_HeroRole_Description_Durable"	"Способны держаться дольше в командных сражениях."
"DOTA_HeroRole_Description_Escape"	"Способны легко избежать смерти."
"DOTA_HeroRole_Description_LaneSupport"	"Могут защищать важных героев на линии в ранней стадии игры, помогая тем зарабатывать золото."
"DOTA_HeroRole_Description_Pusher"	"Могут быстро осаждать и уничтожать башни и казармы на всех стадиях игры."
"DOTA_HeroRole_Description_Initiator"	"Отлично начинают сражения между командами."
"DOTA_HeroGrid_OptionCategory_Role"	"Роли:"
"DOTA_HeroGrid_OptionCategory_Attributes"	"Характеристики:"
"DOTA_HeroGrid_OptionCategory_AttackType"	"Тип атаки:"
"DOTA_HeroLoadout_PreviousHeroName"	"{s:previous_hero_name}"
"DOTA_HeroLoadout_NextHeroName"	"{s:next_hero_name}"
"DOTA_HeroLoadout_CurrentHeroName"	"{s:hero_name}"
"DOTA_HeroLoadout_AttackType"	"{s:hero_attack_type}"
"DOTA_HeroLoadout_HeroFilterName"	"Герой"
"DOTA_HeroLoadout_Search"	"Искать предметы для {s:hero_name}"
"DOTA_HeroCustomize_Title"	"Переодеть героя"
"DOTA_HeroCustomize_OwnedItems"	"Ваши предметы"
"DOTA_HeroCustomize_Slot"	"Слот"
"DOTA_HeroCustomize_SlotName"	"{s:slot_name}"
"DOTA_HeroCustomize_SlotEquippedItemName"	"{s:equipped_item_name}"
"DOTA_HeroCustomize_DefaultItemName"	"Стандартный предмет"
"DOTA_HeroCustomize_PreviewItemName"	"{s:preview_item_name}"
"DOTA_HeroCustomize_PreviewStyle"	"{s:preview_style_name}"
"DOTA_HeroCustomize_PreviewItemSlot"	"{s:preview_item_slot}"
"DOTA_HeroCustomize_Rarity"	"{s:preview_item_rarity}"
"DOTA_HeroCustomize_StyleLocked"	"Требуется надеть"
"DOTA_UIEconItem_StyleIndex"	"{i:style_index}"
"dota_ready_up_num_accepted"	"Готово: {i:num_accepted}/{i:total_players}"
"returning_top_of_queue"	"Возврат к подбору игры с высоким приоритетом…"
"returning_to_lobby"	"Возврат в лобби для поиска игроков…"
"GC_reconnecting"	"Восстановление соединения с сетью Dota 2…"
"GC_nosteam"	"Нет соединения со Steam"
"GC_searching"	"Поиск сети Dota 2…"
"GC_noconnection"	"Отсутствует соединение с сетью Dota 2."
"GC_connecting"	"Подключение к сети Dota 2…"
"GC_connected"	"Соединение с сетью Dota 2 установлено."
"GC_down"	"Сеть Dota 2 в данный момент недоступна."
"GC_Network_Full"	"На данный момент сеть Dota 2 заполнена."
"GC_Queue_Position"	"Система поиска игр заполнена. Позиция в очереди: {i:gc_queue_position}"
"GC_Queue_Wait_Time"	"Система поиска игр заполнена. Позиция в очереди: {i:gc_queue_position}, приблизительное время ожидания: {s:gc_queue_wait_time}"
"GC_Wait_Time"	"Среднее время ожидания: %s1"
"GC_Wait_Time_Unknown"	"Неизвестно"
"GC_suspended"	"Аккаунт заблокирован, так как система Valve Anti-Cheat зафиксировала сторонние программы, используемые вместе с игрой."
"dota_practice_vs_bots"	"Тренировка с ботами"
"dota_practice_vs_bots_desc"	"Тренировка против ботов. Она не использует подбор игр, и вы сможете покинуть ее в любое время."
"dota_practice_vs_bots_difficulty"	"Уровень сложности ботов"
"dota_practice_vs_bots_team"	"За кого вы хотите играть?"
"DOTA_practice_vs_bots_team_radiant"	"Свет"
"DOTA_practice_vs_bots_team_dire"	"Тьма"
"DOTA_practice_vs_bots_team_random"	"Случайно"
"DOTA_EmoticonUpsell"	"Смайлики можно получить за покупку некоторых предметов или билетов на турниры."
"DOTA_CurrentTime"	"{t:t:current_time}"
"DOTA_MonthlyPlayers"	"{s:users_last_month}"
"DOTA_MonthlyPlayersLabel"	"Уникальных игроков за последний месяц"
"DOTA_CurrentPlayers"	"{s:current_users}"
"DOTA_CurrentPlayersLabel"	"В игре"
"DOTA_Search_NoResults"	"Нет результатов"
"DOTA_Search_ItemShortDescription"	"{s:item_slot}, <span class=\"ItemRarityColor\">{s:item_rarity}</span>"
"join_error_already_in_game"	"Невозможно присоединиться к закрытому лобби, так как вы уже в игре."
"join_error_invalid_lobby"	"Указанное лобби больше не существует."
"join_error_incorrect_password"	"Неверный пароль."
"join_error_access_denied"	"Доступ закрыт."
"join_error_generic"	"
"
"join_error_in_team_party"	"Невозможно войти в тренировочное лобби. Чтобы сделать это, распустите группу вашей команды."
"join_error_lobby_full"	"Лобби заполнено."
"join_error_timed_out"	"Время запроса истекло."
"DOTA_Friends_Ready_To_Play"	"Открытые игры"
"DOTA_Friend_Finding_Match"	"Поиск игры…"
"DOTA_Friend_In_Match"	"В игре"
"DOTA_Friend_Solo_Open_Party"	"{s:player_name} хочет играть"
"DOTA_Friend_In_Party_Open"	"{s:player_name} в открытой группе"
"DOTA_Friend_Solo_Open_Party_Self"	"Вы ищете игроков"
"DOTA_Friend_In_Open_Party_Self"	"Вы в открытой группе"
"DOTA_Friends_In_Party_Open"	"Друзей в открытых группах: {d:num_friends}"
"DOTA_Friend_Lobby_Mode_Self"	"Вы в лобби {s:game_mode}"
"DOTA_Friend_Lobby_Mode_1_Friend"	"{s:player_name} в лобби {s:game_mode}"
"DOTA_Friend_Lobby_Mode_N_Friends"	"Друзей в лобби {s:game_mode}: {d:num_friends}"
"DOTA_Friend_Lobby_Mode_Small"	"Лобби {s:game_mode}"
"DOTA_Friend_Lobby_Players"	"{d:player_count} / {d:max_player_count}"
"DOTA_Friend_Lobby_Join_Button"	"{s:join_button_text}"
"DOTA_Friend_Lobby_Friend_Count"	"+{d:extra_friend_count}"
"DOTA_Friend_Invite_To_Party"	"Пригласить в группу"
"DOTA_Friend_SuggestInviteToParty"	"Предложить пригласить"
"DOTA_Request_Join_Party"	"Попросить пригласить"
"DOTA_Request_Merge_Parties"	"Предложить объединить группы"
"DOTA_Request_Merge_Parties_NotLeader"	"Лидер группы может попросить объединить группы."
"DOTA_Friend_PartyInvitePending"	"Приглашение отправлено"
"DOTA_Friend_PartyInvitePending_Leader"	"Приглашение отправлено<br/>Нажмите, чтобы отменить"
"DOTA_Friend_PartyMergeRequestPending"	"Предложение объединить группы отправлено"
"DOTA_Friend_PartyMergeRequestPending_Leader"	"Предложение объединить группы отправлено<br/>Нажмите, чтобы отменить"
"DOTA_Friend_JoinParty"	"Присоединиться к группе"
"DOTA_Friend_Watch"	"Смотреть"
"DOTA_PartyVisTooltip_SoloTitleOpen"	"Хочет играть"
"DOTA_PartyMerge_Error_Title"	"Не удалось присоединиться к группе / объединить группы"
"DOTA_PartyMerge_Error_NOT_LEADER"	"Только лидер может управлять группой"
"DOTA_PartyMerge_Error_TOO_MANY_PLAYERS"	"Невозможно объединить группы, так как игроков слишком много."
"DOTA_PartyMerge_Error_TOO_MANY_COACHES"	"Невозможно объединить группы, так как тренеров слишком много."
"DOTA_PartyMerge_Error_ENGINE_MISMATCH"	"Невозможно объединить группы, так как они находятся в разных версиях игры"
"DOTA_PartyMerge_Error_NO_SUCH_GROUP"	"Группа больше не существует."
"DOTA_PartyMerge_Error_OTHER_GROUP_NOT_OPEN"	"В эту группу нельзя вступать и с ней нельзя объединяться."
"DOTA_Feed_Timestamp_Recently"	"Только что"
"DOTA_Feed_Timestamp_MinutesAgo"	"{i:value} мин. назад"
"DOTA_Feed_Timestamp_HourAgo"	"{i:value} час назад"
"DOTA_Feed_Timestamp_HoursAgo"	"{i:value} ч. назад"
"DOTA_Feed_Timestamp_Yesterday"	"Вчера"
"DOTA_Feed_Timestamp_Date"	"{s:day} {s:month}"
"dota_lobby_type_general"	"Нерейтинговая"
"dota_lobby_type_practice"	"Тренировочная"
"dota_lobby_type_practice_game_mode_custom"	"Пользовательская"
"dota_lobby_type_tournament"	"Турнирная"
"dota_lobby_type_coop_bot"	"Против ботов"
"dota_lobby_type_competitive"	"Рейтинговая"
"dota_lobby_type_casual_1v1"	"1 на 1"
"dota_lobby_unknown"	"Неизвестно"
"DOTA_Lobby_No_Players_Title"	"В КОМАНДЕ НЕТ ИГРОКОВ"
"DOTA_Lobby_No_Players_Desc"	"В команде сил Света или сил Тьмы должен быть хотя бы один игрок."
"dota_match_result_won"	"Победа"
"dota_match_result_lost"	"Поражение"
"dota_match_result_none"	"???"
"dota_social_feed_loading"	"Загрузка…"
"DOTA_LoadingPlayerUnknown"	"-"
"DOTA_LoadingPlayerLoading"	"Загрузка…"
"DOTA_LoadingPlayerFullyConnected"	"Готов"
"DOTA_LoadingPlayerFailed"	"Неудачно"
"LoadingScreenTimer"	"{t:d:countdown_timer_seconds}"
"HeroSelectionTimer"	"{i:timer_seconds}"
"LoadingScreenMapInfo"	"Карта: {s:map_name}"
"LoadingScreenPlayersInfo"	"Игроков: {i:players_loaded}/{i:players_total}"
"LoadingScreenSpectatorsInfo"	"Наблюдателей: {i:spectators_loaded}/{i:spectators_total}"
"custom_end_screen_victory_message"	"{s:winning_team_name} побеждают!"
"custom_end_screen_legend_player"	"Игрок"
"custom_end_screen_legend_level"	"Уровень"
"custom_end_screen_legend_hero"	"Герой"
"custom_end_screen_legend_kills"	"У"
"custom_end_screen_legend_deaths"	"С"
"custom_end_screen_legend_assists"	"П"
"custom_end_screen_legend_items"	"Предметы"
"custom_end_screen_legend_gold"	"Золото"
"custom_end_screen_legend_team_score"	"Счет"
"custom_scoreboard_hero_name_and_desc"	"{s:hero_name} {i:hero_level}-го ур."
"CustomEndScreenClose"	"Закрыть"
"DOTA_Armory_Category_Heroes"	"Герои"
"DOTA_Armory_Category_Companions"	"Компаньоны"
"DOTA_Armory_Category_Couriers"	"Курьеры"
"DOTA_Armory_Category_Pets"	"Питомцы"
"DOTA_Armory_Category_World"	"Окружение"
"DOTA_Armory_Category_Wards"	"Варды"
"DOTA_Armory_Category_Weather"	"Погодные эффекты"
"DOTA_Armory_Category_Effigies"	"Статуи"
"DOTA_Armory_Category_Interface"	"Интерфейс"
"DOTA_Armory_Category_Emoticons"	"Смайлики"
"DOTA_Armory_Category_LoadingScreens"	"Загрузочные экраны"
"DOTA_Armory_Category_HUDs"	"Стили интерфейса"
"DOTA_Armory_Category_CursorPacks"	"Наборы курсоров"
"DOTA_Armory_Category_Audio"	"Звук"
"DOTA_Armory_Category_VoicePacks"	"Озвучка"
"DOTA_Armory_Category_AnnouncerPacks"	"Комментаторы"
"DOTA_Armory_Category_Music"	"Музыка"
"DOTA_Armory_Category_All"	"Все"
"DOTA_Armory_Category_Other"	"Другое"
"DOTA_Armory_Category_View"	"По категориям"
"DOTA_Armory_Filter"	"Настроить фильтр"
"DOTA_Armory_SortBy"	"Сортировка:"
"DOTA_Armory_SortBy_Rarity"	"по редкости"
"DOTA_Armory_SortBy_Quality"	"по качеству"
"DOTA_Armory_SortBy_Name"	"по названию"
"DOTA_Armory_SortBy_Recent"	"по дате получения"
"DOTA_Armory_SortBy_Sockets"	"по количеству гнезд"
"DOTA_Armory_Search"	"Найти предметы в арсенале"
"DOTA_Armory_ContextMenu_Preview"	"Предпросмотр предмета"
"DOTA_Armory_ContextMenu_PreviewSet"	"Предпросмотр набора"
"DOTA_Armory_ContextMenu_Equip"	"Надеть"
"DOTA_Armory_ContextMenu_Unequip"	"Снять"
"DOTA_Armory_ContextMenu_Socketing"	"Самоцветы"
"DOTA_Armory_ContextMenu_GiftWrap"	"Завернуть в подарок"
"DOTA_Armory_ContextMenu_Delete"	"Удалить"
"dota_page_match_details_loading"	"Загрузка игры…"
"dota_page_match_details_victory"	"Победитель: {s:winner}"
"dota_page_match_details_legend_player"	"Игрок"
"dota_page_match_details_legend_level"	"Ур."
"dota_page_match_details_legend_hero"	"Герой"
"dota_page_match_details_legend_kills"	"У"
"dota_page_match_details_legend_deaths"	"С"
"dota_page_match_details_legend_assists"	"П"
"dota_page_match_details_legend_items"	"Предметы"
"dota_page_match_details_legend_gold"	"Зол."
"dota_page_match_details_legend_last_hits"	"ПУ"
"dota_page_match_details_legend_denies"	"НО"
"dota_page_match_details_legend_gold_per_min"	"З/М"
"dota_page_match_details_legend_xp_per_min"	"О/М"
"dota_page_match_details_legend_winner_tooltip"	"Победившая команда"
"dota_page_match_details_legend_kills_tooltip"	"Убийств"
"dota_page_match_details_legend_deaths_tooltip"	"Смертей"
"dota_page_match_details_legend_assists_tooltip"	"Помощи"
"dota_page_match_details_legend_last_hits_tooltip"	"Добито крипов"
"dota_page_match_details_legend_denies_tooltip"	"Не отдано крипов"
"dota_page_match_details_legend_gold_per_min_tooltip"	"Золота в минуту"
"dota_page_match_details_legend_xp_per_min_tooltip"	"Опыта в минуту"
"dota_page_match_details_header_league_name"	"Название турнира"
"dota_page_match_details_header_custom_game_map_name"	"Карта"
"dota_page_match_details_header_match_id"	"№ матча"
"dota_page_match_details_header_game_mode"	"Режим игры"
"dota_page_match_details_header_duration"	"Длительность"
"dota_page_match_details_header_timestamp"	"Дата и время игры"
"dota_page_match_details_voting_votes"	"Голосов: {i:num_votes}"
"dota_page_match_details_match_discussion"	"Обсуждение матча"
"dota_page_match_details_comment_placeholder"	"Написать комментарий…"
"dota_page_match_details_comment_loading_comments"	"Загрузка комментариев…"
"dota_page_match_details_comment_no_comments"	"Нет комментариев к этому матчу"
"dota_page_match_details_replay_existence_unknown"	"Поиск записи…"
"dota_page_match_details_replay_existence_cdn_found"	"Загрузить запись"
"dota_page_match_details_replay_existence_not_found"	"Запись недоступна"
"dota_page_match_details_replay_existence_downloading"	"Загрузка…"
"dota_page_match_details_replay_existence_disk_found_replay"	"Смотреть запись"
"dota_page_match_details_replay_existence_disk_found_highlights"	"Лучшие моменты"
"dota_page_match_details_replay_existence_wrong_engine"	"Записи на Source 1 недоступны в версии на Source 2"
"dota_profile_content_tab_activity_feed"	"История"
"dota_profile_content_tab_recent_games"	"Игры"
"dota_profile_recent_games_option_show_practice_matches"	"Отображать мои тренировочные игры"
"dota_profile_recent_game_header_timestamp"	"Дата и время"
"dota_profile_recent_game_header_hero_name"	"Герой"
"dota_profile_recent_game_header_result"	"Результат"
"dota_profile_recent_game_header_duration"	"Время"
"dota_profile_recent_game_header_type"	"Вид игры"
"dota_profile_recent_game_result_win"	"Победа"
"dota_profile_recent_game_result_loss"	"Поражение"
"dota_profile_recent_game_result_abandon"	"Покинута"
"dota_profile_recent_game_icon_source1"	"S1"
"dota_profile_hero_with_index"	"{d:hero_index} {s:hero_name}"
"dota_profile_hero"	"{s:hero_name}"
"dota_replay_manager_error_not_found"	"Не удалось найти запись в CDN."
"dota_replay_manager_error_existing_partial"	"Не удалось удалить существующий файл с частичной записью."
"dota_replay_manager_error_creation_failure"	"Не удалось создать файл с частичной записью."
"dota_replay_manager_error_disk_full"	"Не удалось выделить место для файла записи."
"dota_replay_manager_error_chunk_failed"	"Не удалось загрузить файл записи."
"dota_replay_manager_error_write_failure"	"Не удалось осуществить запись в файл частичной записи."
"dota_replay_manager_error_partial_compressed_open_failure"	"Не удалось открыть сжатый файл записи."
"dota_replay_manager_error_partial_decompressed_open_failure"	"Не удалось открыть файл повтора."
"dota_replay_manager_error_partial_decompression_failure"	"Не удалось распаковать файл повтора."
"dota_replay_manager_error_partial_decompression_write_failure"	"Не удалось записать файл повтора."
"dota_page_match_details_replay_error_not_found"	"Запись не найдена на диске."
"DOTA_tooltip_econ_item_name"	"{s:item_name}"
"DOTA_tooltip_econ_item_description"	"{s:item_description}"
"DOTA_tooltip_econ_item_set"	"Входит в набор: <font color='#dddddd'>{s:item_set}</font>"
"DOTA_tooltip_econ_item_rarity_label"	"Редкость: "
"DOTA_tooltip_econ_item_rarity"	"{s:item_rarity}"
"DOTA_tooltip_econ_item_slot"	"Слот: {s:item_slot}"
"DOTA_tooltip_econ_item_gifter"	"{g:dota_persona:gifter_name}"
"DOTA_tooltip_econ_item_gift_received_date"	"Получено: {t:T:gift_received_date_time}"
"DOTA_tooltip_econ_item_trade_restriction_permanent"	"Нельзя передавать"
"DOTA_tooltip_econ_item_trade_restriction_date"	"Нельзя передавать до: {t:T:tradable_after_date_time} {t:s:tradable_after_date_time}"
"DOTA_tooltip_econ_item_market_restriction_permanent"	"Нельзя продавать"
"DOTA_tooltip_econ_item_gift_restriction_permanent"	"Нельзя дарить"
"DOTA_tooltip_econ_item_gift_restriction_date"	"Нельзя дарить до: {t:T:giftable_after_date_time} {t:s:giftable_after_date_time}"
"DOTA_tooltip_econ_item_gem_type"	"{s:gem_type}"
"DOTA_tooltip_econ_item_gem_strange_count"	"{d:strange_count}"
"DOTA_tooltip_econ_item_gem_description"	"{s:gem_description}"
"DOTA_tooltip_econ_item_partner"	"{s:partner}"
"DOTA_econ_item_details_item_name"	"{s:item_name}"
"DOTA_econ_item_details_item_creation_date"	"ДАТА СОЗДАНИЯ: {t:l:creation_date}"
"DOTA_econ_item_details_set_includes"	"Содержит:"
"DOTA_econ_item_details_item_set"	"Часть: <font color='#dddddd'>{s:item_set}</font>"
"DOTA_econ_item_details_rarity_label"	"Редкость: "
"DOTA_econ_item_details_item_rarity"	"{s:item_rarity}"
"DOTA_econ_item_details_item_slot"	"Слот: {s:item_slot}"
"DOTA_econ_item_details_item_description"	"{s:item_description}"
"DOTA_econ_item_details_gem_type"	"{s:gem_type}"
"DOTA_econ_item_details_gem_strange_count"	"{d:strange_count}"
"DOTA_econ_item_details_gem_description"	"{s:gem_description}"
"DOTA_Treasure_Name"	"{s:treasure_name}"
"DOTA_Treasure_Rarity"	"Сокровищница (<span class=\"ItemRarityColor\">{s:treasure_rarity}</span>)"
"DOTA_Voice_Party"	"Голосовой чат в группе"
"custom_game_mismatch_title"	"Несоответствие данных пользовательской игры"
"custom_game_mismatch_desc"	"Архив пользовательской игры на сервере не совпадает с версией в клиенте."
"custom_game_team_select"	"Выбор команды"
"custom_game_team_select_timer"	"{i:countdown_timer_seconds}"
"custom_game_team_select_shuffle"	"Перемешать"
"custom_game_team_select_auto_start"	"До начала"
"custom_game_team_select_starting"	"Начало"
"custom_game_team_select_unassigned_players"	"Неопределившиеся"
"custom_game_team_select_lock_start"	"Начать игру"
"custom_game_team_select_cancel_unlock"	"Отмена"
"custom_game_team_select_join"	"Присоединиться"
"custom_game_team_select_empty_slot"	"Пустой слот"
"custom_game_team_select_auto_assign"	"Распределить автоматически"
"custom_game_default_gameinfo_text"	"Возвращайтесь, чтобы узнать об этой пользовательской игре больше!"
"CouldntFindCompendium"	"Не удалось загрузить тестовый файл компендиума: %s1"
"CompendiumPageError_Pages"	"Не удалось найти блок страниц в файле данных компендиума."
"CompendiumPageError_Template"	"Не удалось найти атрибут «template» для страницы компендиума «{s:s1}» (номер {s:s2})"
"CompendiumPageError_Image"	"Не удалось найти изображение «{s:s1}» на странице компендиума «{s:s2}»"
"CompendiumPageError_Unknown"	"В компендиуме обнаружена логическая ошибка. Для решения этой проблемы свяжитесь с Valve."
"CompendiumError_FailedPanoramaGen"	"Не удалось создать расположение панорамы для страницы «{s:s1}»."
"CompendiumError_FailedXMLWrite"	"Не удалось записать XML страницы «{s:s1}» в файл «{s:s2}»."
"CompendiumError_FailedCSSWrite"	"Не удалось записать CSS страницы «{s:s1}» в файл «{s:s2}»."
"DOTA_GlobalItems_Companions"	"Компаньоны"
"DOTA_GlobalItems_Couriers"	"Курьеры"
"DOTA_GlobalItems_Pets"	"Питомцы"
"DOTA_GlobalItems_Wards"	"Варды"
"DOTA_GlobalItems_Effigies"	"Статуи"
"DOTA_GlobalItems_Weather"	"Погодные эффекты"
"DOTA_GlobalItems_Interface"	"Интерфейс"
"DOTA_GlobalItems_Emoticons"	"Смайлики"
"DOTA_GlobalItems_LoadingScreens"	"Загрузочные экраны"
"DOTA_GlobalItems_HUDs"	"Стили интерфейса"
"DOTA_GlobalItems_Audio"	"Звук"
"DOTA_GlobalItems_Announcers"	"Наборы комментаторов"
"DOTA_GlobalItems_Music"	"Музыка"
"DOTA_Search"	"Поиск"
"DOTA_Start"	"Начать"
"DOTA_PleaseWait"	"Подождите…"
"DOTA_ProfileCard_HeroHover"	"При наведении:"
"DOTA_ChallengeGroup_2_Desc"	"Потренируйтесь в игре с героями под управлением компьютера в спокойной обстановке."
"DOTA_ChatTab_ToggleSounds"	"Оповещать звуком о новых сообщениях в этом канале."
"dota_lobby_balanced_shuffle"	"Сбалансировать"
"dota_lobby_swap_teams"	"Поменять местами"
"dota_lobby_unassigned_players"	"Неопределившиеся"
"dota_lobby_broadcast_channels"	"Каналы трансляции"
"dota_lobby_settings"	"Настройки лобби"
"dota_lobby_settings_edit"	"Изменить"
"dota_lobby_leave"	"Покинуть лобби"
"DOTA_Custom_Game_View_Lobby_List"	"Список лобби"
"DOTA_Custom_Game_Lobby_List_Title"	"Список лобби"
"DOTA_Custom_Game_Browse_All"	"Все игры"
"DOTA_Custom_Game_Friends_Ready"	"Готовые сыграть"
"DOTA_Custom_Game_Friends_Who_Play"	"Играли ранее"
"DOTA_Custom_Game_Friends_Playing_Now"	"Играют прямо сейчас"
"DOTA_Custom_Game_Browse_Sort"	"Сортировать по:"
"DOTA_Custom_Game_Sort_Popular_Today"	"Оценкам (за сегодня)"
"DOTA_Custom_Game_Sort_Popular_Week"	"Оценкам (за неделю)"
"DOTA_Custom_Game_Sort_Top_Rated"	"Оценкам (за все время)"
"DOTA_Custom_Game_Sort_Date"	"Дате публикации"
"DOTA_WatchLive_WatchLabel"	"СМОТРЕТЬ:"
"DOTA_WatchLive_ThirdParty"	"НА СТОРОННЕМ САЙТЕ"
"DOTA_WatchLive_Steam"	"STEAM"
"DOTA_WatchLive_InGame"	"В ИГРЕ"
"DOTA_WatchLive_Broadcaster0"	"Смотреть {g:dota_persona:b:broadcaster_account_id_0}"
"DOTA_WatchLive_Broadcaster1"	"Смотреть {g:dota_persona:b:broadcaster_account_id_1}"
"DOTA_WatchLive_Broadcaster2"	"Смотреть {g:dota_persona:b:broadcaster_account_id_2}"
"DOTA_WatchLive_Broadcaster3"	"Смотреть {g:dota_persona:b:broadcaster_account_id_3}"
"DOTA_WatchLive_Broadcaster4"	"Смотреть {g:dota_persona:b:broadcaster_account_id_4}"
"DOTA_WatchLive_Broadcaster5"	"Смотреть {g:dota_persona:b:broadcaster_account_id_5}"
"DOTA_WatchLive_Broadcaster6"	"Смотреть {g:dota_persona:b:broadcaster_account_id_6}"
"DOTA_WatchLive_Broadcaster7"	"Смотреть {g:dota_persona:b:broadcaster_account_id_7}"
"DOTA_WatchLive_Broadcaster8"	"Смотреть {g:dota_persona:b:broadcaster_account_id_8}"
"DOTA_WatchLive_Broadcaster9"	"Смотреть {g:dota_persona:b:broadcaster_account_id_9}"
"dota_matchmaking_region_title_confirm"	"Выберите регионы подбора игр"
"dota_play_lobby_games"	"Список лобби"
"dota_play_host_loading"	"Загрузка хоста…"
"dota_play_connecting_to_server"	"Подключение…"
"dota_reconnecting"	"Переподключение…"
"dota_matchmaking_regions_retry"	"Попробуйте еще раз"
"dota_matchmaking_region_ping_calculating"	"Задержка: Вычисление…"
"dota_matchmaking_region_ping_failed"	"Задержка: ОШИБКА"
"dota_matchmaking_region_or"	"или"
"dota_matchmaking_region_selected_offline"	"Часть выбранных регионов временно вне сети."
"dota_matchmaking_region_selected_unreachable"	"Не удалось установить соединение с выбранными регионами."
"dota_matchmaking_region_all_unavailable"	"Не удалось вычислить задержку. Проверьте интернет-соединение."
"dota_matchmaking_region_check_internet"	"Проверьте интернет-соединение."
"dota_matchmaking_region_poor_choices"	"Соединение с серверами в выбранных регионах может оказаться медленным."
"dota_settings_hide_party_unless_open"	"Скрывать статус моей группы, если она не открытая"
"dota_settings_open_party_manual_accept_invites"	"Не принимать приглашения автоматически в открытой группе"
"dota_settings_networkhud"	"Отображать информацию о сети"
"dota_settings_fullscreenbrightness"	"Яркость"
"dota_settings_dashboard_renderquality"	"Эффекты в главном меню"
"dota_settings_lowlatency_audio"	"Автонастройка задержки звука"
"dota_settings_quicktargetattack"	"Быстрая атака"
"dota_settings_chat_whispers"	"Показывать сообщения Steam во внутриигровом чате"
"dota_settings_no_mode_resolutions"	"Нет поддерживаемых разрешений"
"DOTA_Settings_Tooltip_QuickTargetAttack"	"Нажатие кнопки атаки даст команду атаковать в месте расположения курсора."
"dota_lobby_browser_header_name"	"Название лобби"
"dota_lobby_browser_header_slots"	"Мест"
"dota_lobby_browser_header_game_mode"	"Режим игры"
"dota_lobby_browser_region"	"Регион"
"dota_lobby_browser_lobby_name"	"Название лобби"
"DOTA_Friend_Game_Mode_Self"	"Ваш режим игры: {s:game_mode}"
"DOTA_Friend_Game_Mode_1_Friend"	"{s:player_name} играет в режиме {s:game_mode}"
"DOTA_Friend_Game_Mode_N_Friends"	"{d:num_friends} друзей играют в режиме {s:game_mode}"
"custom_game_lobby_mismatch"	"Архив пользовательской игры не совпадает с версией лидера лобби."
"Compendium_DefaultText_TimerTitle_Active"	"ОСТАЛОСЬ"
"Compendium_DefaultText_TimerTitle_Expired"	"ГОЛОСОВАНИЕ ОКОНЧЕНО"
"Compendium_DefaultText_CD_Days"	"д."
"Compendium_DefaultText_CD_Hours"	"ч."
"Compendium_DefaultText_CD_Minutes"	"мин."
"Compendium_DefaultText_CD_Seconds"	"сек."
"NetGraph_FPS"	"FPS: {d:fps}"
"NetGraph_Ping"	"Задержка: {d:ping} мс"
"NetGraph_Loss"	"Потери: {d:loss}%"
"DOTA_Credits"	"Благодарности"
"DOTA_ActorCredits_1_Name"	"Ди Бредли Бейкер"
"DOTA_ActorCredits_1_Heroes"	"techies"
"DOTA_ActorCredits_2_Name"	"Деннис Бэйтман"
"DOTA_ActorCredits_2_Heroes"	"invoker"
"DOTA_ActorCredits_3_Name"	"Том Чентлер"
"DOTA_ActorCredits_3_Heroes"	"centaur,lion,obsidian_destroyer,riki,slark,tusk,witch_doctor"
"DOTA_ActorCredits_4_Name"	"Мерл Дэндридж"
"DOTA_ActorCredits_4_Heroes"	"legion_commander,winter_wyvern"
"DOTA_ActorCredits_5_Name"	"Барри Дэннен"
"DOTA_ActorCredits_5_Heroes"	"chaos_knight,phantom_lancer,rubick"
"DOTA_ActorCredits_6_Name"	"Дэйв Фенной"
"DOTA_ActorCredits_6_Heroes"	"batrider,ember_spirit,faceless_void,jakiro,venomancer,skeleton_king"
"DOTA_ActorCredits_7_Name"	"Джим Френч"
"DOTA_ActorCredits_7_Heroes"	"elder_titan"
"DOTA_ActorCredits_8_Name"	"Майкл Грегори"
"DOTA_ActorCredits_8_Heroes"	"bounty_hunter,clinkz,silencer"
"DOTA_ActorCredits_9_Name"	"Джин Хеммонд"
"DOTA_ActorCredits_9_Heroes"	"crystal_maiden,drow_ranger,enchantress,mirana,phantom_assassin,spectre,vengefulspirit"
"DOTA_ActorCredits_10_Name"	"Джон Патрик Лоури"
"DOTA_ActorCredits_10_Heroes"	"ancient_apparition,dark_seer,doom_bringer,earthshaker,pudge,nevermore,storm_spirit"
"DOTA_ActorCredits_11_Name"	"Эллен Маклейн"
"DOTA_ActorCredits_11_Heroes"	"broodmother,death_prophet"
"DOTA_ActorCredits_12_Name"	"Брюс Майлз"
"DOTA_ActorCredits_12_Heroes"	"alchemist,life_stealer,omniknight"
"DOTA_ActorCredits_13_Name"	"Линда К. Моррис"
"DOTA_ActorCredits_13_Heroes"	"luna,naga_siren,queenofpain,templar_assassin"
"DOTA_ActorCredits_13_Extra"	"Комментатор"
"DOTA_ActorCredits_14_Name"	"Сэм А. Моури"
"DOTA_ActorCredits_14_Heroes"	"antimage,beastmaster,rattletrap,necrolyte,slardar,warlock"
"DOTA_ActorCredits_14_Extra"	"Торговец из Потайной лавки"
"DOTA_ActorCredits_15_Name"	"Эрик Ньюсом"
"DOTA_ActorCredits_15_Heroes"	"chen,leshrac,furion,razor,tidehunter,tiny,zuus"
"DOTA_ActorCredits_16_Name"	"Нолан Норт"
"DOTA_ActorCredits_16_Heroes"	"brewmaster,earth_spirit,gyrocopter,keeper_of_the_light,lone_druid,lycan,meepo,ogre_magi,shadow_demon,troll_warlord"
"DOTA_ActorCredits_17_Name"	"Демпси Паппион"
"DOTA_ActorCredits_17_Heroes"	"magnataur,nyx_assassin,visage"
"DOTA_ActorCredits_18_Name"	"Тиджей Рамини"
"DOTA_ActorCredits_18_Heroes"	"abaddon,bristleback,skywrath_mage,shredder"
"DOTA_ActorCredits_19_Name"	"Гарри С. Робинс"
"DOTA_ActorCredits_19_Heroes"	"tinker"
"DOTA_ActorCredits_20_Name"	"Гэри Шварц"
"DOTA_ActorCredits_20_Heroes"	"lich,pugna"
"DOTA_ActorCredits_21_Name"	"Дэвид Скалли"
"DOTA_ActorCredits_21_Heroes"	"bane,dazzle,juggernaut,morphling,sand_king,sven,weaver"
"DOTA_ActorCredits_22_Name"	"Майк Шапиро"
"DOTA_ActorCredits_22_Heroes"	"oracle"
"DOTA_ActorCredits_23_Name"	"Дэвид Соболев"
"DOTA_ActorCredits_23_Heroes"	"terrorblade"
"DOTA_ActorCredits_24_Name"	"Джон Сент-Джон"
"DOTA_ActorCredits_24_Heroes"	"axe,bloodseeker,enigma,kunkka"
"DOTA_ActorCredits_25_Name"	"Фред Таташоре"
"DOTA_ActorCredits_25_Heroes"	"disruptor,spirit_breaker,treant,undying,ursa"
"DOTA_ActorCredits_25_Extra"	"Голем Warlock"
"DOTA_ActorCredits_26_Name"	"Джен Тейлор"
"DOTA_ActorCredits_26_Heroes"	"lina,medusa,puck,windrunner"
"DOTA_ActorCredits_27_Name"	"Тони Тодд"
"DOTA_ActorCredits_27_Heroes"	"dragon_knight,night_stalker,viper"
"DOTA_ActorCredits_28_Name"	"
"
"DOTA_ActorCredits_28_Heroes"	"
"
"DOTA_PlayerContextMenu_Trade"	"Предложить обмен"
"DOTA_Custom_Game_Finished_Vote_Title"	"Голосование за пользовательскую игру"
"DOTA_Custom_Game_Finished_Vote_Question"	"Что вы думаете об этой пользовательской игре?"
"DOTA_Custom_Game_Finished_Vote_Skip"	"Пропустить"
"DOTA_TabName_ModsLobbyList"	"Список лобби"
"DOTA_WatchLive_Fullscreen"	"НА ВЕСЬ ЭКРАН"
"DOTA_JoinChatChannel_ChannelName"	"Название канала"
"DOTA_JoinChatChannel_ChannelMemberCount"	"Участники"
"DOTA_Chat_ChannelMemberCount"	"{d:channel_member_count}"
"dota_settings_coop_fullscreen"	"Полный экран с доступом к рабочему столу"
"DOTA_Trading_UI_Body_Outgoing"	"Ожидание ответа от {s:player_name}…"
"DOTA_GiftWrap_Item"	"{g:dota_item_name:gift_item_def} заворачивается в подарок."
"DOTA_GiftWrap_ConfirmDedication_Title"	"Подтвердить подпись"
"DOTA_GiftWrap_ConfirmDedication_Message"	"Вы уверены, что хотите оставить на подарке следующую подпись: «{s:gift_dedication}»?"
"DOTA_GiftWrap_Success_Header"	"Готово"
"DOTA_GiftWrap_Success"	"Ваш подарок доставлен."
"DOTA_GiftWrap_Error_RateLimitedCharge"	"Невозможно отправить подарок, так как ваш уровень боевых баллов не позволяет отправлять более {d:gift_limit_count} подарков за {d:gift_limit_hours} ч."
"DOTA_GiftWrap_Error_RateLimitedChargeNone"	"Невозможно отправить подарок, так как ваш уровень боевых баллов не позволяет дарить не поддающиеся обмену предметы."
"DOTA_Custom_Game_Sort_Most_Played"	"Популярности (за неделю)"
"dota_settings_about"	"Об игре"
"dota_settings_fullscreen_focus_behavior"	"Сворачивает игру при переходе в другое окно"
"DOTA_EquippedItem_AddToShuffle"	"Добавить в случайное"
"DOTA_EquippedItem_RemoveFromShuffle"	"Удалить из случайного"
"DOTA_EquippedItem_Unpack_And_AddToShuffle"	"Открыть и добавить в случайное"
"DOTA_ClientVersion"	"Сборка: <span class=\"VersionNumber\">{d:client_version_number}</span>"
"DOTA_GameplayVersion"	"Версия: <span class=\"VersionNumber\">{s:gameplay_version_number}</span>"
"DOTA_CurrentGameplayVersion"	"6.84c"
"DOTA_Credits_LindaKMorris_Extra"	"Комментатор"
"DOTA_Credits_SamAMowry_Extra"	"Торговец из Потайной лавки"
"DOTA_Credits_FredTatasciore_Extra"	"Голем Warlock"
"DOTA_Recycling"	"Переработка"
"DOTA_Recycling_Action"	"Переработать"
"DOTA_Recycling_DragItems"	"Перетащите сюда ненужные предметы"
"DOTA_Recycling_Outputs"	"Результат"
"DOTA_Recycling_Confirm"	"Вы действительно хотите переработать эти предметы?"
"DOTA_RecyclingCharm_Name"	"Charm of the Crucible Jewel II"
"DOTA_RecyclingCharm_Bonus"	"и 25 монет компендиума"
"custom_game_file_error"	"Ошибка доступа к файлам пользовательской игры."
"DOTA_Previous"	"Пред."
"DOTA_PreviousShort"	"Пред."
"DOTA_Next"	"След."
"DOTA_Friends_Add_Friend_Tooltip"	"Добавить в друзья"
"DOTA_Friends_Add_Friend_Entry_Placeholder"	"Поиск по ID друга"
"DOTA_Friends_Add_Friend_Your_ID"	"Ваш ID:"
"dota_settings_voice_always_sample_mic"	"Упрощенная активация микрофона нажатием"
"dota_settings_voice_always_sample_mic_tooltip"	"Не выключает устройство записи, решая проблему с производительностью на некоторых устройствах."
"DOTA_EconItemSet_Tooltip_MultipleTeams"	"Разные стили для сил Света и Тьмы"
"DOTA_HeroLoadout_Shuffle_Count"	"Предметов в случайном: ({i:loadout_items_in_shuffle})"
"DOTA_HeroLoadout_Add_All_To_Shuffle"	"Добавить всё в случайное"
"DOTA_HeroLoadout_Clear_Shuffle"	"Очистить"
"DOTA_Armory_ActiveFilter"	"{s:filter_field} {s:filter_op} {s:filter_value}"
"DOTA_Treasure_Purchase"	"Купить"
"DOTA_Treasure_CharmPurchase"	"Купить амулет"
"DOTA_Treasure_SearchPlaceholder"	"Поиск по сокровищницам"
"DOTA_Treasure_ViewAll"	"Все сокровищницы"
"DOTA_Treasure_QuantityOption"	"Кол.: {d:quantity}"
"DOTA_Treasure_Gift"	"Подарить"
"DOTA_Treasure_Open"	"Открыть"
"DOTA_Treasure_OpenQuantity"	"{d:owned_quantity}"
"DOTA_Treasure_Owned"	"Шт."
"DOTA_Treasure_Received"	"Получено"
"DOTA_Treasure_Autographed"	"Автограф:"
"DOTA_Treasure_AutographName"	"{s:treasure_autograph_name}"
"DOTA_OpenTreasureTooltip_NormalTitle"	"Содержит следующие предметы:"
"DOTA_OpenTreasureTooltip_NoDupeDescription"	"Открыв сокровищницу, вы получите {d:items_per_treasure} из предметов в сокровищнице. Предметы не будут повторяться, пока не выпадет каждый из списка."
"DOTA_OpenTreasureTooltip_DupeDescription"	"Открыв сокровищницу, вы получите {d:items_per_treasure} из предметов в сокровищнице. Предметы могут повторяться."
"DOTA_OpenTreasureTooltip_RareTitle"	"Есть вероятность получить дополнительно:"
"DOTA_OpenTreasureTooltip_UnitName"	"{g:dota_item_unit_name:item_def}"
"DOTA_OpenTreasureTooltip_ItemName"	" - {g:dota_item_name:item_def}"
"dota_profile_content_tab_official_info"	"Проф. информация"
"dota_profile_oi_player_name"	"ПСЕВДОНИМ"
"dota_profile_oi_player_name_sub"	"Должен быть узнаваемым для игроков по всему миру. Не указывайте в нём команду или спонсоров."
"dota_profile_oi_team"	"КОМАНДА"
"dota_profile_oi_team_sub"	"Если вы играете в команде по Dota 2, то укажите ее. Тег этой команды будет указан перед вашим псевдонимом."
"dota_profile_oi_sponsor"	"СПОНСОР"
"dota_profile_oi_sponsor_sub"	"Названия спонсоров, которые будут указаны после вашего псевдонима."
"dota_profile_oi_country"	"СТРАНА"
"dota_profile_oi_role"	"РОЛЬ"
"dota_profile_oi_role_sub"	"Если вы исполняете определенную роль, выберите ее. В основу входят те, кто играет на центральной или сложной линии, а также те, кто зарабатывает золото на легкой линии."
"dota_profile_oi_preview"	"Вот как ваш псевдоним будет отображаться в таблице лидеров и турнирных играх:"
"dota_profile_oi_preview_warning"	"Эту информацию можно изменять только раз в две недели, поэтому убедитесь, что она указана точно, прежде чем отправлять ее!"
"dota_profile_oi_submit_info"	"Отправить"
"dota_profile_oi_submit_pending"	"Отправка…"
"dota_profile_oi_submit_success"	"Готово!"
"dota_profile_oi_submit_failure"	"Ошибка - повторите попытку."
"dota_role_core"	"Основа"
"dota_role_support"	"Поддержка"
"Compendium_GenerateFail"	"Не удалось сгенерировать файл ресурсов «{s:s1}»."
"Compendium_PreparePublish"	"Подготовить к публикации"
"Compendium_PublishError"	"Не удалось скопировать «{s:s1}» в папку компендиума по адресу «{s:s2}»."
"Compendium_PublishFinishedTitle"	"Публикация успешно завершена"
"DOTA_Treasure"	"Сокровищница"
"DOTA_Blog"	"Новости Dota 2"
"DOTA_SortBy"	"Сортировать по"
"DOTA_SortOption_Newest"	"Новизне"
"DOTA_SortOption_Owned"	"Наличию"
"DOTA_SortOption_Price"	"Цене"
"DOTA_SortOption_Alphabetical"	"Алфавитному порядку"
"Action_Use"	"Использовать"
"DOTA_BadgeLevel"	"{d:badge_level}"
"DOTA_AHC_CurrentHero"	"Текущий герой"
"DOTA_AHC_CurrentHeroName"	"{s:current_hero_name}"
"DOTA_AHC_InProgress"	"Выполняется"
"DOTA_AHC_CurrentHeroAttempts"	"{s:current_hero_attempts}"
"DOTA_AHC_CurrentHeroAverage"	"Попыток в среднем по миру"
"DOTA_AHC_CurrentHeroAverageAttempts"	"{s:current_hero_average_attempts}"
"DOTA_AHC_NextHero"	"Следующий герой"
"DOTA_AHC_NextHeroName"	"{s:next_hero_name}"
"DOTA_AHC_ChallengeProgress"	"Прогресс испытания ({d:challenge_progress_percent}%)"
"DOTA_AHC_HeroesCompleted"	"Героев завершено"
"DOTA_AHC_HeroesCompletedValue"	"{d:heroes_completed} / {d:heroes_total}"
"DOTA_AHC_TotalAttempts"	"Всего игр"
"DOTA_AHC_TotalAttemptsValue"	"{d:challenge_total_attempts}"
"DOTA_AHC_EquivalentWorldAverage"	"Игр для такого же результата в среднем по миру"
"DOTA_AHC_EquivalentWorldAverageValue"	"{d:challenge_average_total_attempts}"
"DOTA_AHC_LifetimeStats"	"Статистика испытания за все время"
"DOTA_AHC_FullChallengesCompleted"	"Полных прохождений испытания"
"DOTA_AHC_FullChallengesCompletedValue"	"{d:full_challenges_completed}"
"DOTA_AHC_BestFullChallenge"	"Рекорд по количеству игр"
"DOTA_AHC_BestFullChallengeValueNone"	"Нет"
"DOTA_AHC_BestFullChallengeValue"	"{d:best_full_challenge}"
"DOTA_AHC_FullChallengeAverage"	"Игр в среднем по миру"
"DOTA_AHC_FullChallengeAverageValue"	"{s:full_challenge_average}"
"DOTA_AHC_ChallengeReward"	"Награда за испытание"
"DOTA_AHC_ChallengeTrophyName"	"{s:challenge_trophy_name}"
"DOTA_AHC_ChallengeTrophyLevel"	"Уровень {d:challenge_trophy_level}"
"DOTA_Trophies_ViewEarned"	"Полученные"
"DOTA_Party_Add_Friends"	"Добавьте друзей, чтобы создать группу"
"DOTA_ItemSet_Count_text"	"{d:item_current_group} / {d:item_group_count}"
"DOTA_Custom_Game_Map_AnyNumbered"	"Любая из {d:map_choices}"
"dota_settings_enable_console"	"Включить консоль"
"dota_settings_enable_console_tooltip"	"Приоритет параметров запуска -dev и -console выше этой опции"
"dota_settings_binding_options"	"Настройки клавиш"
"dota_settings_allow_gui_key_to_bind"	"Использовать клавиши Windows/Command"
"DOTA_HeroLoadout_Loadout"	"Снаряжение"
"DOTA_HeroLoadout_About"	"Информация"
"DOTA_HeroLoadout_Guides"	"Руководства"
"DOTA_HeroLoadout_Roles"	"Роли"
"DOTA_HeroLoadout_Biography"	"Биография"
"DOTA_Feed_Say_Something"	"Расскажите о чём-нибудь…"
"DOTA_Armory_ClearFilter"	"Убрать фильтр"
"DOTA_Armory_ContextMenu_Tags"	"Метки…"
"DOTA_Armory_ContextMenu_EffigyPose"	"Поза…"
"DOTA_Armory_ContextMenu_EffigyReforge"	"Изменить…"
"DOTA_EffigyEditor_CreateEffigy"	"Создать статую"
"DOTA_EffigyEditor_PoseEffigy"	"Изменить позу"
"DOTA_EffigyEditor_ReforgeEffigy"	"Изменить статую"
"DOTA_EffigyEditor_Model"	"Герой"
"DOTA_EffigyEditor_Loadout"	"Снаряжение"
"DOTA_EffigyEditor_Inscription"	"Надпись:"
"DOTA_EffigyEditor_Animation"	"Анимация:"
"DOTA_EffigyEditor_Frame"	"Выберите кадр"
"DOTA_EffigyEditor"	"Редактор статуй"
"DOTA_EffigyEditor_ConfirmCreate"	"Создав статую, вы потратите блок для нее, после чего изменить ее можно будет только соответствующим инструментом. Вы уверены, что хотите продолжить?"
"DOTA_EffigyEditor_ConfirmReforge"	"Изменив статую, вы потратите инструмент для изменения статуй. Вы уверены, что хотите продолжить?"
"DOTA_EffigyEditor_Error"	"Не удалось создать статую."
"DOTA_EffigyEditor_ErrorReforge"	"Не удалось изменить статую."
"DOTA_EffigyEditor_ErrorPose"	"Не удалось изменить позу статуи."
"DOTA_EffigyEditor_Success"	"Статуя создана."
"DOTA_EffigyEditor_SuccessReforge"	"Статуя изменена."
"DOTA_EffigyEditor_SuccessPose"	"Поза статуи изменена."
"dota_profile_content_tab_all_hero_challenge"	"Испытание всех героев"
"DOTA_tooltip_econ_item_delete_restriction"	"Нельзя удалить"
"DOTA_tooltip_econ_item_modifiers"	"Модификаторы"
"DOTA_tooltip_econ_item_modifier_animation"	"Анимация"
"DOTA_tooltip_econ_item_modifier_announcer"	"Комментатор"
"DOTA_tooltip_econ_item_modifier_HUD"	"Стиль интерфейса"
"DOTA_tooltip_econ_item_modifier_health_bar"	"Полоса здоровья"
"DOTA_tooltip_econ_item_modifier_ability_name"	"Название способности"
"DOTA_tooltip_econ_item_modifier_loading_screen"	"Загрузочный экран"
"DOTA_tooltip_econ_item_modifier_cursor_pack"	"Набор курсоров"
"DOTA_tooltip_econ_item_modifier_portrait"	"Портрет"
"DOTA_tooltip_econ_item_modifier_ambient_effects"	"Визуальные эффекты"
"DOTA_tooltip_econ_item_modifier_kill_effects"	"Эффекты убийства"
"DOTA_tooltip_econ_item_modifier_spell_effects"	"Эффекты способностей"
"DOTA_tooltip_econ_item_modifier_model"	"Модель"
"DOTA_tooltip_econ_item_modifier_scale"	"Размер"
"DOTA_tooltip_econ_item_modifier_wearable"	"Можно надеть"
"DOTA_tooltip_econ_item_modifier_courier"	"Курьер"
"DOTA_tooltip_econ_item_modifier_flying_courier"	"Летающий курьер"
"DOTA_tooltip_econ_item_modifier_pet"	"Питомец"
"DOTA_tooltip_econ_item_modifier_weather"	"Погода"
"DOTA_tooltip_econ_item_modifier_sound"	"Звук"
"DOTA_tooltip_econ_item_modifier_soundscape"	"Звуковой фон"
"DOTA_tooltip_econ_item_modifier_voice"	"Голос"
"DOTA_tooltip_econ_item_modifier_icon"	"Иконка"
"DOTA_econ_item_details_style_label"	"Стиль:"
"DOTA_econ_item_details_gift_label"	"Подарок от:"
"Compendium_Downloading"	"Загрузка компендиума…"
"Compendium_DLFailed"	"Загрузка не удалась"
"Compendium_DLFailed_Desc"	"Не удалось загрузить компендиум.\n\nПовторите попытку позже."
"Compendium_Error"	"Ошибка компендиума"
"Compendium_Error_Desc"	"Имеется проблема с компендиумом. Мы работаем над ее устранением.\n\nПовторите попытку позже."
"Compendium_Retry"	"Повторить"
"Compendium_preview_mode"	"ПРЕДПРОСМОТР"
"Compendium_preview_click"	"Нажмите сюда для активации!"
"Compendium_level"	"УРОВЕНЬ"
"Compendium_to_next_level"	"ДО СЛЕД. УРОВНЯ"
"Compendium_LevelupPts_Singular"	"Очков: 1"
"Compendium_LevelupPts_Plural"	"Очков: {d:next_comp_level}"
"DOTA_GlobalItems_MegaKill"	"Наборы мега-убийств"
"DOTA_Treasure_BonusReward"	"Дополнительная награда"
"DOTA_OpenTreasureTooltip_ExtraItems"	"…и еще {d:extra_items_count}!"
"DOTA_AASystem_Green"	"Вы играете без перерыва {s:playtime}. Сейчас никакой угрозы здоровью нет. Наслаждайтесь!"
"DOTA_AASystem_Yellow"	"Вы играете без перерыва %s1. Это слишком долго и может навредить вашему здоровью. Пожалуйста, отдохните!"
"DOTA_AASystem_Red"	"Вы играете без перерыва %s1. Это слишком долго и может навредить вашему здоровью. Самое время отдохнуть!"
"DOTA_AntiAddiction_Initial_With_ID_18Plus"	"Последний раз в сети: %s1\nПоследний IP-адрес: %s2"
"DOTA_AntiAddiction_Initial_With_ID_Under_18"	"Вам нет 18 лет. Действует система против зависимости.\nПоследний раз в сети: %s1\nПоследний IP-адрес: %s2"
"DOTA_AntiAddiction_Initial_No_ID"	"Ваш аккаунт не зарегистрирован.\nПоследний раз в сети: %s1\nПоследний IP-адрес: %s2"
"DOTA_AntiAddiction_Blocked_Time_Exceeded"	"Система против зависимости: превышено допустимое время игры. Завершение работы."
"DOTA_AntiAddiction_Initial_No_ID_Popup"	"Ваш аккаунт зарегистрирован не полностью. Желаете ввести информацию о себе?"
"DOTA_AntiAddiction_CompleteInfoNow"	"Ввести информацию"
"DOTA_AntiAddiction_CompleteInfoNotNow"	"Не сейчас"
"DOTA_AntiAddiction_Initial_DateFormat"	"%s1Г%s2М%s3Д %s4:%s5:%s6"
"DOTA_AntiAddiction_Label_Green"	"Время игры: {s:playtime} (безопасно)"
"DOTA_AntiAddiction_Label_Yellow"	"Время игры: {s:playtime} (небезопасно)"
"DOTA_AntiAddiction_Label_Red"	"Время игры: {s:playtime} (превышен лимит)"
"DOTA_Workshop_Browse"	"Мастерская"
"DOTA_Workshop_TextureName_color"	"Цвет"
"DOTA_Workshop_MaterialName_MetalnessTexture"	"Эффект металла"
"DOTA_Workshop_MaterialName_NormalTexture"	"Карта нормалей"
"DOTA_Workshop_MaterialName_RimMaskTexture"	"Маска краев"
"DOTA_Workshop_MaterialName_SpecMaskTexture"	"Маска отражений"
"DOTA_Workshop_MaterialDetail_ColorTexture"	"Это текстура цвета! Это цвет."
"DOTA_Workshop_Model"	"Модель"
"DOTA_Workshop_Animations"	"Анимации"
"DOTA_Workshop_Misc"	"Разное"
"DOTA_Workshop_SubmissionType_Ward"	"Вард"
"DOTA_Workshop_ImportNoP4"	"Импорт (без файла .p4)"
"DOTA_Workshop_SaveSettings"	"Сохранить настройки"
"DOTA_Workshop_LoadSettings"	"Загрузить настройки"
"DOTA_Workshop_Ready"	"Готово"
"DOTA_Workshop_NotRequired_Geometry"	"(Макс. кол-во треугольников: %s1)"
"DOTA_Workshop_NotRequired_Texture"	"(Размер текстур будет изменен до: %s1)"
"DOTA_Workshop_ItemName"	"ИМЯ ВЫХОДНОГО ФАЙЛА:"
"DOTA_Workshop_ItemName_Desc"	"Это выходное имя файла для вашего предмета. Его не видят игроки, и его длина не должна превышать 50 символов."
"DOTA_Workshop_GenericModelName_Desc"	"Это имя загружаемого вами контента. Оно используется только в компании Valve, поэтому подберите уникальное и наглядное имя. Игроки его не увидят. Максимальная длина — 50 символов."
"DOTA_Workshop_UnknownLOD"	"Неизвестный файл геометрии"
"DOTA_Workshop_LOD0Title"	"ДОПОЛНИТЕЛЬНАЯ ГЕОМЕТРИЯ ПОРТРЕТА"
"DOTA_Workshop_LOD1Title"	"Внутриигровая геометрия"
"DOTA_Workshop_Texture_Title"	"ФАЙЛЫ ТЕКСТУР"
"DOTA_Workshop_Texturing"	"Помощь по текстурированию"
"DOTA_Workshop_Modelling"	"Помощь по моделированию"
"DOTA_Workshop_Animation"	"Помощь по анимации"
"DOTA_Workshop_DisableNICE"	"Отключить фильтрацию текстур"
"DOTA_Workshop_DisableNICE_Desc"	"Некоторые текстуры могут образовывать лишние блики, сильно снижающие детализацию, если включена стандартная фильтрация. Если у вас имеется данная проблема, попробуйте включить эту опцию и посмотреть, стали ли текстуры более разборчивыми."
"DOTA_Workshop_Reimport"	"Обновить"
"DOTA_Workshop_Models_Title"	"МОДЕЛИ"
"DOTA_Workshop_Materials_Title"	"МАТЕРИАЛЫ"
"DOTA_Workshop_Attachments_Title"	"ТОЧКИ ФИКСАЦИИ"
"DOTA_Workshop_Marketing_Title"	"РЕКЛАМА"
"DOTA_Workshop_Marketing_Desc"	"Файл формата .PSD, содержащий изображения, используемые для продвижения вашей публикации. Пройдите по ссылке «Помощь по рекламе», чтобы узнать требования к вашему PSD-файлу и его рекомендуемый формат."
"DOTA_Workshop_Marketing_Help"	"Помощь по рекламе"
"DOTA_Workshop_Particles_Title"	"ЧАСТИЦЫ"
"DOTA_Workshop_Particles_Desc"	"Эта модель будет иметь прикрепленную систему частиц для игры. Вершины, указывающие на то, как система частиц должна быть прикреплена, содержатся в файле с расширением .DMX, .SMD или .FBX."
"DOTA_Workshop_Images_Title"	"ИЗОБРАЖЕНИЯ"
"DOTA_Workshop_AbilityIcons_Title"	"ИКОНКИ СПОСОБНОСТЕЙ"
"DOTA_Workshop_HudSkin_Intro"	"Стиль интерфейса — это набор изображений, заменяющих внутриигровой интерфейс."
"DOTA_Workshop_HudSkin_Desc"	"Набор .PNG-файлов, созданных с помощью инструмента для экспорта стиля интерфейса из Photoshop. Выберите любой из .PNG-файлов, и остальные будут выбраны автоматически. Файлы должны находиться в папке, созданной инструментом для экспорта."
"DOTA_Workshop_HudSkin_Help"	"Помощь по стилям интерфейса"
"DOTA_Workshop_CursorPack_Intro"	"Набор курсоров – это набор изображений, заменяющих стандартные внутриигровые курсоры."
"DOTA_Workshop_CursorPack_Desc"	"Набор файлов в формате .BMP и .ANI, которые заменят курсоры. Также необходимо изображение этих же курсоров в формате .PNG. Выберите файл icon.png, который будет иконкой вашего набора в инвентаре, а остальные файлы выберутся автоматически."
"DOTA_Workshop_CursorPack_Help"	"Помощь по курсорам"
"DOTA_Workshop_ImportLoadingScreen"	"ИМПОРТИРОВАТЬ ЗАГРУЗОЧНЫЙ ЭКРАН"
"DOTA_Workshop_LoadingScreen_Intro"	"Изображение, которое заменяет стандартный загрузочный экран Dota 2"
"DOTA_Workshop_LoadScreen_Preview_Title"	"Предпросмотр обрезки сторон"
"DOTA_UI_LoadScreen_16_9"	"Формат 16:9"
"DOTA_UI_LoadScreen_16_10"	"Формат 16:10"
"DOTA_UI_LoadScreen_4_3"	"Формат 4:3"
"DOTA_Workshop_ImportChatEmoticon"	"ИМПОРТИРОВАТЬ СМАЙЛИК"
"DOTA_Workshop_ChatEmoticon_Intro"	"Анимированный смайлик"
"DOTA_Workshop_ChatEmoticon_Help"	"Помощь по смайликам"
"DOTA_Workshop_ChatEmoticon_ItemName"	"Ключевое слово для смайлика"
"DOTA_Workshop_ChatEmoticon_ItemName_Desc"	"Предполагаемое ключевое слово смайлика"
"DOTA_Workshop_ChatEmoticon_AnimationSpeed"	"Длительность кадра"
"DOTA_Workshop_ChatEmoticon_DefaultFrame"	"Основной кадр"
"DOTA_Workshop_ChatEmoticon_DefaultFrame_Desc"	"Номер кадра, который показывается, когда закончилась анимация смайлика. В диапазоне кадров от нуля до последнего кадра минус один. Используйте -1, чтобы автоматически выбрать последний кадр. Если информация не указана, будет использоваться первый кадр (0)."
"DOTA_Workshop_ChatEmoticon_Preview_Title"	"Предпросмотр смайлика"
"DOTA_Workshop_ImportChatEmoticon_Preview"	"Предпросмотр"
"DOTA_Workshop_File_ChatEmoticon"	"Исходное изображение (файлы .png)"
"DOTA_Workshop_Attachments_Desc"	"Точки фиксации — это места на модели, на которые игра может поместить некоторые эффекты. У каждой точки фиксации есть координаты и угол, на котором она отклоняется от кости модели. Укажите для каждой требуемой точки фиксации имя кости. Как только мы построим импортированную модель, вы сможете увидеть на предварительном просмотре указанные вами точки фиксации и подтвердить их использование."
"DOTA_Workshop_Attachments_UIBlock"	"Вложения %s1"
"DOTA_Workshop_Attachment_HitLocation"	"Название кости точки попадания"
"DOTA_Workshop_Attachment_LeftEye"	"Название кости левого глаза"
"DOTA_Workshop_Attachment_RightEye"	"Название кости правого глаза"
"DOTA_Workshop_Attachment_AttackPoint"	"Название кости точки атаки"
"DOTA_Workshop_Attachment_AttackPoint_Desc"	"У воинов дальнего боя в этой точке начинается полет снаряда. У воинов ближнего боя в этой точке появляются эффекты удара (например, брызги крови)."
"DOTA_Workshop_Attachment_AttackPoint2"	"Название кости точки атаки вспомогательного оружия"
"DOTA_Workshop_Attachment_Mouth"	"Название кости рта"
"DOTA_Workshop_Attachment_Mouth_Desc"	"Обозначает место, где будут располагаться эффекты частиц, необходимые для рта юнита."
"DOTA_Workshop_Attachment_BowTop"	"Верхняя точка фиксации тетивы"
"DOTA_Workshop_Attachment_BowTop_Desc"	"Задает место, в котором фиксируется эффект частицы верхнего конца тетивы."
"DOTA_Workshop_Attachment_BowMid"	"Средняя точка фиксации тетивы"
"DOTA_Workshop_Attachment_BowMid_Desc"	"Задает место, в котором фиксируется эффект частицы середины тетивы. Используется при изгибе тетивы во время стрельбы."
"DOTA_Workshop_Attachment_BowBot"	"Нижняя точка фиксации тетивы"
"DOTA_Workshop_Attachment_BowBot_Desc"	"Задает место, в котором фиксируется эффект частицы нижнего конца тетивы."
"DOTA_Workshop_Attachment_LowerStaff"	"Нижняя точка фиксации на посохе Earth Spirit"
"DOTA_Workshop_Attachment_LowerStaff_Desc"	"Указывает, где на модели посоха должен быть прикреплен нижний эффект частиц."
"DOTA_Workshop_Attachment_UpperStaff"	"Верхняя точка фиксации на посохе Earth Spirit"
"DOTA_Workshop_Attachment_UppperStaff_Desc"	"Указывает, где на модели посоха должен быть прикреплен верхний эффект частиц."
"DOTA_Workshop_Animation_Desc"	"Анимации — это файлы с расширением .dmx, .smd, либо .fbx, в которых содержатся отдельные анимации для вашей модели."
"DOTA_Workshop_Animation_UIBlock"	"Анимации %s1"
"DOTA_Workshop_Preview_Anim"	"Анимация:"
"DOTA_Workshop_Preview_Gesture"	"Наложение:"
"DOTA_Workshop_Preview_Skin"	"Текстура:"
"DOTA_Workshop_Preview_Model"	"Модель:"
"DOTA_Workshop_Preview_Attachment"	"Выделить точку фиксации:"
"DOTA_Workshop_Preview_NoAttachment"	"Нет"
"DOTA_Workshop_Preview_ShowReference"	"Показать основу"
"DOTA_Workshop_ImportError"	"Ошибка импорта"
"DOTA_Workshop_Error"	"Ошибка импорта"
"DOTA_Workshop_Quicksave_Fail"	"Ошибка сохранения"
"DOTA_Workshop_LOD1Title_Ward"	"Внутриигровая геометрия"
"DOTA_Workshop_Mat0Title_Ward"	"Текстуры Observer Ward"
"DOTA_Workshop_Mat1Title_Ward"	"Текстуры Sentry Ward"
"DOTA_Workshop_Animation_Spawn"	"Возрождение"
"DOTA_Workshop_Animation_Idle"	"Бездействие"
"DOTA_Workshop_Animation_IdleRare"	"Бездействие, редкая"
"DOTA_Workshop_Animation_Run"	"Бег"
"DOTA_Workshop_Animation_RunRare"	"Бег, редкая"
"DOTA_Workshop_Animation_RunHaste"	"Ускорение"
"DOTA_Workshop_Animation_RunInjured"	"Бег при ранениях"
"DOTA_Workshop_Animation_Die"	"Смерть"
"DOTA_Workshop_Animation_Attack"	"Атака"
"DOTA_Workshop_Animation_Attack2"	"Вспомогательная атака"
"DOTA_Workshop_Animation_Flail_Desc"	"Повторяющаяся анимация, использующаяся, когда юнит выведен из строя и перемещается (напр. под воздействием Eul's Scepter of Divinity, Black Hole, Tornado)"
"DOTA_Workshop_Animation_TurnPoseCenter"	"Движение прямо"
"DOTA_Workshop_Animation_TurnPoseLeft"	"Поворот налево"
"DOTA_Workshop_Animation_TurnPoseRight"	"Поворот направо"
"DOTA_Workshop_Animation_PortraitIdle"	"Портрет при бездействии"
"DOTA_Workshop_Animation_BackLeftIdle"	"Бездействие слева сзади"
"DOTA_Workshop_Animation_LeftIdle"	"Бездействие слева"
"DOTA_Workshop_Animation_RightIdle"	"Бездействие справа"
"DOTA_Workshop_Animation_BackRightIdle"	"Бездействие справа сзади"
"DOTA_Workshop_Animation_BackLeftAttack"	"Атака слева сзади"
"DOTA_Workshop_Animation_LeftAttack"	"Атака слева"
"DOTA_Workshop_Animation_RightAttack"	"Атака справа"
"DOTA_Workshop_Animation_BackRightAttack"	"Атака справа сзади"
"DOTA_Filter_Field_Category"	"Меткам"
"DOTA_Armory_Tags_Popup_Title"	"Задать метки"
"DOTA_Armory_Attributes"	"Атрибуты"
"DOTA_Event_Level"	"Уровень"
"DOTA_Skip"	"Пропустить"
"DOTA_Done"	"Готово"
"DOTA_TryAgain"	"Еще раз"
"DOTA_Treasure_OpenAnother"	"Открыть еще"
"DOTA_Treasure_OpenTreasure"	"Открыть сокровищницу"
"DOTA_Treasure_OpenDupe"	"Каждая сокровищница содержит {d:items_per_treasure} из показанных предметов. При повторном открытии вам может выпасть дубликат. Если повезет, вы также получите один из редких предметов."
"DOTA_Treasure_OpenFailed_NoItem"	"В инвентаре нет сокровищницы, которую можно открыть."
"DOTA_Treasure_OpenFailed_NoItemsReceived"	"Невозможно получить список предметов, полученных из сокровищницы."
"DOTA_Treasure_OpenSuccess"	"Поздравляем! Вы получили:"
"dota_settings_force_right_click_attack"	"Принудительная атака правой кнопкой мыши"
"DOTA_Settings_Tooltip_Force_Right_Click_Attack"	"Если вы нажмете правой кнопкой мыши на дружественного юнита, герой попытается атаковать его."
"DOTA_Effigy_AcceptCustomize"	"Принять снаряжение для статуи"
"DOTA_Effigy_CancelCustomize"	"Отменить снаряжение для статуи"
"DOTA_Custom_Game_Created_By"	"Создатель: <b>{g:dota_persona:author}</b>"
"DOTA_Custom_Game_Dedicated_Servers"	"Выделенные серверы"
"DOTA_Custom_Game_Dedicated_Servers_I"	"Эта пользовательская игра поддерживает выделенные серверы Valve и будет работать на них."
"dota_settings_rangefinder"	"Показывать расстояние применения способности"
"DOTA_View_Details"	"Подробнее"
"DOTA_TabName_Featured"	"Избранное"
"DOTA_TabName_Heroes"	"Герои"
"DOTA_Friends_ID"	"Ваш ID для друзей"
"DOTA_Profile_Edit"	"Редактировать профиль"
"DOTA_Profile_LifetimeStats"	"Статистика за всё время"
"DOTA_Profile_ViewSteamProfile"	"Профиль Steam"
"DOTA_Profile_SendMessage"	"Отправить сообщение"
"DOTA_Trophies_ViewAvailable"	"Доступные"
"DOTA_TrophyXPProgress"	"{d:trophy_xp} / {d:total_trophy_xp} очков трофеев"
"DOTA_TrophyDetails_XP"	"{d:trophy_details_xp} очков"
"DOTA_Trophy_Upgraded"	"Трофей улучшен"
"DOTA_Trophy_Achieved"	"Трофей получен"
"DOTA_TrophyPlusProfileXP"	"+{d:trophy_xp} очков трофеев"
"DOTA_ProfileBadge_Upgraded"	"Значок профиля улучшен"
"DOTA_Lobby_Settings_Tournament_None"	"Нет"
"DOTA_Lobby_Settings_Tournament"	"Турнир"
"DOTA_WatchReplaysConextMenu_Watch"	"Смотреть"
"DOTA_WatchReplaysConextMenu_DownloadWatch"	"Загрузить и посмотреть"
"DOTA_WatchReplaysConextMenu_DownloadWatchLater"	"Загрузить и посмотреть позже"
"DOTA_WatchReplaysConextMenu_WatchLater"	"Посмотреть позже"
"DOTA_WatchReplaysConextMenu_WatchLaterClear"	"Не смотреть позже"
"DOTA_WatchReplays_Game1"	"Игра 1"
"DOTA_WatchReplays_Game2"	"Игра 2"
"DOTA_WatchReplays_Game3"	"Игра 3"
"DOTA_WatchReplays_Game4"	"Игра 4"
"DOTA_WatchReplays_Game5"	"Игра 5"
"DOTA_WatchReplayError"	"Ошибка при просмотре записи"
"DOTA_WatchReplayError_Incompatible"	"Эта запись несовместима с текущей версией игры."
"DOTA_WatchReplayError_DoesNotExist"	"Этого матча не существует."
"DOTA_WatchTournaments_PrizePoolLabel"	"в фонде"
"DOTA_WatchTournaments_PrizePoolTicketPrice"	"Билет - {g:dota_item_price:ticket_itemdef}"
"DOTA_WatchTournaments_PrizePoolActivate"	"Активировать билет"
"DOTA_WatchTournaments_LiveGames"	"- ИГРА В ПРЯМОМ ЭФИРЕ"
"DOTA_WatchTournaments_View"	"Смотреть"
"DOTA_WatchTournaments_Region_NA"	"Северная Америка"
"DOTA_WatchTournaments_Region_SA"	"Южная Америка"
"DOTA_WatchTournaments_Region_EU"	"Европа"
"DOTA_WatchTournaments_Region_RU"	"Россия"
"DOTA_WatchTournaments_Region_CN"	"Китай"
"DOTA_WatchTournaments_Region_SEA"	"Юго-Восточная Азия"
"DOTA_WatchTournament_BestOf3"	"До 2 побед"
"DOTA_WatchTournament_BestOf5"	"До 3 побед"
"DOTA_WatchTournament_Website"	"Сайт турнира"
"DOTA_WatchTournament_Compendium"	"Компендиум"
"DOTA_WatchTournament_Page"	"Страница {i:page_cur} / {i:page_max}"
"DOTA_WatchTournament_Spectators"	"Зрителей: {i:spectators}"
"DOTA_ShuffledItem_Label"	"В случайном"
"DOTA_EquippedItem_Button_SingleItemShuffle"	"Надеть"
"DOTA_Feed_Title"	"Действия друзей"
"DOTA_Armory_Category_EffigyBlocks"	"Блоки статуй"
"DOTA_Armory_Category_EffigyReforgers"	"Инструменты для изменения статуй"
"DOTA_Armory_Category_Leagues"	"Турнирные предметы"
"DOTA_Armory_Category_Charms"	"Амулеты"
"DOTA_Armory_Category_CharmFragments"	"Осколки амулетов"
"DOTA_Armory_Category_MegaKills"	"Мега-убийства"
"DOTA_Armory_Category_Treasures"	"Сокровища"
"DOTA_Armory_Category_Gifts"	"Подарки"
"DOTA_Armory_Category_Bundles"	"Комплекты"
"DOTA_Armory_Category_Compendiums"	"Компендиумы"
"DOTA_Armory_Category_Tools"	"Инструменты"
"DOTA_Armory_ActiveFilterLabel"	"Фильтр:"
"DOTA_Armory_EditFilter"	"Изменить фильтр"
"DOTA_Armory_ContextMenu_AddShuffle"	"В случайное"
"DOTA_Armory_ContextMenu_RemoveShuffle"	"Убрать из случайного"
"DOTA_Armory_Filter_Tradeable"	"МОЖНО ОБМЕНЯТЬ"
"DOTA_Armory_Filter_Equipped"	"ИСПОЛЬЗУЕТСЯ"
"DOTA_Armory_Filter_Duplicate"	"ДУБЛИКАТ"
"DOTA_Armory_Filter_HasSockets"	"ЕСТЬ ГНЕЗДА"
"DOTA_Armory_Filter_IsJunk"	"ПОМЕЧЕНО НЕНУЖНЫМ"
"DOTA_Armory_Filter_WillExpire"	"ИСЧЕЗНЕТ"
"DOTA_Armory_Filter_IsBundle"	"В КОМПЛЕКТЕ"
"DOTA_Armory_Filter_IsGift"	"ПОДАРОК"
"DOTA_Armory_Filter_Rarity"	"РЕДКОСТЬ"
"DOTA_Armory_Filter_Quality"	"КАЧЕСТВО"
"DOTA_Armory_Filter_Tags"	"МЕТКИ"
"DOTA_Armory_Filter_Delete"	"Удалить фильтр"
"DOTA_Armory_Filter_CreateNew"	"Новый фильтр…"
"DOTA_Armory_Filter_FilterName"	"Название фильтра"
"DOTA_Armory_Filter_Required"	"ОБЯЗАТЕЛЬНО"
"DOTA_tooltip_econ_item_tags"	"Метки"
"Compendium_LeagueID"	"ID турнира"
"Compendium_InvalidLeagueID"	"Неверный ID турнира."
"Compendium_Unsupported"	"Компендиум не поддерживается"
"Compendium_Unsupported_Desc"	"Это старый компендиум, который больше не работает."
"Compendium_TestingBadLeagueID"	"Неверное ключевое значение «league_id» в файле данных компендиума."
"DOTA_GlobalItems_CursorPacks"	"Наборы курсоров"
"DOTA_Workshop_Materials"	"Материалы"
"DOTA_Armory_Tags_Popup_Info"	"Изменив метку, вы не очистите выбранные до этого предметы с указанной меткой. Эти предметы унаследуют новую метку."
"DOTA_Popup_Item_Received_Header_Unknown"	"Вы получили:"
"DOTA_Popup_Item_Received_Header_Dropped"	"Вы получили:"
"DOTA_Popup_Item_Received_Header_Crafted"	"Вы сковали:"
"DOTA_Popup_Item_Received_Header_Traded"	"Вы обменялись на:"
"DOTA_Popup_Item_Received_Header_Purchased"	"Вы приобрели:"
"DOTA_Popup_Item_Received_Header_FoundInCrate"	"Вы получили:"
"DOTA_Popup_Item_Received_Header_Gifted"	"Вам подарили:"
"DOTA_Popup_Item_Received_Header_Support"	"Служба поддержки выдала вам:"
"DOTA_Popup_Item_Received_Header_Promotion"	"Вы получили промо-предмет:"
"DOTA_Popup_Item_Received_Header_Earned"	"Вы заработали:"
"DOTA_Popup_Item_Received_Header_Refunded"	"Вам восстановили:"
"DOTA_Popup_Item_Received_Header_GiftWrapped"	"Вы поместили в подарок:"
"DOTA_Popup_Item_Received_Header_Foreign"	"Вы получили предмет в другой игре:"
"DOTA_Popup_Item_Received_Header_CollectionReward"	"Вы получили коллекционную награду:"
"DOTA_Popup_Item_Received_Header_PreviewItem"	"Вы тестируете:"
"DOTA_Popup_Item_Received_Header_PreviewItemPurchased"	"Вы приобрели:"
"DOTA_Popup_Item_Received_Header_PeriodicScoreReward"	"Вы заработали:"
"DOTA_Popup_Item_Received_Header_Recycling"	"Вы сковали:"
"DOTA_Popup_Item_Received_Header_TournamentDrop"	"Вы получили турнирный предмет:"
"DOTA_Popup_Item_Received_Header_RecipeOutput"	"Вы сковали:"
"DOTA_Popup_Item_Received_Header_CommunityMarketPurchase"	"Вы приобрели:"
"DOTA_Popup_Item_Received_Header_GemExtract"	"Вы извлекли:"
"DOTA_Popup_Item_Received_Header_CompendiumReward"	"Вы получили награду компендиума:"
"DOTA_Popup_Item_Received_Header_CompendiumDrop"	"Вы получили предмет из компендиума:"
"DOTA_Popup_Item_Received_Label_IOfN"	"{d:item_i} из {d:item_n}"
"DOTA_Popup_Item_Received_Button_Accept"	"Принять"
"DOTA_Popup_Item_Received_Button_AcceptAll"	"Принять все ({d:item_n})"
"DOTA_WatchLive_LoadMore"	"Еще"
}
