"dota"
{
"DOTA_Accept"	"Accetta"
"DOTA_Cancel"	"Annulla"
"DOTA_Console"	"Console"
"DOTA_Create"	"Crea"
"DOTA_Decline"	"Rifiuta"
"DOTA_Error"	"Errore"
"DOTA_Join"	"Unisciti"
"DOTA_Leave"	"Esci"
"DOTA_New"	"Novità"
"DOTA_Ok"	"OK"
"DOTA_Sale"	"Sconto"
"DOTA_Close"	"Chiudi"
"DOTA_Continue"	"Continua"
"DOTA_Add"	"Aggiungi"
"DOTA_Edit"	"Modifica"
"DOTA_Enable"	"Attiva"
"DOTA_Disable"	"Disattiva"
"DOTA_Refresh"	"Aggiorna"
"DOTA_Loading"	"Caricamento"
"DOTA_None"	"Nulla"
"DOTA_Customize"	"Personalizza"
"DOTA_AcceptChanges"	"Accetta le modifiche"
"dota_team_radiant"	"Radiant"
"dota_team_dire"	"Dire"
"Unknown"	"Sconosciuto"
"UI_Yes"	"Sì"
"UI_No"	"No"
"UI_File_Filter_Any"	"Tutti i file (*.*)"
"DOTA_MainMenu_Heroes"	"Eroi"
"DOTA_MainMenu_Watch"	"Guarda"
"DOTA_MainMenu_Learn"	"Impara"
"DOTA_MainMenu_Mods"	"Modalità personalizzate"
"DOTA_TabName_GlobalItems"	"Oggetti globali"
"DOTA_TabName_Treasury"	"Tesoreria"
"DOTA_TabName_Armory"	"Arsenale"
"DOTA_ConfirmQuit"	"Conferma la chiusura"
"DOTA_ConfirmQuitDesc"	"Vuoi davvero uscire da Dota 2?"
"DOTA_ConfirmQuitDescUnsafe"	"Se abbandoni prima della conclusione, rischi di rovinare la partita agli altri giocatori. Vuoi davvero uscire da Dota 2?"
"DOTA_InvalidPersonaName"	"[sconosciuto]"
"DOTA_Friends_WindowTitle"	"AMICI"
"DOTA_FriendsCategory_ReadyToPlay"	"In partite aperte <font color='#63C290'><b></b>({d:friend_count})</font>"
"DOTA_FriendsCategory_PlayingDota"	"In Dota <font color='#ACEBA9'>({d:friend_count})</font>"
"DOTA_FriendsCategory_Online"	"Online <font color='#6a9dcc'>({d:friend_count})</font>"
"DOTA_FriendsCategory_Pending"	"In sospeso <font color='#eeee82'>({d:friend_count})</font>"
"DOTA_FriendsCategory_Offline"	"Offline <font color='#676666'>({d:friend_count})</font>"
"DOTA_Friends_Empty"	"La tua lista amici è vuota"
"DOTA_FriendsMenu_Tooltip_NoneReady"	"Amici"
"DOTA_UserName"	"{g:dota_persona:user_account_id}"
"DOTA_UserNamePro"	"{g:dota_persona_pro:user_account_id}"
"DOTA_UserNickname"	"{g:dota_persona_nickname:user_account_id}"
"DOTA_UserRichPresence"	"{s:user_rich_presence}"
"DOTA_ProfileCard_StatTitle_SoloRank"	"MMR da solo"
"DOTA_ProfileCard_StatTitle_PartyRank"	"MMR di gruppo"
"DOTA_ProfileCard_StatTitle_Wins"	"Vittorie"
"DOTA_ProfileCard_StatTitle_Commends"	"Elogi"
"DOTA_ProfileCard_StatTitle_GamesPlayed"	"Partite"
"DOTA_ProfileCard_StatTitle_FirstMatchDate"	"Prima partita"
"DOTA_ProfileCard_StatValue_Int"	"{d:stat_value}"
"DOTA_ProfileCard_StatValue_Date"	"{t:s:stat_value}"
"DOTA_ProfileCard_StatValue_String"	"{s:stat_value}"
"DOTA_ProfileCard_SlotTab_Trophies"	"Trofei"
"DOTA_ProfileCard_SlotTab_Items"	"Arsenale"
"DOTA_ProfileCard_SlotTab_Heroes"	"Eroi"
"DOTA_ProfileCard_SlotTab_Emoticons"	"Emoticon"
"DOTA_ProfileCard_NoTrophies"	"Nessun trofeo disponibile."
"DOTA_ProfileCard_NoItems"	"Nessun oggetto disponibile."
"DOTA_ProfileCard_HeroOnly"	"Solo l'Eroe"
"DOTA_ProfileCard_HeroShowWins"	"Mostra vittorie"
"DOTA_ProfileCard_HeroShowWinsAndLosses"	"Mostra vittorie e sconfitte"
"DOTA_ProfileCard_ItemSearchPrefix"	"Cerca:"
"DOTA_ProfileCard_ItemSearchPlaceholder"	"Oggetti per nome"
"DOTA_ProfileCard_ItemArmoryLink"	"Mostra tutto l'Arsenale"
"DOTA_HeroTooltip_HeroName"	"{s:hero_name}"
"DOTA_HeroTooltip_HeroRecord"	"{s:hero_wins_string}, {s:hero_losses_string}"
"DOTA_ProfileCard_HeroSearchPlaceholder"	"Cerca per nome dell'Eroe"
"DOTA_Wins_Singular"	"1 vittoria"
"DOTA_Wins_Plural"	"{d:hero_wins} vittorie"
"DOTA_Losses_Singular"	"1 sconfitta"
"DOTA_Losses_Plural"	"{d:hero_losses} sconfitte"
"DOTA_Profile_TotalGames"	"Partite totali"
"DOTA_Profile_Solo_MMR"	"MMR da solo"
"DOTA_Profile_Team_MMR"	"MMR di squadra"
"DOTA_Profile_Party_MMR"	"MMR di gruppo"
"DOTA_Profile_VictoryCount"	"Vittorie"
"DOTA_Profile_ProfilePage"	"Profilo"
"DOTA_Profile_TrophyPage"	"Trofei"
"DOTA_Profile_RecentGamesPage"	"Partite recenti"
"DOTA_Profile_HeroPage"	"Eroi"
"DOTA_Profile_PlayStyle"	"Stile di gioco"
"DOTA_Profile_MostRecent"	"Partite più recenti: {s:num_style_games}"
"DOTA_Profile_RecentActivity"	"Attività recente"
"DOTA_Profile_Fighting"	"Scontri"
"DOTA_Profile_Fighting_TooltipTitle"	"Scontri"
"DOTA_Profile_Fighting_Tooltip"	"Indica i giocatori che combattono spesso contro gli Eroi nemici."
"DOTA_Profile_Farming"	"Farm"
"DOTA_Profile_Farming_TooltipTitle"	"Farm"
"DOTA_Profile_Farming_Tooltip"	"Indica i giocatori che accumulano oro uccidendo i creep."
"DOTA_Profile_Supporting"	"Support"
"DOTA_Profile_Supporting_TooltipTitle"	"Support"
"DOTA_Profile_Supporting_Tooltip"	"Giocatori che assistono la loro squadra con guarigioni, Guardiani e altri oggetti."
"DOTA_Profile_Pushing"	"Pusher"
"DOTA_Profile_Pushing_TooltipTitle"	"Pusher"
"DOTA_Profile_Pushing_Tooltip"	"Giocatori che fanno pressione sulle torri nemiche per dare spazio ai compagni di squadra."
"DOTA_Profile_Versatility"	"Versatilità"
"DOTA_Profile_Versatility_TooltipTitle"	"Versatilità"
"DOTA_Profile_Versatility_Tooltip"	"Giocatori versatili che usano una grande varietà di Eroi."
"DOTA_Profile_Tooltip_Value"	"{s:CurrentStatValue}"
"DOTA_Profile_Tooltip_Comparison"	"{s:CurrentComparisonValue}"
"DOTA_Profile_StatsCompare"	"Confronta con le mie statistiche"
"DOTA_Profile_Self"	"Tu"
"DOTA_Profile_GPM"	"Media dell'Oro/min"
"DOTA_Profile_XPM"	"Media dell'Esp./min"
"DOTA_Profile_LH"	"Media dei colpi di gr."
"DOTA_Profile_Rampages"	"Scatenato"
"DOTA_Profile_TripleKills"	"Triple uccisioni"
"DOTA_Profile_FirstBled"	"Vittima del primo sangue"
"DOTA_Profile_CourierKills"	"Corrieri uccisi"
"DOTA_Profile_CreepStack"	"Campi ammassati"
"DOTA_Profile_GPMValue"	"{s:GPM}"
"DOTA_Profile_XPMValue"	"{s:XPM}"
"DOTA_Profile_LHValue"	"{s:LH}"
"DOTA_Profile_RampagesValue"	"{d:Rampages}"
"DOTA_Profile_TripleKillsValue"	"{d:TripleKills}"
"DOTA_Profile_FirstBloodValue"	"{d:FirstBlood}"
"DOTA_Profile_FirstBledValue"	"{d:FirstBled}"
"DOTA_Profile_CourierKillsValue"	"{d:CourierKills}"
"DOTA_Profile_AegisesValue"	"{d:Aegises}"
"DOTA_Profile_CheeseEatenValue"	"{d:CheeseEaten}"
"DOTA_Profile_CreepStackValue"	"{d:CreepStack}"
"DOTA_Profile_GPMLocalValue"	"{s:GPMLocal}"
"DOTA_Profile_XPMLocalValue"	"{s:XPMLocal}"
"DOTA_Profile_LHLocalValue"	"{s:LHLocal}"
"DOTA_Profile_RampagesLocalValue"	"{d:RampagesLocal}"
"DOTA_Profile_TripleKillsLocalValue"	"{d:TripleKillsLocal}"
"DOTA_Profile_FirstBloodLocalValue"	"{d:FirstBloodLocal}"
"DOTA_Profile_FirstBledLocalValue"	"{d:FirstBledLocal}"
"DOTA_Profile_CourierKillsLocalValue"	"{d:CourierKillsLocal}"
"DOTA_Profile_AegisesLocalValue"	"{d:AegisesLocal}"
"DOTA_Profile_CheeseEatenLocalValue"	"{d:CheeseEatenLocal}"
"DOTA_Profile_CreepStackLocalValue"	"{d:CreepStackLocal}"
"DOTA_RecentGames_Title"	"Partite recenti"
"DOTA_RecentGames_TimeStamp"	"Data/Ora"
"DOTA_RecentGames_HeroSelection"	"Eroe giocato"
"DOTA_RecentGames_GameResult"	"Risultato"
"DOTA_RecentGames_GameLength"	"Durata"
"DOTA_RecentGames_Team"	"Squadra"
"DOTA_RecentGames_GameType"	"Tipo"
"DOTA_RecentGames_Items"	"Oggetti"
"DOTA_RecentGame_Timestamp_Entry"	"{t:s:timestamp} {t:t:timestamp}"
"DOTA_RecentGame_Duration"	"{t:d:duration}"
"DOTA_RecentGame_Downloading"	"Download in corso ({s:DownloadPercent})"
"DOTA_RecentGame_Watch"	"Guarda il replay"
"DOTA_RecentGame_NoReplay"	"Nessun replay"
"DOTA_RecentGame_Expired"	"Replay non più disponibile"
"DOTA_RecentGame_Finding"	"Ricerca..."
"DOTA_RecentGame_Download"	"Scarica la partita"
"DOTA_RecentGame_Pending"	"Replay in sospeso"
"DOTA_RecentGame_Unavailable"	"Replay non disponibile"
"DOTA_RecentGame_MatchID"	"ID della partita: #{s:match_id}"
"DOTA_No_Team_Name"	"--"
"DOTA_TrophyCount"	"{d:trophy_count} trofeo"
"DOTA_TrophiesCount"	"{d:trophy_count} trofei"
"DOTA_TrophyCount_Number"	"{d:trophy_count}"
"DOTA_TrophyCount_NoNum"	"Trofeo"
"DOTA_TrophiesCount_NoNum"	"Trofei"
"DOTA_Trophies_ViewAll"	"Tutti"
"DOTA_TrophyName"	"{s:trophy_name}"
"DOTA_TrophyCategory"	"{s:trophy_category}"
"DOTA_TrophyDescription"	"{s:trophy_description}"
"DOTA_NextTrophy"	"Prossimo traguardo"
"DOTA_NewPlayerQuestion_Title"	"BENVENUTO SU DOTA 2"
"DOTA_PlayerOriginQuestion_Question"	"Per migliorare la tua esperienza di gioco, raccontaci qual è il tuo livello di esperienza di Dota 2 e di giochi simili:"
"DOTA_PlayerOriginQuestion_BeginnerButton"	"Sono un principiante."
"DOTA_PlayerOriginQuestion_RTSButton"	"Ho giocato a giochi di strategia in tempo reale."
"DOTA_PlayerOriginQuestion_MOBAButton"	"Ho giocato a un gioco simile a Dota 2."
"DOTA_PlayerOriginQuestion_Dota2Button"	"Ho giocato a Dota 2."
"DOTA_PlayerOriginQuestion_MOBAExplanation"	"Seleziona il gioco che conosci meglio:"
"DOTA_OtherGames_LOL"	"League of Legends"
"DOTA_OtherGames_DOTA"	"DotA 1"
"DOTA_OtherGames_HON"	"Heroes of Newerth"
"DOTA_OtherGames_Smite"	"Smite"
"DOTA_OtherGames_Other"	"Altro gioco"
"DOTA_PlayerOriginQuestion_ConfirmationButton"	"GIOCHIAMO"
"DOTA_PlayerOriginQuestion_ConfirmationTutorial"	"Come nuovo giocatore di Dota potresti essere interessato a giocare delle sessioni di allenamento, che puoi trovare cliccando sulla scheda \"Impara\". È il primo passo per diventare imbattibile."
"DOTA_PlayerOriginQuestion_ConfirmationSettings"	"I tasti assegnati e le opzioni sono impostati sulla configurazione tipica dei giocatori del tuo livello. Puoi personalizzare la configurazione facendo clic sull'icona delle impostazioni."
"DOTA_Tutorial_SkipButton"	"Salta il tutorial"
"DOTA_ConfirmSkip"	"Saltare l'introduzione a Dota 2?"
"DOTA_ConfirmSkipDesc"	"Sei sicuro di voler saltare il tutorial di Dota 2?"
"DOTA_Tutorial_Start_Quest"	"INIZIA LA MISSIONE"
"DOTA_Tutorial_Quest0_Title"	"MISSIONE 1"
"DOTA_Tutorial_Quest0_TitleDesc"	"EROE A DISTANZA"
"DOTA_Tutorial_Quest0DetailsDesc"	"Questa missione richiede\n circa 10 minuti."
"DOTA_Tutorial_QuestDetailsLearn"	"Cosa imparerai:"
"DOTA_Tutorial_Quest0DetailsLesson"	"Movimento dell'Eroe\nAumento di livello dell'Eroe\nUtilizzo di abilità\nOggetti\nCombattimento di base\nColpi di grazia"
"DOTA_Tutorial_Quest1_Title"	"MISSIONE 2"
"DOTA_Tutorial_Quest1_TitleDesc"	"COMBATTIMENTO IN CORSIA"
"DOTA_Tutorial_Quest1DetailsDesc"	"Questa missione richiede\n circa 10 minuti."
"DOTA_Tutorial_Quest1DetailsLesson"	"Combattimento a distanza\n Abilità con area d'effetto\nLa minimappa\nTorri\nI corrieri e la Scorta\nTeletrasporto"
"DOTA_Tutorial_Quest2_Title"	"MISSIONE 3"
"DOTA_Tutorial_Quest2_TitleDesc"	"COMBATTIMENTO IN CORSIA"
"DOTA_Tutorial_Quest2DetailsDesc"	"Questa missione richiede\n 10 o 15 minuti."
"DOTA_Tutorial_Quest2DetailsLesson"	"Combattimento in corsia\nAttacco e difesa delle torri\nOggetti di partenza"
"DOTA_Challenges_Title"	"Impara"
"DOTA_ChallengeGroup_0_Title"	"Meccaniche"
"DOTA_ChallengeGroup_1_Title"	"Partite guidate contro i bot"
"DOTA_ChallengeGroup_1_Desc"	"Inizia qui!"
"DOTA_ChallengeGroup_2_Title"	"Partite contro i bot"
"DOTA_ChallengeGroup_More"	"Altro in arrivo"
"DOTA_ChallengeGroup_Locked"	"Bloccato"
"DOTA_LearnMechanics_Title"	"Meccaniche"
"DOTA_LearnMechanics_SubTitle"	"Impara i concetti fondamentali di Dota: controllare un Eroe, usare il Negozio degli oggetti, guadagnare oro ed esperienza, e altro ancora. Se non hai mai giocato a un gioco come Dota, comincia da qui."
"DOTA_Mechanics_0_Title"	"Meccaniche 1"
"DOTA_Mechanics_0_Desc"	"Movimento dell'Eroe\nAumento di livello dell'Eroe\nUtilizzo di abilità\nOggetti\nCombattimento di base\nColpi di grazia"
"DOTA_Mechanics_1_Title"	"Meccaniche 2"
"DOTA_Mechanics_1_Desc"	"Combattimento a distanza\nAbilità con area d'effetto\nLa minimappa\nTorri\nI corrieri e la Scorta\nPergamente del Portale Cittadino"
"DOTA_LearnGuidedBotMatches_Title"	"Partite guidate contro i bot"
"DOTA_LearnGuidedBotMatches_SubTitle"	"Gioca una partita contro Eroi controllati dal computer per capire le meccaniche di Dota. Ti guideremo passo per passo per aiutarti a trasformare il tuo Eroe in una forza inarrestabile."
"DOTA_GuidedBotMatches_0_Title"	"Luna"
"DOTA_GuidedBotMatches_0_Desc"	"Attacco a distanza a breve gittata\nDanno d'attacco elevato\nVelocità di movimento alta\nModeratamente vulnerabile\nAttributo principale: Agilità"
"DOTA_GuidedBotMatches_1_Title"	"Sven"
"DOTA_GuidedBotMatches_1_Desc"	"Attacco da mischia\nIngenti danni in breve tempo\nMolto resistente\nVulnerabile ai rallentamenti\nAttributo principale: Forza"
"DOTA_GuidedBotMatches_2_Title"	"Lina"
"DOTA_GuidedBotMatches_2_Desc"	"Attacco a distanza a lunga gittata\nIngenti danni in breve tempo\nTempi di ricarica brevi\nMolto vulnerabile\nAttributo principale: Intelligenza"
"DOTA_LearnBotMatches_Title"	"Partite contro i bot"
"DOTA_LearnBotMatches_SubTitle"	"Fai pratica con gli Eroi controllati dal computer per allenarti in tutta tranquillità."
"DOTA_BotMatches_0_Title"	"Bot facili"
"DOTA_BotMatches_0_Desc"	"Ottima per imparare a giocare un nuovo Eroe."
"DOTA_BotMatches_1_Title"	"Bot normali"
"DOTA_BotMatches_1_Desc"	"Per fare un po' di riscaldamento."
"DOTA_BotMatches_2_Title"	"Bot difficili"
"DOTA_BotMatches_2_Desc"	"Per metterti alla prova."
"DOTA_BotMatches_3_Title"	"Bot folli"
"DOTA_BotMatches_3_Desc"	"Se vuoi farti del male."
"FileOpenDialog_Open"	"Apri"
"FileOpenDialog_Save"	"Salva"
"FileOpenDialog_Select"	"Seleziona"
"FileOpenDialog_FileType_Folder"	"Cartella"
"DOTA_FindMatch"	"Avvia la ricerca"
"DOTA_FindingMatch"	"Ricerca in corso ({s:find_match_time})"
"DOTA_FindMatchTime"	"{s:find_match_time}"
"DOTA_Searching"	"Ricerca"
"DOTA_StartSoloBotMatch"	"Avvia la partita contro i bot"
"DOTA_Create_Lobby"	"Crea lobby"
"DOTA_Join_Lobby"	"Unisciti"
"DOTA_LobbyStartGame"	"Inizia"
"DOTA_ReturnToLobby"	"Torna alla lobby"
"DOTA_FindMatchStatus"	"{s:searching_matchtype} / {s:searching_gamemodes} / {s:searching_region}"
"DOTA_FindGameModesMany"	"Modalità: "
"DOTA_FindRegionsMany"	"Regioni: "
"DOTA_GameMode_AllPick"	"All Pick"
"DOTA_GameMode_SingleDraft"	"Single Draft"
"DOTA_GameMode_CaptainsMode"	"Captains Mode"
"DOTA_GameMode_RandomDraft"	"Random Draft"
"DOTA_GameMode_AbilityDraft"	"Ability Draft"
"DOTA_GameMode_LeastPlayed"	"Least Played"
"DOTA_GameMode_AllRandom"	"All Random"
"DOTA_GameMode_LimitedHeroes"	"Eroi limitati"
"DOTA_GameMode_CaptainsDraft"	"Captains Draft"
"DOTA_GameMode_AllRandomDeathMatch"	"All Random Death Match"
"DOTA_ImmediatePurchase_SendFailed"	"Invio della richiesta di acquisto non riuscita. I server di Dota potrebbero essere offline. Ritenta l'acquisto più tardi."
"DOTA_ImmediatePurchase_Timeout"	"Il tempo d'attesa per la richiesta di acquisto è scaduto. Riprova più tardi."
"DOTA_ImmediatePurchase_InitFailed"	"Non riusciamo a iniziare l'acquisto su Perfect World. Riprova più tardi."
"DOTA_ImmediatePurchase_InsufficientFundsPW"	"Il credito del tuo account di Perfect World non basta per completare l'acquisto. Ricarica il tuo account e riprova."
"DOTA_ImmediatePurchase_Success_Title"	"Operazione riuscita"
"DOTA_ImmediatePurchase_Success_Text"	"Acquisto riuscito! Gli oggetti acquistati appariranno a breve nell'Arsenale."
"DOTA_ImmediatePurchase_Cancelled_Title"	"Annullato"
"DOTA_ImmediatePurchase_UnbundleTimeout"	"Il tempo d'attesa per la richiesta di apertura del pacchetto è scaduto. Riprova più tardi."
"DOTA_ImmediatePurchase_UnbundleFailure"	"Apertura del pacchetto non riuscita. Riprova più tardi."
"DOTA_ImmediatePurchase_LateCancel"	"L'acquisto è già stato annullato. Nessun addebito a tuo carico."
"DOTA_ConfirmPurchaseTitle"	"Conferma l'acquisto"
"DOTA_ConfirmPurchaseText"	"Acquistare questo oggetto?"
"DOTA_PurchaseInProgress_Title"	"Acquisto in corso"
"DOTA_PurchaseInProgress_Text"	"La richiesta di acquisto è in elaborazione."
"DOTA_UnbundleInProgress_Title"	"Apertura del pacchetto in corso"
"DOTA_UnbundleInProgress_Text"	"Stiamo aprendo il pacchetto."
"DOTA_ConfirmUnbundleTitle"	"Conferma l'apertura del pacchetto"
"DOTA_ConfirmUnbundleText"	"Devi aprire questo pacchetto per usare gli oggetti contenuti. Procedere?"
"DOTA_RequestingBalance_Title"	"Richiesta del saldo"
"DOTA_RequestingBalance_Text"	"Richiesta del saldo sull'account di Perfect World..."
"DOTA_PartnerPurchaseRecharge_Title"	"Ricarica del saldo"
"DOTA_PartnerPurchaseRecharge_Text"	"Ricarica del saldo del tuo account..."
"DOTA_PartnerPurchase_Purchase"	"{g:dota_item_price:item_def}"
"DOTA_PartnerPurchase_Recharge"	"Ricarica l'account"
"DOTA_PartnerPurchase_Balance"	"Saldo: {m:balance}"
"DOTA_PartnerRecharge_Close"	"Torna all'acquisto"
"RequestBalanceBadAccount"	"Richiesta del saldo dell'account non riuscita: account non trovato."
"RequestBalanceAccountNotLinked"	"Richiesta del saldo dell'account non riuscita: il tuo account non è collegato a Perfect World."
"RequestBalanceUnsupportedPartner"	"Richiesta del saldo dell'account non riuscita: il tuo account non è collegato a un partner riconosciuto."
"StoreCheckout_Error_Title"	"Errore"
"StoreCheckout_NoItems"	"Il tuo carrello è vuoto!"
"StoreCheckout_TooManyItems"	"Hai troppi oggetti nel carrello!"
"StoreCheckout_Loading"	"Pagamento alla cassa..."
"StoreCheckout_Unavailable"	"Cassa non disponibile al momento."
"StoreCheckout_Cancelling"	"Annullamento..."
"StoreCheckout_Fail"	"Il Negozio è chiuso."
"StoreCheckout_InvalidParam"	"C'è stato un problema! Il coordinatore del gioco ha ricevuto un parametro non valido. Ritenta l'acquisto."
"StoreCheckout_InternalError"	"Si è verificato un errore durante l'avvio o l'aggiornamento della transazione. Attendi un minuto e riprova, oppure contatta l'assistenza."
"StoreCheckout_ContactSupport"	"Si è verificato un errore durante la transazione. Contatta l'assistenza."
"StoreCheckout_NotApproved"	"Il coordinatore del gioco non è riuscito ad approvare la transazione su Steam. Ritenta l'acquisto più tardi."
"StoreCheckout_NotLoggedin"	"Devi eseguire l'accesso a Steam per completare l'acquisto."
"StoreCheckout_WrongCurrency"	"La valuta di questa transazione non corrisponde a quella del tuo Portafoglio."
"StoreCheckout_NoAccount"	"Il tuo account di Steam non è attualmente disponibile. Ritenta l'acquisto più tardi."
"StoreCheckout_InsufficientFunds"	"Non disponi di fondi sufficienti per completare l'acquisto."
"StoreCheckout_TimedOut"	"Tempo per la transazione scaduto. Ritenta l'acquisto."
"StoreCheckout_SteamAccountDisabled"	"Il tuo account di Steam è disabilitato e non può pertanto eseguire acquisti."
"StoreCheckout_SteamAccountNoPurchase"	"Le transazioni tramite il Portafoglio di Steam sono state disabilitate su questo account."
"StoreCheckout_OldPriceSheet"	"Il tuo elenco locale dei prodotti non è aggiornato. È in corso la richiesta di un elenco nuovo."
"StoreCheckout_TransactionNotFound"	"Il coordinatore del gioco non ha trovato l'ID di questa transazione. Ritenta l'acquisto."
"StoreCheckout_TransactionCancelled"	"Transazione annullata. Nessun addebito a tuo carico."
"StoreCheckout_TransactionCompleted"	"Transazione completata!\nGoditi il bottino!"
"StoreCheckout_CompleteButUnfinalized"	"Impossibile confermare l'operazione. Se è riuscita, gli oggetti verranno consegnati in seguito."
"StoreCheckout_NotEnoughRoom"	"Non hai abbastanza spazio nel tuo Arsenale per acquistare tutti questi oggetti."
"StoreCheckout_ContactSupport_Dialog_Title"	"Attenzione"
"StoreCheckout_ContactSupport_Dialog_Btn"	"Contatta"
"StoreCheckout_LimitedQuantityItemsUnavailable"	"Un oggetto che stai cercando di acquistare è esaurito o non è disponibile al momento."
"StoreCheckout_Nexon_InsufficientFunds"	"Non hai credito sufficiente per completare l'acquisto."
"StoreCheckout_Nexon_FundsLocked"	"Il blocco del denaro di Nexon è attivato."
"npc_dota_hero_abaddon_hype"	"Abaddon è in grado di trasformare gli attacchi nemici in cure che lo aiutano a sopravvivere alla maggior parte degli assalti. È sempre pronto a lanciarsi nelle battaglie più dure, proteggendo gli alleati con il suo scudo e utilizzando la spirale alimentata dalla sua salute per guarire gli alleati o ferire i nemici."
"npc_dota_hero_alchemist_hype"	"Alchemist può sintetizzare risorse extra dalle uccisioni procurandosi gli strumenti necessari per distruggere i nemici. Grazie alle imboscate con uso di acidi corrosivi e miscugli instabili, continua a scorrazzare indisturbato."
"npc_dota_hero_ancient_apparition_hype"	"Grazie alla sua esplosione glaciale a gittata globale, Ancient Apparition è temutissimo dai nemici indeboliti, ovunque si trovino. La sua abilità di rallentare i nemici rafforzando gli alleati si rivela preziosa in battaglia."
"npc_dota_hero_antimage_hype"	"Se Anti-Mage riesce a raggiungere il pieno delle forze, pochi possono fermarlo. I suoi attacchi che bruciano il mana dei nemici ad ogni colpo e il teletrasporto con il quale sfugge alle imboscate lo rendono un bersaglio difficile da mettere alle strette."
"npc_dota_hero_axe_hype"	"Axe falcia i nemici. Quando va incontro agli avversari, contrattacca roteando la sua ascia letale. È sempre pronto a massacrare i nemici indeboliti."
"npc_dota_hero_bane_hype"	"Bane terrorizza i nemici con le sue abilità disabilitanti, che gli permettono di intrappolare un avversario in un incubo contagioso o di immobilizzarlo con una stretta maligna, lasciando agli alleati tutto il tempo necessario per procedere al massacro."
"npc_dota_hero_batrider_hype"	"Una volta preso il volo, Batrider può colpire da ogni direzione. Dopo aver imprigionato un nemico nel suo lazo, sorvola le cime degli alberi e trascina la propria preda in un mare di fiamme, verso i suoi compagni di squadra bramosi di sangue."
"npc_dota_hero_beastmaster_hype"	"Grazie al suo cinghiale velenoso e al falco che lo aiuta nella caccia, Beastmaster non è mai impreparato quando solca il campo di battaglia. Facendosi strada nella foresta con le asce, guida i propri alleati verso i nemici, che stordisce con il suo potente ruggito."
"npc_dota_hero_bloodseeker_hype"	"Bloodseeker obbliga i nemici a compiere scelte difficili. Grazie al suo pericoloso rituale e alla sua ultimate sanguinolenta, egli impone ai nemici di restare immobili o di correre verso la propria morte."
"npc_dota_hero_bounty_hunter_hype"	"Sgattaiolando alle spalle dei nemici, Bounty Hunter riesce a tenere traccia della loro posizione. E se uno dei suoi bersagli dovesse morire in battaglia, lui e i suoi alleati ne trarrebbero un bel gruzzolo."
"npc_dota_hero_brewmaster_hype"	"Brewmaster è un temibile avversario che può stravolgere le sorti di una battaglia dividendosi in tre spiriti elementali, ognuno con le proprie abilità uniche. Quando non è diviso, può travolgere i nemici con una devastazione di rallentamenti e potenti colpi del suo mazzafrusto."
"npc_dota_hero_bristleback_hype"	"Quando è ora di combattere, Bristleback è pronto a spaccarsi la schiena. Riducendo tutti i danni provenienti da dietro di lui o dai fianchi, egli entra in battaglia con poche preoccupazioni, ricoprendo i nemici di dannosi aculei e muco rallentante."
"npc_dota_hero_broodmother_hype"	"Broodmother si cela tra le sue tele mentre dà vita ad un esercito di ragni per guidare le forze alleate verso la base nemica. E se un nemico si dovesse aggirare nei paraggi, lei unisce le forze a quelle dei suoi piccoli per attaccare, rallentando la preda con morsi incapacitanti per saziare la sua fame senza limiti."
"npc_dota_hero_centaur_hype"	"Centaur Warrunner sa come infliggere e assorbire i danni. Guidando la carica in battaglia, può stordire i nemici con i suoi pestoni e contrastare ogni loro colpo. Il suo travolgimento rende più veloci gli alleati in combattimento e in fuga, dando la carica al massacro."
"npc_dota_hero_chaos_knight_hype"	"Chaos Knight è un esercito di un solo uomo. È in grado di evocare un'armata di cloni per demolire le difese nemiche, e se un avversario dovesse pararglisi davanti può squarciare la realtà per spingere se stesso e le sue illusioni abbastanza vicino da infliggere una letale serie di colpi."
"npc_dota_hero_chen_hype"	"Potendo convertire le creature della foresta alla propria causa, Chen guida il suo esercito di voltafaccia per aiutare gli alleati in battaglia. Può assalire i nemici con le sue belve, dando tempo agli alleati di mettersi in salvo. E quando le cose si mettono male può curare gli amici ovunque si trovino."
"npc_dota_hero_clinkz_hype"	"Quando Clinkz solca il campo di battaglia celato dall'invisibilità, nessuno è al sicuro. Veloce di passo e di freccia, egli può scagliare una pioggia infuocata di morte sui nemici, per poi ritirarsi e assorbire la forza vitale dalle creature della foresta prima dell'assalto successivo."
"npc_dota_hero_rattletrap_hype"	"Grazie al rampino con cui si lancia verso i nemici e ai suoi razzi segnalatori, che gli permettono di perlustrare il campo di battaglia, Clockwerk non ha mai problemi a trovare bersagli isolati da fare a pezzi con le sue schegge disorientanti."
"npc_dota_hero_crystal_maiden_hype"	"Riuscendo a mantenere i propri alleati riforniti di mana e a rallentare i suoi nemici per assicurarne la sconfitta, Crystal Maiden è un prezioso elemento in ogni squadra. E quando dovesse presentarsi l'occasione, può scatenare la sua potente ultimate per spazzare via gli avversari."
"npc_dota_hero_dark_seer_hype"	"Versatile e strategico, Dark Seer sa manipolare perfettamente la posizione dei nemici. Risucchiandoli verso i propri alleati pronti ad attaccare, può inoltre scatenare la forza degli avversari verso loro stessi trascinandoli verso il suo muro di repliche."
"npc_dota_hero_dazzle_hype"	"Dazzle è nato per aiutare i compagni in battaglia, riuscendo a tenere in vita gli alleati feriti per permettere loro di sbaragliare i nemici. Le sue arti arcane interagiscono con le armature, indebolendo quelle nemiche e rafforzando quelle degli alleati."
"npc_dota_hero_death_prophet_hype"	"Death Prophet eccelle nel disintegrare i nemici e le loro difese grazie all'abilità di evocare un esercito di spiriti. Vedendola alla guida della sua squadra negli attacchi verso la base nemica e aprendo la strada con i suoi sciami devastanti si ha l'impressione che nulla possa fermare i suoi assalti."
"npc_dota_hero_disruptor_hype"	"Disruptor può mandare in fumo con facilità i piani dei suoi nemici, intrappolandoli con la sua barriera insuperabile, ammutolendoli con la sua tempesta e teletrasportando indietro chiunque riesca inizialmente ad evitare la sua trappola."
"npc_dota_hero_doom_bringer_hype"	"Doom riesce sempre ad annientare i propri nemici, in un modo o nell'altro. Può divorare i creep per far sue le abilità che questi avevano in vita, ammutolire i propri avversari e impedire loro inoltre l'utilizzo degli oggetti grazie alla sua ultimate, potendo così bruciarli in tutta calma."
"npc_dota_hero_dragon_knight_hype"	"Dragon Knight incute timore in chiunque lo affronti assumendo una terrificante forma di drago. Potente e versatile, può stordire i suoi nemici e bruciare tutto ciò che si trova di fronte a sé, spesso dando lo slancio necessario ai suoi alleati per avanzare verso la vittoria."
"npc_dota_hero_drow_ranger_hype"	"Non sono in molti a poter sfuggire agli attacchi di Drow Ranger. Può ammutolire i suoi nemici con una gelida folata per poi finirli con una raffica di frecce letali dalla punta di ghiaccio."
"npc_dota_hero_earth_spirit_hype"	"Earth Spirit alimenta la confusione nei ranghi nemici lanciandogli contro i suoi residui di pietra per intralciarli ammutolendoli o stordendoli, o usando la sua presa geomagnetica per riacchiappare un alleato dalle fauci della morte."
"npc_dota_hero_earthshaker_hype"	"Che si tratti di bloccare la fuga dei nemici, dividere le loro forze o frantumare il terreno sotto i loro piedi, Earthshaker dà il meglio di sé quando colpisce senza preavviso. Chi sopravvive alle scosse deve vedersela con i colpi del suo totem."
"npc_dota_hero_elder_titan_hype"	"Mandando in avanguardia il suo spirito astrale, Elder Titan può colpire da qualunque direzione, investendo i suoi avversari con il pestone del suo zoccolo mentre la sua presenza da sola basta a intaccare le loro difese, permettendogli di abbatterli con facilità spaccandogli la terra sotto i piedi."
"npc_dota_hero_ember_spirit_hype"	"Rapido e sfuggente, Ember Spirit colpisce tutti i nemici nelle vicinanze in rapida successione, e li intrappola con delle catene infuocate. Schizzando in un battibaleno verso uno dei suoi residui esplosivi per raggiungere una battaglia in corso, in pochi possono pensare di fuggire o catturare la sua fiamma."
"npc_dota_hero_enigma_hype"	"Enigma è temutissimo per la sua ultimate, un buco nero capace di intrappolare le forze nemiche per permettere agli alleati di massacrarle. La presenza costante dei suoi spettri lo assiste negli attacchi a distanza contro i suoi avversari."
"npc_dota_hero_faceless_void_hype"	"Il tempo è essenziale per Faceless Void. Ne velocizza lo scorrere per scattare da un posto all'altro, lo manipola per schivare gli attacchi, lo ferma in una vasta area per devastare i nemici e con le giuste risorse può rendersi incredibilmente pericoloso."
"npc_dota_hero_gyrocopter_hype"	"Con tutta la potenza di fuoco a sua disposizione, Gyrocopter plana sulla battaglia. Riducendo a brandelli tutti i nemici vicini col suo cannone o tempestandoli con le sue salve di razzi, se riuscirà a diventare abbastanza forte non avrà problemi a fare piazza pulita dei suoi avversari."
"npc_dota_hero_huskar_hype"	"L'abilità di massacrare i nemici di Huskar cresce al calare della sua salute. In grado di rimuovere una parte della sua salute e di quella di un avversario con la sua ultimate, è anche capace di scatenare una raffica di lance ardenti di velocità devastante quando è in punto di morte."
"npc_dota_hero_jakiro_hype"	"Jakiro è il migliore amico di se stesso. I gemelli, non contenti di incendiare i nemici, li congelano sul posto, immobilizzandoli mentre bruciano. E una volta inceneriti gli avversari, questo duo può infliggere danni enormi alle strutture con il suo fuoco liquido."
"npc_dota_hero_juggernaut_hype"	"In un turbinio di fendenti, Juggernaut abbatte i suoi nemici. Scattando e volteggiando in battaglia con noncuranza, e quasi invincibile una volta che è in grado di lanciarsi all'assalto, fermarlo si rivelerà tanto difficile quanto sopravvivergli."
"npc_dota_hero_keeper_of_the_light_hype"	"Keeper of the Light è un elemento prezioso in ogni situazione. Egli è in grado di manipolare il mana di alleati e nemici, e può inoltre distruggere senza sforzo i suoi avversari più deboli con le onde di luce, per poi entrare nella forma spirituale e riunire la squadra in preparazione per l'assalto."
"npc_dota_hero_kunkka_hype"	"Kunkka ha la fissa di predire dove andranno i suoi nemici. In grado di attaccare un punto del campo di battaglia usando un getto d'acqua o il relitto di una nave fantasma, dovessero le sue previsioni rivelarsi corrette, lui e i suoi alleati non avranno problemi a ripulire quel poco che sarà rimasto dei loro avversari."
"npc_dota_hero_legion_commander_hype"	"Marciando per tutto il campo di battaglia, Legion Commander sfida i nemici a singolar tenzone. Ciascun duello vinto aumenterà la potenza dei suoi attacchi, finché alla fine ella stessa sarà il solo esercito di cui avrà bisogno."
"npc_dota_hero_leshrac_hype"	"I potenti incantesimi di Leshrac si abbattono sui suoi nemici con la stessa violenza che sgretola le loro difese. Spingendosi in profondità in territorio avverso col suo devastante editto, con il giusto tempismo è in grado di stordire gli avversari spaccandogli la terra sotto i piedi, dando la possibilità ai suoi alleati di finirli."
"npc_dota_hero_lich_hype"	"Muovendosi di battaglia in battaglia, e sacrificando i creep per alimentare i propri assalti, Lich aiuta gli alleati a distruggere i nemici con i suoi poteri glaciali rallentanti. E se i suoi avversari si rivelassero così stupidi da riunirsi in gruppo, la sua ultimate assicurerebbe la loro dipartita."
"npc_dota_hero_life_stealer_hype"	"Quando Lifestealer ha raggiunto la sua preda, c'è ben poco che possa salvarla. Viaggiando nascosto in un creep o in un Eroe alleato, erutterà fuori dal suo corpo ospite per sorprendere i suoi nemici e farli a pezzi coi suoi artigli."
"npc_dota_hero_lina_hype"	"Lina, tanto letale quanto vulnerabile, può annientare facilmente qualunque nemico che incautamente si faccia sorprendere da solo. Grazie alla velocità d'attacco aggiuntiva ottenuta ad ogni magia lanciata, in pochi riusciranno a sopravvivere alle sue fiammate e ai suoi fulmini brucianti."
"npc_dota_hero_lion_hype"	"Lion concede ai suoi nemici poche possibilità di reazione, stordendo gli avversari con i suoi spuntoni di roccia o trasformandoli temporaneamente in bestiole innocue per fornire tutto il tempo necessario a sé e ai suoi alleati a procedere ad un tranquillo massacro, nel caso in cui le sue potenti magie da sole non fossero sufficienti."
"npc_dota_hero_lone_druid_hype"	"Lottando fianco a fianco con il suo potente spirito orso, Lone Druid abbatte le forze e le strutture nemiche. Potendo trasformarsi a piacimento per attaccare in mischia o dalla distanza, dovesse riuscire ad avere abbastanza tempo per armare se stesso e il suo fedele compagno, ci sarà poco che potrà fermarli."
"npc_dota_hero_lycan_hype"	"Da uomo o da lupo, Lycan devasta i suoi nemici con artigli affilati e fauci letali, evocando i suoi fedeli e furtivi lupi per mandarli in ricognizione o per assalire i malcapitati che trovano. La sua trasformazione gli dona la forza e la velocità necessarie per cacciare le sue prede o per scappare a un'imboscata."
"npc_dota_hero_omniknight_hype"	"Omniknight è un protettore di prima linea sempre ansioso di unirsi alla sua squadra in battaglia. È dedito a proteggere i suoi alleati, curandoli con un'abilità che danneggia al contempo i nemici vicini, minacciandoli anche con i colpi del suo pesante martello."
"npc_dota_hero_queenofpain_hype"	"Queen of Pain colpisce senza avvertimento, distruggendo i nemici raggruppati con urla assordanti. E se un nemico dovesse sopravvivere al massacro, il pugnale rallentante ne ostacolerebbe la fuga senza lasciargli scampo."
"npc_dota_hero_sand_king_hype"	"Non sono in molti a sopravvivere ad un'imboscata di Sand King. In grado di demolire ogni cosa lo circondi con le letali onde vibranti della sua ultimate, può inoltre sfuggire ai contrattacchi nascondendosi in una tempesta di sabbia per poi stordire i nemici colpendoli dal sottosuolo."
"npc_dota_hero_skywrath_mage_hype"	"Letale e fragile allo stesso tempo, Skywrath Mage distrugge velocemente i suoi nemici con una potente raffica magica. Ammutolisce i suoi avversari rendendoli inoltre più vulnerabili alle magie, facilitandosi dunque il compito di annientare chiunque gli si opponga."
"npc_dota_hero_slark_hype"	"Slark eccelle nel balzare nel bel mezzo dell'azione per poi sgusciarne via all'occorrenza. Si muove velocemente non appena un nemico si trovi da solo, lo blocca sul posto e ne ruba parte dell'essenza a ogni taglio della sua lama, ed è sempre pronto a scomparire se le carte in tavola dovessero cambiare."
"npc_dota_hero_sniper_hype"	"La morte a distanza è la specialità di Sniper. Tiene i nemici sulle spine con una costante raffica di fuoco, e quando il momento è giusto li finisce con un colpo letale."
"npc_dota_hero_tinker_hype"	"Tinker demolisce i nemici con ondate di macchine e con i suoi aggeggi letali. Nel caso in cui riesca ad ottenere tutte le risorse necessarie, il potere di azzerare l'attesa delle sue abilità gli permette di guidare la propria squadra su ogni fronte."
"npc_dota_hero_troll_warlord_hype"	"Potendo passare istantaneamente dagli attacchi da mischia a quelli a distanza, Troll Warlord è efficace ovunque si trovi. Può ruotare vorticosamente le sue asce per colpire e confondere i nemici, farli a pezzi con una serie di attacchi sempre più veloci o velocizzare gli assalti suoi e dei suoi alleati ovunque si trovino."
"npc_dota_hero_ursa_hype"	"Con ogni colpo d'artiglio, Ursa rende l'avversario più vulnerabile all'attacco successivo. Potendo aumentare brevemente la velocità delle sue artigliate e rallentare i nemici vicini, riesce a sbarazzarsi degli avversari in men che non si dica."
"npc_dota_hero_venomancer_hype"	"Venomancer porta i suoi nemici verso una morte lenta e dolorosa grazie al suo esercito infinito di guardiani sputa-veleno che lo aiutano a difendere il suo territorio e alla sua gigantesca nuvola di veleno in caso dovessero avvicinarsi avversari più potenti."
"npc_dota_hero_witch_doctor_hype"	"Witch Doctor può ricoprire vari ruoli: aiutare i compagni con le cure nel tempo, stordire e maledire i nemici per assicurarne la sconfitta o distruggerli lui stesso ballando per evocare la sua ultimate. Pochi sono versatili come Witch Doctor."
"DOTA_AbilityTooltip_Name"	"{s:name}"
"DOTA_AbilityTooltip_Level"	"Livello {s:level}"
"DOTA_AbilityTooltip_TargetType"	"USABILE SU: {s:targettype}"
"DOTA_AbilityTooltip_CastType"	"TIPO DI ABILITÀ: {s:casttype}"
"DOTA_AbilityTooltip_DamageType"	"TIPO DI DANNO: {s:damagetype}"
"DOTA_AbilityTooltip_SpellImmunityType"	"IMMUNITÀ AGLI INCANTESIMI: {s:spellimmunity}"
"DOTA_AbilityTooltip_Description"	"{s:description}"
"DOTA_AbilityTooltip_ScepterDescription"	"{s:scepterdescription}"
"DOTA_AbilityTooltip_ExtraDescription"	"{s:extradescription}"
"DOTA_AbilityTooltip_Attributes"	"{s:attributes}"
"DOTA_AbilityTooltip_Cooldown"	"{s:cooldown}"
"DOTA_AbilityTooltip_ManaCost"	"{s:manacost}"
"DOTA_AbilityTooltip_Lore"	"{s:lore}"
"DOTA_AbilityTooltip_UpgradeLevel"	"Prossimo miglioramento al livello {d:upgradelevel}"
"DOTA_AbilityTooltip_BuildHeader"	"Guida all'abilità"
"DOTA_AbilityTooltip_BuildComment"	"{s:buildcomment}"
"DOTA_PersonaTooltip_Title"	"{g:dota_persona:account_id}"
"DOTA_PersonaTooltip_TitlePro"	"{g:dota_persona_pro:account_id}"
"DOTA_PendingInvites"	"Inviti ai gruppi"
"DOTA_PendingInvitesTooltip_None"	"Nessun invito in sospeso"
"DOTA_PendingInvitesTooltip_1"	"1 invito in sospeso"
"DOTA_PendingInvitesTooltip_N"	"{d:pending_invite_count} inviti in sospeso"
"DOTA_PendingInvitesTooltip_Leader"	"Clicca per gestire gli inviti."
"DOTA_PendingInvitesTooltip_NonLeader"	"Clicca per vedere gli inviti."
"DOTA_PendingInvitesCancelAll"	"Elimina tutti gli inviti"
"DOTA_PendingInvitesNotPartyLeader"	"Solo il leader del gruppo può gestire gli inviti"
"DOTA_ChatTab_NotInChannelMessage"	"Non ti sente nessuno."
"DOTA_ChatTab_ToggleGlobal"	"Mostra i messaggi di questo canale in tutte le schede."
"DOTA_ChatTab_Close"	"Chiudi questa scheda."
"DOTA_ChatTab_Leave"	"Esci da questo canale."
"DOTA_JoinChatChannel_Title"	"Unisciti al canale"
"DOTA_JoinChatChannel_Description"	"Crea un canale di chat o unisciti a uno esistente."
"DOTA_JoinChatChannel_AddToCurrentTab"	"Aggiungi alla scheda \"{s:current_tab_name}\""
"DOTA_JoinChatChannel_CreateNewTab"	"Crea una nuova scheda:"
"DOTA_Chat_ChannelName"	"{s:channel_name}"
"DOTA_Chat_ChannelMemberCount_Singular"	"1 membro"
"DOTA_Chat_ChannelMemberCount_Plural"	"{d:channel_member_count} membri"
"DOTA_EditChatTab_Title"	"Modifica la scheda di chat"
"DOTA_EditChatTab_Description"	"Scegli quali messaggi mostrare in questa scheda."
"DOTA_EditChatTab_AddNewChannel"	"Aggiungi un nuovo canale..."
"DOTA_EditChatTab_TabName"	"Nome della scheda:"
"DOTA_EditChatTab_ChannelToggleDisabled"	"{s:target} deve essere presente in almeno una scheda."
"DOTA_EditChatTab_Target"	"{s:target}"
"DOTA_Chat_TimestampFormat"	"{t:t:timestamp}"
"DOTA_Chat_Autocomplete_Title"	"{s:autocomplete_title}"
"DOTA_Chat_Autocomplete_NoMatches"	"Nessuna partita"
"DOTA_Chat_Autocomplete_WhisperFriends"	"Sussurra a un amico"
"DOTA_Chat_Autocomplete_InviteFriends"	"Invita un amico"
"DOTA_Chat_Autocomplete_Channels"	"Canali"
"DOTA_Chat_Autocomplete_Commands"	"Comandi"
"DOTA_Chat_Autocomplete_CommandName"	"/{s:command_name}"
"DOTA_Chat_Autocomplete_CommandDescription"	"{s:command_description}"
"dota_suggest_invite_format"	"Invita {s:invite_persona} nel gruppo."
"dota_suggest_invite_format_leader"	"Invita {s:invite_persona} nel gruppo. (<a href=\"event:DOTAInviteToParty({s:invite_persona_steamid})\" class=\"InviteButton\">Invita</a>)"
"dota_suggest_invite_format_lobby"	"Invita {s:invite_persona} nella lobby."
"dota_suggest_invite_format_lobby_leader"	"Invita {s:invite_persona} nella lobby. (<a href=\"event:DOTAInviteToLobby({s:invite_persona_steamid})\" class=\"InviteButton\">Invita</a>)"
"DOTA_ChatTarget_Format_Default"	"{s:target}"
"DOTA_ChatTarget_Prompt_Default"	"A ({s:target}):"
"DOTA_ChatTarget_Format_Whisper"	"{s:persona}"
"DOTA_ChatTarget_Prompt_Whisper"	"A [{s:persona}]:"
"DOTA_ChatTarget_Party"	"Gruppo"
"DOTA_ChatTarget_Lobby"	"Lobby"
"DOTA_ChatTarget_Team"	"Squadra"
"DOTA_ChatTarget_Guild"	"Gilda"
"DOTA_ChatTarget_Fantasy"	"FantaDota"
"DOTA_ChatTarget_Console"	"Console"
"DOTA_ChatTarget_Whisper"	"Sussurri"
"DOTA_ChatTarget_Invalid"	"Nessun canale"
"DOTA_ChatTarget_GameAll"	"Tutti"
"DOTA_ChatTarget_GameAllies"	"Alleati"
"DOTA_ChatTarget_GameCoaching"	"Mentore/allievi"
"DOTA_ChatTarget_GameSpectator"	"Spettatori"
"DOTA_ChatTargetMenu_Title"	"{s:target}"
"DOTA_ChatTargetMenu_ToggleEnabled"	"{s:toggle_enabled}"
"DOTA_ChatTargetMenu_NotActive"	"(Inattivo)"
"DOTA_Chat_Placeholder"	"Scrivi qui il tuo messaggio di chat. Digita \"/\" per mostrare i comandi."
"DOTA_Chat_MissedMessages"	"{s:missed_message_count}"
"DOTA_ChatCommand_Party"	"p"
"DOTA_ChatCommand_Party_Name"	"Gruppo"
"DOTA_ChatCommand_Party_Description"	"Parla con i giocatori del tuo gruppo."
"DOTA_ChatCommand_Lobby"	"l"
"DOTA_ChatCommand_Lobby_Name"	"Lobby"
"DOTA_ChatCommand_Lobby_Description"	"Parla con i giocatori della lobby."
"DOTA_ChatCommand_Channel"	"c"
"DOTA_ChatCommand_Channel_Name"	"Canale"
"DOTA_ChatCommand_Channel_Description"	"Parla con i giocatori di un canale di chat specifico."
"DOTA_ChatCommand_Whisper"	"w"
"DOTA_ChatCommand_Whisper_Name"	"Sussurra"
"DOTA_ChatCommand_Whisper_Description"	"Invia un messaggio privato a un amico."
"DOTA_ChatCommand_Reply"	"r"
"DOTA_ChatCommand_Reply_Name"	"Rispondi"
"DOTA_ChatCommand_Reply_Description"	"Rispondi a chi ti ha inviato il sussurro più recente."
"DOTA_ChatCommand_Help"	"?"
"DOTA_ChatCommand_Help_Name"	"Aiuto"
"DOTA_ChatCommand_Help_Description"	"Apre la finestra di aiuto per i comandi di chat."
"DOTA_ChatCommand_InviteToParty"	"partyinvite"
"DOTA_ChatCommand_InviteToParty_Name"	"Invita nel gruppo"
"DOTA_ChatCommand_InviteToParty_Description"	"Invita un amico a unirsi al tuo gruppo."
"DOTA_ChatCommand_LeaveParty"	"leaveparty"
"DOTA_ChatCommand_LeaveParty_Name"	"Esci dal gruppo"
"DOTA_ChatCommand_LeaveParty_Description"	"Ti fa uscire dal gruppo."
"DOTA_ChatCommand_JoinChannel"	"joinchannel"
"DOTA_ChatCommand_JoinChannel_Name"	"Unisciti al canale"
"DOTA_ChatCommand_JoinChannel_Description"	"Unisciti a un canale di chat o creane uno nuovo."
"DOTA_ChatCommand_LeaveChannel"	"leavechannel"
"DOTA_ChatCommand_LeaveChannel_Name"	"Esci dal canale"
"DOTA_ChatCommand_LeaveChannel_Description"	"Ti fa uscire da un certo canale di chat."
"DOTA_ChatCommand_GameAll"	"all"
"DOTA_ChatCommand_GameAll_Name"	"Tutti"
"DOTA_ChatCommand_GameAll_Description"	"Parla con tutti i giocatori della partita."
"DOTA_ChatCommand_GameAllies"	"allies"
"DOTA_ChatCommand_GameAllies_Name"	"Alleati"
"DOTA_ChatCommand_GameAllies_Description"	"Parla con i tuoi alleati."
"DOTA_ChatCommand_GameCoaching"	"coach"
"DOTA_ChatCommand_GameCoaching_Name"	"Mentore/allievi"
"DOTA_ChatCommand_GameCoaching_Description"	"Parla con gli allievi o il mentore."
"DOTA_ChatCommand_GameSpectator"	"spectator"
"DOTA_ChatCommand_GameSpectator_Name"	"Spettatori"
"DOTA_ChatCommand_GameSpectator_Description"	"Parla con gli altri spettatori."
"DOTA_ChatCommand_Clear"	"clear"
"DOTA_ChatCommand_Clear_Name"	"Cancella"
"DOTA_ChatCommand_Clear_Description"	"Cancella tutti i messaggi visibili nella scheda scelta."
"DOTA_Chat_UnknownCommandMessage"	"Comando di chat \"{s:chat_command}\" non riconosciuto"
"DOTA_ChatHelp_Targets"	"Destinatari"
"DOTA_ChatHelp_Commands"	"Comandi"
"DOTA_ChatHelp_NameFormat"	"{s:command_name}:"
"DOTA_ChatHelp_CommandFormat"	"/{s:command}"
"DOTA_Chat_JoinedParty"	"Unito al gruppo: {s:party_members}"
"DOTA_Chat_LeftParty"	"Il gruppo è stato sciolto."
"DOTA_Chat_MemberJoinedParty"	"{s:party_members} si è unito al gruppo"
"DOTA_Chat_MemberLeftParty"	"{s:party_members} è uscito dal gruppo"
"DOTA_Chat_InvitedToJoinParty"	"{s:party_members} è stato invitato nel gruppo"
"DOTA_Chat_RequestedToJoinParty"	"{s:party_members} ha chiesto di unirsi al gruppo"
"DOTA_Chat_PartyMemberSeparator"	", "
"DOTA_Feature_Under_Construction_Title"	"In fase di sviluppo"
"DOTA_Feature_Under_Construction_Text"	"Questa funzionalità è in fase di sviluppo e non è ancora disponibile."
"DOTA_Treasure_Purchase_Under_Construction_Text"	"Al momento è possibile acquistare tesori solo tramite il negozio di Dota. I set acquistabili della lista sono sulla sinistra."
"DOTA_Marketplace_Purchase_Under_Construction_Text"	"Al momento non è possibile acquistare dal Mercato, ma solo tramite il negozio di Dota. I set acquistabili della lista sono sulla sinistra."
"DOTA_PartyJoinRequest_Title"	"Richiesta di unione al gruppo"
"DOTA_PartyJoinRequest_Description"	"{g:dota_persona:b:inviter} chiede di unirsi al tuo gruppo."
"DOTA_PartyMergeRequest_Title"	"Richiesta di fusione dei gruppi"
"DOTA_PartyMergeRequest_Description"	"{g:dota_persona:b:inviter} chiede di unire il suo gruppo al tuo."
"DOTA_PartyMergeRequestLowPriWarning"	"Nota: se accetti la richiesta il tuo gruppo potrà cercare solo partite a bassa priorità."
"DOTA_PartyInvite_Title"	"Invito nel gruppo"
"DOTA_Invite_IOfN"	"{d:received_invite_index} di {d:received_invite_count}"
"DOTA_PartyInvite_Description"	"{g:dota_persona:b:inviter} ti ha invitato in un gruppo."
"DOTA_PartyInvite_LowPriority_Title"	"Invito nel gruppo a bassa priorità"
"DOTA_PartyInvite_LowPriority_Description"	"{g:dota_persona:b:inviter} ti ha invitato in un gruppo a bassa priorità."
"DOTA_PartyInvite_BlockPartyLeader"	"Blocca tutte le comunicazioni da {g:dota_persona:b:inviter}"
"DOTA_LobbyInvite_BlockInviter"	"Blocca tutte le comunicazioni da questo giocatore"
"DOTA_PartyInvite_BlockNonFriendInvites"	"Blocca gli inviti di giocatori non presenti nella tua lista amici"
"DOTA_PartyInvite_BlockNonFriendInvitesDescription"	"Puoi cambiarla nell'area Opzioni/Profilo delle impostazioni"
"DOTA_PartyInvite_Expired"	"La richiesta è stata revocata o non è più valida."
"DOTA_PartyInvite_Coach"	"Mentore:"
"DOTA_PartyVisTooltip_TitleOpen"	"In cerca di altri giocatori"
"DOTA_PartyVisTooltip_TitleNotOpen"	"Non sei alla ricerca di altri giocatori per il gruppo"
"DOTA_PartyVisTooltip_SoloNotOpen"	"Clicca qui per cambiare lo stato."
"DOTA_PartyVisTooltip_SoloOpen"	"Gli amici possono chiedere di unirsi al gruppo.<br/>Clicca qui per cambiare lo stato."
"DOTA_PartyVisTooltip_LeaderOpen"	"Le richieste di unirsi a un gruppo da parte di amici dei giocatori vengono accettate automaticamente.<br/>Clicca qui per bloccare l'accesso al gruppo."
"DOTA_PartyVisTooltip_LeaderOpenManualAccept"	"Gli amici dei giocatori possono chiedere di unirsi al gruppo.<br/>Clicca qui per bloccare l'accesso al gruppo."
"DOTA_PartyVisTooltip_LeaderNotOpen"	"Gli amici dei giocatori possono chiedere di unirsi al gruppo.<br/>Clicca qui per aprire l'accesso al gruppo, rendendolo più visibile agli amici."
"DOTA_PartyVisTooltip_NotOpenHidden"	"Le tue impostazioni della privacy impediscono ai tuoi amici di vedere questo gruppo.<br/>Nota: altri membri del gruppo potrebbero però permettere ai loro amici di vedere il gruppo e di unirsi."
"DOTA_PartyVisTooltip_NonLeaderOpen"	"Gli amici possono chiedere di unirsi al gruppo.<br/>Clicca qui per bloccare l'accesso al gruppo."
"DOTA_PartyVisTooltip_NonLeaderNotOpen"	"Gli amici dei giocatori possono chiedere di unirsi al gruppo.<br/>Solo il leader del gruppo può accettare le richieste ricevute.<br/>Clicca qui per aprire l'accesso al gruppo, rendendolo più visibile agli amici."
"DOTA_TogglePartyOpenMic_Tooltip"	"Attiva o disattiva il microfono aperto per il gruppo"
"DOTA_PartySettings"	"Impostazioni del gruppo"
"DOTA_PartySettings_OpenParty"	"Apri il gruppo alle richieste di unione"
"DOTA_PartySettings_BroadcastToFriends"	"Permetti ai miei amici di vedere i miei gruppi"
"DOTA_PartySettings_OpenState_NotOpen"	"Il leader non ha aperto il gruppo alle richieste di unione."
"DOTA_PartySettings_OpenState_NotOpenLeader"	"Questo gruppo non accetta richieste di unione."
"DOTA_PartySettings_OpenState_OpenButHiddenFromFriends"	"Questo gruppo può ricevere richieste di unione. Anche se il gruppo non è visibile ai tuoi amici, potrebbe essere visibile agli amici di altri giocatori."
"DOTA_PartySettings_OpenState_Open"	"Questo gruppo può ricevere richieste di unione ed è visibile ai tuoi amici. Inoltre, potrebbe essere visibile anche agli amici di altri giocatori."
"DOTA_LobbyInvite_Title"	"Invito nella lobby"
"DOTA_LobbyInvite_Description"	"{g:dota_persona:inviter} ti ha invitato in una lobby."
"DOTA_PartyJoinedLobby_Title"	"Sei in una lobby"
"DOTA_PartyJoinedLobby_Generic"	"{s:party_leader} ti ha portato in una lobby."
"DOTA_PartyJoinedLobby_Custom"	"{s:party_leader} ti ha portato in una lobby della modalità {s:custom_game}."
"DOTA_PartyLeader"	"Leader del gruppo"
"DOTA_LobbyKicked_Header"	"Espulso dalla lobby"
"DOTA_LobbyKicked_Message"	"Il leader ti ha espulso dalla lobby."
"DOTA_PlayerContextMenu_ViewProfile"	"Mostra il profilo"
"DOTA_PlayerContextMenu_InviteToParty"	"Invita nel gruppo"
"DOTA_PlayerContextMenu_SuggestInviteToParty"	"Proponi l'invito al gruppo"
"DOTA_PlayerContextMenu_KickFromParty"	"Espelli dal gruppo"
"DOTA_PlayerContextMenu_SetPartyLeader"	"Promuovi a leader del gruppo"
"DOTA_PlayerContextMenu_LeaveParty"	"Esci dal gruppo"
"DOTA_PlayerContextMenu_CoachParty"	"Diventa il mentore del gruppo"
"DOTA_PlayerContextMenu_StopCoachingParty"	"Smetti di essere il mentore del gruppo"
"DOTA_PlayerContextMenu_AddFriend"	"Chiedi l'amicizia"
"DOTA_PlayerContextMenu_RemoveFriend"	"Rimuovi l'amicizia"
"DOTA_PlayerContextMenu_AcceptFriendRequest"	"Accetta la richiesta di amicizia"
"DOTA_PlayerContextMenu_IgnoreFriendRequest"	"Ignora la richiesta di amicizia"
"DOTA_PlayerContextMenu_Spectate"	"Guarda la partita"
"DOTA_PlayerContextMenu_InviteToLobby"	"Invita nella lobby"
"DOTA_PlayerContextMenu_SuggestInviteToLobby"	"Proponi l'invito alla lobby"
"DOTA_PlayerContextMenu_KickFromLobby"	"Espelli dalla lobby"
"DOTA_PlayerContextMenu_KickFromLobbyTeam"	"Espelli dalla squadra della lobby"
"DOTA_FeaturedHero_UnableToLoad"	"Impossibile caricare Eroi in evidenza."
"DOTA_FeaturedHero_ViewGrid"	"Mostra la griglia"
"DOTA_FeaturedHero_HeroName"	"{s:hero_name}"
"DOTA_FeaturedHero_ItemName"	"{g:dota_item_name:item_def}"
"DOTA_FeaturedHeroReason_NewHero"	"Nuovo Eroe rilasciato"
"DOTA_FeaturedHeroReason_NewItem"	"Nuovo oggetto {s:item_rarity}"
"DOTA_FeaturedHeroReason_FrequentlyPlayedHero"	"Dato che hai giocato con"
"DOTA_FeaturedHeroReason_FeaturedItem"	"Oggetto in evidenza"
"DOTA_FeaturedHeroReason_PopularItem"	"Il più venduto"
"DOTA_FeaturedHeroReason_SaleItem"	"In offerta"
"DOTA_NewFeaturedHero_WinterWyvern"	"Il Drago Anziano arriva, seguito da un vento gelido."
"DOTA_HeroSelectorCategory_Default"	"Tutti gli Eroi"
"DOTA_HeroSelectorCategory_NewItems"	"Nuovi oggetti"
"DOTA_HeroSelectorCategory_Favorites"	"Preferiti"
"DOTA_HeroSelectorCategory_MostPlayed"	"Eroi più giocati"
"DOTA_HeroSelectorCategory_LeastPlayed"	"Eroi meno giocati"
"DOTA_HeroSelectorCategory_HaveItems"	"Eroi per cui ho oggetti"
"DOTA_HeroSelectorCategory_PrimaryAttribute_Strength"	"Forza"
"DOTA_HeroSelectorCategory_PrimaryAttribute_Agility"	"Agilità"
"DOTA_HeroSelectorCategory_PrimaryAttribute_Intelligence"	"Intelligenza"
"DOTA_HeroSelectorCategory_AttackRange_Melee"	"Da mischia"
"DOTA_HeroSelectorCategory_AttackRange_Ranged"	"A distanza"
"DOTA_HeroSelector_SelectHero_Label"	"Scegli"
"DOTA_HeroSelector_ClearFilters"	"Rimuovi i filtri"
"DOTA_OwnedItemSet_Selector_Title"	"Nell'Arsenale"
"DOTA_EquippedItemSet_Selector_Title"	"Equipaggiato"
"DOTA_OwnedItemSet_Available_Title"	"Disponibili"
"DOTA_FeaturedItemSet_Selector_Title"	"In evidenza"
"DOTA_AllItemSet_Selector_Title"	"Tutto"
"DOTA_ConfirmLANLobby_title"	"LOBBY LOCALE"
"DOTA_ConfirmLANLobby_desc"	"Le partite locali vengono create sul tuo computer. I requisiti di sistema per questo computer saranno inoltre più elevati."
"DOTA_ConfirmLANLobbyDisconnect_title"	"Uscire dalla lobby locale?"
"DOTA_ConfirmLANLobbyDisconnect_desc"	"Stai ospitando questa lobby sul tuo computer. Se ti disconnetti la partita terminerà anche per gli altri giocatori. Vuoi continuare?"
"DOTA_ConfirmLANLobbyDisconnect_ok"	"Sì, disconnettimi"
"DOTA_Lobby_Settings_General"	"IMPOSTAZIONI GENERALI DELLA LOBBY"
"DOTA_Lobby_Settings_Required"	"OBBLIGATORIA"
"DOTA_Lobby_Settings_Confirm"	"{s:lobby_confirm_label}"
"DOTA_Lobby_Settings_Game_Mode"	"MODALITÀ"
"DOTA_Lobby_Settings_Region"	"AREA DEL SERVER"
"DOTA_Lobby_Settings_Password"	"PASSWORD DELLA LOBBY"
"DOTA_Lobby_Settings_Game_Name"	"NOME DELLA LOBBY"
"DOTA_Lobby_Settings_Advanced"	"IMPOSTAZIONI AVANZATE DELLA LOBBY"
"DOTA_Lobby_Settings_Competitive"	"IMPOSTAZIONI COMPETITIVE"
"DOTA_Lobby_Settings_Starting_Team"	"SQUADRA DI PARTENZA"
"DOTA_Lobby_Settings_Starting_Team_Random"	"CASUALE"
"DOTA_Lobby_Settings_Starting_Team_Radiant"	"RADIANT"
"DOTA_Lobby_Settings_Starting_Team_Dire"	"DIRE"
"DOTA_Lobby_Settings_Penalty_Radiant"	"PENALITÀ - RADIANT"
"DOTA_Lobby_Settings_Penalty_Dire"	"PENALITÀ - DIRE"
"DOTA_Lobby_Settings_Penalty_Level_0"	"Nessuna"
"DOTA_Lobby_Settings_Penalty_Level_1"	"-30 secondi per la fase dei ban"
"DOTA_Lobby_Settings_Penalty_Level_2"	"-70 secondi per la fase dei ban"
"DOTA_Lobby_Settings_Penalty_Level_3"	"-110 secondi per la fase dei ban"
"DOTA_Lobby_Settings_Penalty_Tooltip"	"In Captains Mode, questa impostazione riduce il tempo disponibile per i ban di questa squadra."
"DOTA_Lobby_Settings_Series_Type"	"TIPO DI SERIE"
"DOTA_Lobby_Settings_No_Series"	"NESSUNA SERIE"
"DOTA_Lobby_Settings_Series_Best_of_3"	"AL MEGLIO DI 3"
"DOTA_Lobby_Settings_Series_Best_of_5"	"AL MEGLIO DI 5"
"DOTA_Lobby_Settings_Gameplay_Rules"	"REGOLE DI GIOCO"
"DOTA_Lobby_Settings_Enable_Cheats"	"ATTIVA I TRUCCHI"
"DOTA_Lobby_Settings_All_Chat"	"CHAT GLOBALE"
"DOTA_Lobby_Settings_Fill_Bots"	"BOT NEGLI SLOT VUOTI"
"DOTA_Lobby_Settings_Bot_Difficulty"	"DIFFICOLTÀ DEI BOT"
"DOTA_Lobby_Settings_Bot_Difficulty_Passive"	"PASSIVA"
"DOTA_Lobby_Settings_Bot_Difficulty_Easy"	"FACILE"
"DOTA_Lobby_Settings_Bot_Difficulty_Medium"	"NORMALE"
"DOTA_Lobby_Settings_Bot_Difficulty_Hard"	"DIFFICILE"
"DOTA_Lobby_Settings_Bot_Difficulty_Unfair"	"SLEALE"
"DOTA_Lobby_Settings_Version"	"VERSIONE"
"DOTA_Lobby_Settings_Version_Latest"	"PIÙ RECENTE"
"DOTA_Lobby_Settings_Version_Tournament"	"DA TORNEO"
"DOTA_Lobby_Settings_Spectator_Section"	"IMPOSTAZIONI PER SPETTATORI"
"DOTA_Lobby_Settings_Dota_TV_Delay"	"RITARDO DELLA DOTA TV"
"DOTA_Lobby_Settings_Dota_TV_Delay_2_Minutes"	"2 minuti"
"DOTA_Lobby_Settings_Dota_TV_Delay_5_Minutes"	"5 minuti"
"DOTA_Lobby_Settings_Dota_TV_Delay_10_Seconds"	"10 secondi"
"DOTA_Lobby_Settings_Spectators"	"SPETTATORI"
"DOTA_Lobby_Settings_Spectators_Enabled"	"ABILITATI"
"DOTA_Lobby_Settings_Spectators_Disabled"	"DISABILITATI"
"dota_lobby_settings_hide_password"	"Nascondi la password"
"dota_lobby_settings_local_host"	"Ospita la partita localmente"
"DOTA_Lobby_Settings_Visibility"	"Visibilità della lobby"
"DOTA_Lobby_Settings_Visibility_Public"	"Pubblica"
"DOTA_Lobby_Settings_Visibility_Friends"	"Visibile agli amici"
"DOTA_Lobby_Settings_Visibility_Unlisted"	"Non elencata"
"DOTA_Lobby_Settings_Visibility_Tooltip"	"Controlla la visibilità della lobby. Le lobby pubbliche saranno visibili nel browser delle lobby e agli amici. Le lobby per amici sono visibili esclusivamente da loro, ma è possibile invitare giocatori che non sono tuoi amici. Le lobby non elencate non saranno visibili nel browser delle lobby o agli amici."
"DOTA_TeamUnsetHeader"	"Squadra non selezionata"
"DOTA_TeamUnsetMessage"	"Almeno una delle squadre non ha un nome o un logo. Avviare comunque la partita?"
"DOTA_LeagueUnsetHeader"	"Lega non selezionata"
"DOTA_LeagueUnsetMessage"	"Non hai impostato una lega per questa lobby, ma puoi farlo ora. Avviare comunque la partita?"
"DOTA_LobbyAllowSpectatingHeader"	"Impossibile avviare la partita della lobby"
"DOTA_LobbyAllowSpectatingMessage"	"La partita deve permettere gli spettatori per poter essere avviata con gli utenti attuali della lobby. Per farlo, vai alle impostazioni della lobby."
"dota_radiant"	"I Radiant"
"dota_dire"	"I Dire"
"dota_lobby_team_name_radiant"	"{s:team_name_good_guys}"
"dota_lobby_team_name_dire"	"{s:team_name_bad_guys}"
"dota_lobby_no_team"	"Nessuna squadra"
"dota_lobby_broadcast_default_channel_name"	"Nome del canale"
"dota_lobby_broadcast_join"	"Unisciti"
"dota_lobby_broadcast_leave"	"Esci"
"dota_lobby_broadcast_create"	"Crea un nuovo canale"
"dota_lobby_broadcast_no_channels"	"Nessun canale per commentatori disponibile"
"dota_popup_broadcast_channel_edit_title"	"Personalizza il canale"
"dota_lobby_broadcast_default_channel_name_custom"	"{s:custom_title}"
"dota_popup_broadcast_channel_edit_channel_name"	"Titolo del canale"
"dota_popup_broadcast_channel_edit_country"	"Paese"
"dota_popup_broadcast_channel_edit_language"	"Lingua"
"dota_popup_broadcast_channel_edit_save"	"Salva come impostazioni predefinite da applicare ai canali vuoti a cui mi unisco"
"DOTA_Lobby_Broadcaster_Channel_Other_Language"	"Altra lingua"
"lobby_slot_error_header"	"Impossibile cambiare slot"
"generic_gc_timeout"	"Tempo per il messaggio esaurito."
"lobby_slot_success_header"	"Operazione riuscita"
"lobby_slot_denied"	"Non hai i permessi per accedere a questo slot."
"lobby_slot_cameramanalready"	"I canali da commentatore possono avere un solo cameraman"
"lobby_slot_cameramanon"	"Ora sei un cameraman"
"lobby_slot_cameramanoff"	"Non sei più un cameraman"
"lobby_slot_error"	"Cambiamento dello slot della lobby non riuscito."
"lobby_create_timeout"	"Creazione della lobby non riuscita."
"find_match_error"	"Impossibile cercare partite al momento."
"DOTA_DialogVariableTest1"	"Semplice: {s:var}"
"DOTA_DialogVariableTest2"	"Valore del denaro: {m:money}"
"DOTA_DialogVariableTest3"	"Collegamento dell'oggetto: {g:dota_item_link:item_def}"
"DOTA_DialogVariableTest4"	"Prezzo dell'oggetto: {g:dota_item_price:item_def}"
"DOTA_DialogVariableTest5"	"Nome identificativo dell'account: {g:dota_persona:account_id}, Nome da pro: {g:dota_persona:pro:account_id}"
"DOTA_DialogVariableTest6"	"Semplice con span: <span class=\"TextSpan\">{s:var}</span>"
"LobbySetting_GameMode"	"Modalità"
"LobbySetting_GameMode_Value"	"{s:lobbysetting_gamemode}"
"LobbySetting_Bots"	"Bot"
"LobbySetting_Bots_Value"	"{s:lobbysetting_bots}"
"LobbySetting_Password"	"Password"
"LobbySetting_Password_Value"	"{s:lobbysetting_password}"
"LobbySetting_Server"	"Server"
"LobbySetting_Server_Value"	"{s:lobbysetting_server}"
"LobbySetting_Cheats"	"Trucchi"
"LobbySetting_Cheats_Value"	"{s:lobbysetting_cheats}"
"LobbySetting_Spectators"	"Spettatori"
"LobbySetting_Spectators_Value"	"{s:lobbysetting_spectators}"
"LobbySetting_Visibility"	"Visibilità"
"LobbySetting_Visibility_Value"	"{s:lobbysetting_visibility}"
"dota_lobby_lan_title"	"Server locale"
"dota_lobby_coaches_none"	"Mentori: nessuno"
"dota_lobby_coaches"	"Mentori:"
"DOTA_Custom_Game"	"Modalità personalizzata"
"DOTA_Custom_Game_Info"	"Informazioni"
"DOTA_Custom_Game_View_Details"	"Dettagli della modalità"
"DOTA_Custom_Game_Author"	"creata da {g:dota_persona:author}"
"DOTA_Custom_Game_Lobby_Count"	"{d:lobby_count} lobby"
"DOTA_Custom_Game_Lobby_Count_Plural"	"{d:lobby_count} lobby"
"DOTA_Custom_Game_Friend_Lobbies_Alert"	"{d:friend_count} amico ha una lobby aperta."
"DOTA_Custom_Game_Friend_Lobbies_Alert_Plural"	"{d:friend_count} amici hanno delle lobby aperte."
"DOTA_Custom_Game_Quick_Join"	"Unione rapida"
"DOTA_Custom_Game_View_Lobbies"	"Mostra le lobby"
"DOTA_Custom_Game_Find_Lobby"	"Trova lobby"
"DOTA_Custom_Game_Create_Lobby"	"Crea lobby"
"DOTA_Custom_Game_Game_Page"	"Pagina della modalità"
"DOTA_Custom_Game_Workshop_Page"	"Pagina del Workshop"
"DOTA_Custom_Game_Download_Queued"	"Download in coda"
"DOTA_Custom_Game_Downloading"	"Download in corso..."
"DOTA_Custom_Game_Downloading_Percent"	"Download in corso - {d:lobby_download_percent}%"
"DOTA_Custom_Game_Needs_Update"	"Da aggiornare"
"DOTA_Custom_Game_Play"	"Gioca a \"{s:game_mode_name}\""
"DOTA_Custom_Game_Uninstall"	"Disinstalla"
"DOTA_Custom_Game_Install"	"Installa"
"DOTA_Custom_Game_Installed"	"Installata"
"DOTA_Custom_Game_Not_Installed"	"Non installata"
"DOTA_Custom_Game_Connect"	"Unisciti"
"DOTA_Custom_Game_FileSize"	"{d:file_size} MB"
"DOTA_Custom_Game_Name"	"{s:game_mode_name}"
"DOTA_Custom_Game_Released_By"	"Data di rilascio: {s:release_date}</b> Creata da <b>{g:dota_persona:author}</b>"
"DOTA_Custom_Game_Subscription"	"{s:subscriptions_count} sottoscrizione"
"DOTA_Custom_Game_Subscriptions"	"{s:subscriptions_count} sottoscrizioni"
"DOTA_Custom_Game_Rating"	"Voto"
"DOTA_Custom_Game_Release_Date"	"Data di rilascio"
"DOTA_Custom_Game_Playing_Now"	"{s:player_count} in gioco"
"DOTA_Custom_Game_Ratings_Count"	"({d:ratings_count})"
"DOTA_Custom_Game_Description"	"{s:game_description}"
"DOTA_Custom_Game_Last_Updated"	"Ultimo aggiornamento: {t:r:t:last_updated}"
"DOTA_Custom_Game_Update_Note_Title"	"{s:timestamp}"
"DOTA_Custom_Game_Screenshots"	"Screenshot"
"DOTA_Custom_Game_Map_Label"	"Mappa"
"DOTA_Custom_Game_Map_Any"	"Qualsiasi"
"DOTA_Custom_Game_Update"	"Aggiorna"
"DOTA_Custom_Game_Spectate"	"Fai da spettatore"
"DOTA_Custom_Game_Already_In_Lobby"	"Finisci la partita in corso per passare a questa modalità."
"DOTA_Custom_Game_Friends_Playing"	"Amici in modalità personalizzate"
"DOTA_Custom_Game_Friends_In_Lobbies"	"{d:friends_in_open_lobbies} in lobby aperte"
"DOTA_Custom_Game_Friends_In_Game"	"{d:friends_in_game} amici in modalità personalizzate"
"DOTA_Custom_Games_Friends_Play"	"Modalità personalizzate giocate dagli amici"
"DOTA_Custom_Game_Invite_Friend"	"Invita un amico"
"DOTA_Custom_Game_Tooltip_Subscribers"	"{d:subscriber_count} sottoscrizioni"
"DOTA_Custom_Game_Tooltip_Subscriber"	"{d:subscriber_count} sottoscrizione"
"DOTA_Custom_Game_Most_Popular"	"Le più popolari"
"DOTA_Custom_Game_Installed_Games"	"Modalità installate"
"DOTA_Custom_Game_Favorite_Games"	"Mostra solo preferite"
"DOTA_Custom_Game_Add_Favorite"	"Nei preferiti"
"DOTA_Custom_Game_VotePrompt"	"Pensi che questa modalità piacerà ad altri giocatori?"
"DOTA_Custom_Game_DetailsPrompt"	"Visita la pagina di questa modalità per trovare informazioni o per installarla e iniziare a giocare."
"DOTA_Custom_Game_Vote_Box_Title"	"Votazioni del Workshop"
"DOTA_Custom_Game_Vote_Start"	"Inizia a votare"
"DOTA_Custom_Game_VoteThanks"	"Grazie per il voto!"
"DOTA_Custom_Game_Vote_PrevLabel"	"Precedente"
"DOTA_Custom_Game_Vote_NextLabel"	"Successiva"
"DOTA_Custom_Game_Vote_ControlsLabel"	"Votazione del Workshop"
"DOTA_Custom_Game_Vote_YesLabel"	"Sì!"
"DOTA_Custom_Game_Vote_NoLabel"	"No, va migliorata."
"DOTA_Custom_Game_Vote_SkipLabel"	"Non saprei. Passa alla prossima modalità."
"DOTA_Custom_Game_Vote_Up"	"Buona modalità"
"DOTA_Custom_Game_Vote_Down"	"Da migliorare"
"Video_Support_Coming_Soon"	"Supporto per i video in arrivo"
"DOTA_Custom_Game_Leave_Lobby"	"Esci dalla lobby"
"DOTA_Custom_Game_Suggested_Title"	"Modalità consigliate"
"DOTA_Custom_Game_Suggested_Info"	"Questa lista comprende le modalità popolari e quelle che hanno ricevuto voti positivi.<br><br>La lista viene aggiornata ogni 30 minuti e mostra una selezione unica di 15 modalità a tutta la comunità."
"DOTA_Custom_Game_Addon_Restricted"	"Impossibile eseguire questa operazione con la modalità a strumenti limitati per gli addon."
"DOTA_Custom_Game_Search"	"Cerca nelle modalità personalizzate"
"DOTA_Custom_Lobby_Create_Button"	"Crea una lobby"
"DOTA_Custom_Lobby_Settings_Title"	"Crea una lobby per modalità personalizzate"
"DOTA_Custom_Lobby_Settings_Mode"	"Modalità"
"DOTA_Custom_Lobby_Settings_Map"	"Mappa"
"DOTA_Custom_Lobby_LobbyName"	"Descrizione facoltativa"
"DOTA_Custom_Lobby_List_Desc"	"Un elenco di lobby private (protette da password) e modalità personalizzate attive senza filtri"
"DOTA_Custom_Lobby_Public"	"Pubblica"
"DOTA_Custom_Lobby_Passworded"	"I giocatori possono unirsi alla lobby su invito o usando la password nell'opzione di ricerca."
"DOTA_Custom_Lobby_Join_Failed_Title"	"Unione non riuscita"
"DOTA_Custom_Lobby_Join_Failed_Reason"	"{s:join_error}"
"DOTA_Custom_Lobby_Join_Failed_Prompt"	"Cercare una lobby aperta della modalità \"{s:game_name}\"?"
"DOTA_Lobby_Failed_Pings"	"Ricezione delle informazioni sulla latenza non riuscita. Assicurati che la tua connessione a Internet sia funzionante e che i server di Dota 2 siano attivi."
"DOTA_Custom_Lobby_Create_Private_Button"	"Crea una lobby privata"
"DOTA_Custom_Lobby_Find_Private_Button"	"Cerca lobby privata"
"DOTA_Custom_Lobby_Find_Private_Title"	"Cerca lobby privata"
"DOTA_Custom_Lobby_Find_Private_Desc"	"Inserisci la password associata alla lobby privata:"
"DOTA_Custom_Lobby_List_Game_Header"	"Modalità"
"DOTA_Custom_Lobby_List_Name_Header"	"Descrizione"
"DOTA_Custom_Lobby_List_Players_Header"	"Giocatori"
"DOTA_Custom_Lobby_List_Map_Header"	"Mappa"
"DOTA_Custom_Lobby_List_Region_Header"	"Regione"
"DOTA_Custom_Lobby_List_Connection_Header"	"Latenza"
"DOTA_Custom_Lobby_List_Status_Header"	"Stato locale"
"DOTA_Custom_Lobby_List_Game"	"{s:lobby_game}"
"DOTA_Custom_Lobby_List_Lobby_Name"	"{s:lobby_name}"
"DOTA_Custom_Lobby_List_Players"	"{s:lobby_players} / {s:lobby_max_players}"
"DOTA_Custom_Lobby_List_Map"	"{s:lobby_map}"
"DOTA_Custom_Lobby_List_Region"	"{s:lobby_region}"
"DOTA_Custom_Lobby_List_Connection"	"..."
"DOTA_Custom_Lobby_List_Status"	"{s:lobby_status}"
"DOTA_Custom_Lobby_List_Connect"	"{s:connect_button_text}"
"DOTA_Custom_Lobby_Game_Name"	"{s:game_name}"
"DOTA_Custom_Lobby_Map_Name"	"Mappa: {s:map_name}"
"DOTA_Custom_Lobby_Player_Count"	"Giocatori: {d:player_count} / {d:max_player_count}"
"DOTA_Custom_Lobby_Player_Count_Short"	"{d:player_count} / {d:max_player_count}"
"DOTA_Custom_Lobby_Visibility"	"Visibilità della lobby"
"DOTA_Custom_Join_Chat"	"Entra nella chat"
"DOTA_Custom_Join_Chat_Member_Count"	"({d:ChatMemberCount})"
"DOTA_Custom_Leave_Chat"	"Esci dalla chat"
"DOTA_Custom_Game_Vote_Up_Tooltip"	"Clicca per dare un voto positivo a questa modalità sullo Steam Workshop."
"DOTA_Page_Number"	"Pagina: {d:current_page} / {d:num_pages}"
"DOTA_TabName_ModsOverview"	"Panoramica"
"DOTA_TabName_ModsSubscribed"	"Libreria"
"DOTA_TabName_ModsWorkshop"	"Workshop"
"DOTA_TabName_ModsBrowse"	"Sfoglia"
"DOTA_WatchTabName_Live"	"In diretta"
"DOTA_WatchTabName_Featured"	"In evidenza"
"DOTA_WatchTabName_Replays"	"Replay"
"DOTA_WatchTabName_Tournaments"	"Tornei"
"DOTA_WatchTabName_Downloads"	"Download"
"DOTA_WatchLive_Search"	"Cerca un Eroe da seguire"
"DOTA_WatchLive_DataPending"	"Ricerca di partite in diretta..."
"DOTA_WatchLive_DataError"	"Errore durante il caricamento delle partite in diretta"
"DOTA_WatchLive_NoGames"	"Nessuna partita in diretta"
"DOTA_WatchLive_Connecting"	"In attesa dei dati della partita..."
"DOTA_WatchLive_HeroFilter"	"Filtro: {s:hero_filter_name}"
"DOTA_WatchLive_CountSpec"	"Spettatori: {i:num_spectating}"
"DOTA_WatchLive_CountSpecFriend"	"Spettatori: {i:num_spectating}, {i:num_friends_spectating} amico"
"DOTA_WatchLive_CountSpecFriends"	"Spettatori: {i:num_spectating}, {i:num_friends_spectating} amici"
"DOTA_WatchLive_CountFriends"	"{i:num_friends_playing} amici in gioco"
"DOTA_WatchLive_ParticipantsUnranked"	"Non classificata"
"DOTA_WatchLive_Participants1"	"{s:friend_1}"
"DOTA_WatchLive_Participants2"	"{s:friend_1} e {s:friend_2}"
"DOTA_WatchLive_Participants3"	"{s:friend_1}, {s:friend_2} e {s:friend_3}"
"DOTA_WatchLive_Participants4Plus"	"{s:friend_1}, {s:friend_2}, {s:friend_3} e altri {i:friend_count_over_3}..."
"DOTA_WatchLive_MatchType_MM_Kills"	"{s:game_mode}"
"DOTA_WatchLive_MatchType_MM"	"{s:game_mode}"
"DOTA_WatchLiveDotaTV"	"Guarda su DotaTV"
"DOTA_WatchLivePurchase"	"Compra il pass del torneo {g:dota_item_price:ticket_itemdef}"
"DOTA_WatchLiveSpectatorFriends1"	"{g:dota_persona:spectator_friend_1} sta guardando"
"DOTA_WatchLiveSpectatorFriends2"	"{g:dota_persona:spectator_friend_1} e {g:dota_persona:spectator_friend_2} stanno guardando"
"DOTA_WatchLiveSpectatorFriends3"	"{g:dota_persona:spectator_friend_1}, {g:dota_persona:spectator_friend_2} e {g:dota_persona:spectator_friend_3} stanno guardando"
"DOTA_WatchLiveSpectatorFriends4Plus"	"{g:dota_persona:spectator_friend_1}, {g:dota_persona:spectator_friend_2}, {g:dota_persona:spectator_friend_3} e altri {i:spectator_friend_count_over_3} amici stanno guardando"
"DOTA_WatchLiveSpectatorCount"	"Spettatori: {i:spectator_count}"
"DOTA_WatchLivePreGame"	"Pre-partita"
"DOTA_WatchLive_ElapsedTime"	"Durata:"
"DOTA_WatchLive_Spectating"	"Spettatori:"
"DOTA_WatchReplays_Popular"	"PARTITE POPOLARI"
"DOTA_WatchReplays_SavedForLater"	"PARTITE DA GUARDARE PIÙ TARDI"
"DOTA_WatchReplays_ParticipantsVs"	"{s:team_1} vs {s:team_2}"
"DOTA_WatchReplays_MatchType_League"	"{s:league_name}"
"DOTA_WatchReplays_MatchType_Public"	"Partita {s:match_id} - {s:game_mode}"
"DOTA_WatchReplays_Recommendations"	"{i:recommendations}"
"DOTA_WatchReplays_Recommendations1"	"{g:dota_persona:friend_1} + {i:recommendations}"
"DOTA_WatchReplays_Recommendations2"	"{g:dota_persona:friend_1}, {g:dota_persona:friend_2} + {i:recommendations}"
"DOTA_WatchReplays_Recommendations3Plus"	"{g:dota_persona:friend_1} + altri {i:friend_count_over_1} amici + {i:recommendations}"
"DOTA_WatchReplays_Friends1"	"{g:dota_persona:b:friend_1} era nella partita"
"DOTA_WatchReplays_Friends2"	"{g:dota_persona:b:friend_1} e {g:dota_persona:friend_2} erano nella partita"
"DOTA_WatchReplays_Friends3Plus"	"{g:dota_persona:b:friend_1}, {g:dota_persona:b:friend_2} e altri {i:friend_count_over_2} amici erano nella partita"
"DOTA_WatchReplays_Views"	"{i:views} visualizzazioni"
"DOTA_WatchReplays_SharedMatch"	"{g:dota_persona:shared_by} ha condiviso: \"{s:shared_text}\""
"DOTA_WatchReplays_SharedHighlight"	"{g:dota_persona:shared_by} ha condiviso un momento saliente"
"DOTA_WatchReplays_Duration"	"{s:minutes}:{s:seconds}"
"DOTA_WatchReplays_Tag"	"\"{s:recommendation_text}\""
"DOTA_WatchTournaments_FeaturedTitle"	"{s:tournament_featured_title}"
"DOTA_WatchTournaments_FeaturedDates"	"{s:tournament_featured_start} - {s:tournament_featured_end}"
"DOTA_WatchTournaments_FeaturedDescription"	"{s:tournament_featured_description}"
"DOTA_WatchTournaments_FeaturedTeams"	"Squadre"
"DOTA_WatchTournaments_PrizePool"	"Montepremi:"
"DOTA_WatchTournaments_PrizePoolAmt"	"{s:tournament_featured_prize_pool}"
"DOTA_WatchTournaments_Purchase"	"Pass del torneo - {s:tournament_featured_price}"
"DOTA_WatchTournament_TournamentName"	"{s:tournament_name}"
"DOTA_WatchTournament_Price"	"{s:price}"
"DOTA_Replays_Search"	"Cerca in base all'ID della partita"
"DOTA_Watch_GameStatus"	"Guarda la partita"
"DOTA_Watch_Pending"	"In attesa di guardare la partita..."
"DOTA_Watch_GameServerNotFound"	"Il server che ospita questa partita non è stato trovato."
"DOTA_Watch_Unavailable"	"Impossibile guardare questa partita adesso."
"DOTA_Watch_LobbyNotFound"	"Lobby non trovata."
"DOTA_Watch_MissingLeagueSubscription"	"Per guardare questa partita ti serve il pass della lega."
"vs"	"VS"
"dota_matchmaking_language_title"	"Scegli la lingua per la ricerca di partite"
"dota_matchmaking_language_primary_label"	"Lingua principale per la ricerca di partite:"
"dota_matchmaking_language_primary"	"{s:environment_language}"
"dota_matchmaking_language_primary_invalid"	"La tua lingua ({s:environment_language}) non è disponibile nelle opzioni di ricerca di Dota 2."
"dota_matchmaking_language_select_secondary"	"Puoi scegliere anche una seconda lingua:"
"dota_matchmaking_language_select_primary"	"Scegli una lingua per la ricerca di partite:"
"dota_matchmaking_language_no_selection"	"Nessuna"
"dota_matchmaking_language_english"	"Inglese"
"dota_matchmaking_language_russian"	"Russo"
"dota_matchmaking_language_chinese"	"Cinese"
"dota_matchmaking_language_schinese"	"Cinese"
"dota_matchmaking_language_korean"	"Coreano"
"dota_matchmaking_language_koreana"	"Coreano"
"dota_matchmaking_language_spanish"	"Spagnolo"
"dota_matchmaking_language_portuguese"	"Portoghese"
"GameUI_Language_English"	"Inglese"
"GameUI_Language_German"	"Tedesco"
"GameUI_Language_French"	"Francese"
"GameUI_Language_Italian"	"Italiano"
"GameUI_Language_Korean"	"Coreano"
"GameUI_Language_Spanish"	"Spagnolo"
"GameUI_Language_Simplified_Chinese"	"Cinese semplificato"
"GameUI_Language_Traditional_Chinese"	"Cinese tradizionale"
"GameUI_Language_Russian"	"Russo"
"GameUI_Language_Thai"	"Tailandese"
"GameUI_Language_Japanese"	"Giapponese"
"GameUI_Language_Portuguese"	"Portoghese"
"GameUI_Language_Polish"	"Polacco"
"GameUI_Language_Danish"	"Danese"
"GameUI_Language_Dutch"	"Olandese"
"GameUI_Language_Finnish"	"Finlandese"
"GameUI_Language_Norwegian"	"Norvegese"
"GameUI_Language_Swedish"	"Svedese"
"GameUI_Language_Hungarian"	"Ungherese"
"GameUI_Language_Czech"	"Ceco"
"GameUI_Language_Romanian"	"Rumeno"
"GameUI_Language_Turkish"	"Turco"
"GameUI_Language_Brazilian"	"Portoghese brasiliano"
"GameUI_Language_Bulgarian"	"Bulgaro"
"GameUI_Language_Greek"	"Greco"
"GameUI_Language_Ukrainian"	"Ucraino"
"client_version_out_of_date_title"	"Aggiornamento richiesto"
"client_version_out_of_date"	"Il client del gioco non è aggiornato. Chiudi Dota 2 e riavvia il client per scaricare la versione più aggiornata."
"dota_matchmaking_region_title"	"Scegli le regioni per la ricerca di partite"
"dota_matchmaking_region_auto"	"Scegli automaticamente la regione in base alla mia località."
"dota_matchmaking_region_select"	"Scegli fino a tre regioni per la ricerca di partite. Scegli le regioni più vicine per ottimizzare l'esperienza di gioco."
"limited_heroes_abandon_header"	"Modalità Eroi limitati"
"limited_heroes_abandon_explanation"	"Abbandonare partite nella modalità Eroi limitati non comporta penalità, dato che il tuo Eroe viene sostituito da un bot. Abbandonare partite nelle altre modalità potrebbe farti finire nella coda di ricerca di partite a bassa priorità."
"dota_abandon_dialog_title"	"Abbandona"
"dota_abandon_dialog_confirm"	"Sei sicuro di voler abbandonare la partita?"
"dota_abandon_dialog_yes"	"Sì, abbandona la partita."
"dota_leave_dialog_title"	"Esci dalla partita"
"dota_leave_dialog_confirm"	"Sei sicuro di voler uscire da questa partita?"
"dota_leave_dialog_yes"	"Sì, esci dalla partita"
"dota_accept_match_title"	"La tua partita è pronta"
"dota_accept_match_readyup_title"	"In attesa dei giocatori"
"dota_accept_match_accept"	"Accetta"
"dota_accept_match_accept_low_pri"	"Accetta (bassa priorità)"
"dota_accept_match_accept_button"	"{s:accept}"
"dota_accept_match_decline"	"Rifiuta"
"dota_accept_match_subtitle"	"{s:subtitle}"
"dota_finding_match_players"	"({s:searching_player_count} giocatori in ricerca)"
"dota_finding_match_time"	"tempo in ricerca: {s:find_match_time}"
"dota_finding_match_accept_count"	"giocatori pronti: {s:match_num_accepted} / {s:match_num_total}"
"dota_finding_match_generic"	"Partita normale"
"dota_finding_match_ranked"	"Partita classificata"
"dota_finding_match_bot"	"Partita contro i bot"
"dota_finding_match_bot_passive"	"Partita contro i bot (Passiva)"
"dota_finding_match_bot_easy"	"Partita contro i bot (Facile)"
"dota_finding_match_bot_medium"	"Partita contro i bot (Normale)"
"dota_finding_match_bot_hard"	"Partita contro i bot (Difficile)"
"dota_finding_match_bot_unfair"	"Partita contro i bot (Sleale)"
"dota_finding_match_team"	"Partita classificata a squadre"
"dota_finding_1v1_match_casual"	"Partita 1vs1"
"dota_finding_match_practice_lobby"	"Partita di lobby"
"dota_safe_to_abandon_inline"	"La partita può essere abbandonata senza rischi"
"dota_match_connected"	"Connesso alla partita"
"dota_match_local_game"	"Connesso a una partita locale"
"dota_match_connecting"	"Connessione alla partita..."
"dota_match_in_progress"	"Partita in corso"
"dota_match_finished"	"Partita terminata"
"matchmaking_waiting_for_players"	"In attesa di altri giocatori"
"matchmaking_player_declined"	"Un giocatore ha rifiutato"
"dota_match_wait_for_host"	"In attesa dell'host"
"dota_match_find_server"	"Ricerca del server"
"ranked_disabled"	"Le partite classificate non sono disponibili al momento."
"ranked_mmr"	"Il tuo Livello di abilità"
"ranked_mmr_solo_label"	"Da solo"
"ranked_mmr_solo_value"	"{i:solo_mmr}"
"ranked_mmr_solo_calibrating"	"da determinare - Partite rimanenti: {i:solo_calibrating_games}"
"ranked_mmr_solo_no_data"	"Partite richieste: {i:solo_calibrating_required_games}"
"ranked_mmr_party_label"	"Di gruppo"
"ranked_mmr_party_value"	"{i:party_mmr}"
"ranked_mmr_party_calibrating"	"da determinare - Partite rimanenti: {i:party_calibrating_games}"
"ranked_mmr_party_no_data"	"Partite richieste: {i:party_calibrating_required_games}"
"matchmaking_account_disabled"	"Hai creato troppi problemi e non potrai usare la chat o unirti alla coda per la ricerca di partite. Tempo rimanente: {t:r:match_denied_time}"
"matchmaking_match_disabled_party"	"La ricerca di partite non è disponibile perché {s:match_denied_player_name} ha abbandonato o non ha confermato la sua presenza in tempo nella partita precedente. Tempo rimanente: {t:r:match_denied_time}"
"matchmaking_low_priority_party"	"La ricerca di partite è solo a bassa priorità perché {s:match_denied_player_name} ha abbandonato troppe partite o ha ricevuto troppe segnalazioni. Partite rimanenti: {d:match_denied_games}"
"matchmaking_match_disabled_local"	"Non potrai cercare partite perché hai abbandonato o non hai confermato la tua presenza in tempo nella partita precedente. Tempo rimanente: {t:r:match_denied_time}"
"matchmaking_low_priority_local"	"Puoi cercare solo partite a bassa priorità perché hai abbandonato troppe partite o hai ricevuto troppe segnalazioni. Partite rimanenti: {d:match_denied_games}"
"dota_ready_up_count"	"{s:ready_up_ready} / {s:ready_up_lobby_members}"
"dota_play_normal_match"	"Partita normale"
"dota_play_ranked_match"	"Partita classificata"
"dota_play_practice_1v1"	"Pratica 1vs1"
"dota_play_practice_with_bots"	"Pratica con i bot"
"dota_play_practice_1v1_playtab"	"PRATICA 1VS1"
"dota_play_1v1_desc"	"Fai pratica nella corsia centrale contro un altro giocatore finché uno dei due muore due volte o perde una torre."
"dota_play_practice_1v1_party_warning"	"I gruppi non sono permessi nelle partite 1vs1"
"dota_play_button_label"	"{s:play_button_label}"
"dota_play"	"Gioca a Dota"
"dota_play_searching"	"Ricerca in corso"
"dota_play_connecting"	"Caricamento dell'host..."
"dota_play_lobby_find_server"	"Ricerca del server"
"dota_play_find_match_label"	"{s:find_match_label}"
"dota_reconnect"	"Riconnettiti"
"dota_abandon_game"	"Abbandona"
"dota_safe_leave_game"	"Esci dalla partita"
"dota_disconnect"	"Disconnettiti"
"dota_play_unavailable"	"Non disponibile"
"dota_leaver_consequence_tooltip_header"	"Conseguenze"
"dota_leaver_consequences"	"{s:leaver_consequences}"
"dota_leaver_consequences_details"	"{s:leaver_consequences_details}"
"dota_leaver_view_tooltip"	"Mostra i dettagli"
"dota_leaver_consequence_header_failure_to_reconnect"	"Non riconnettersi avrà le seguenti conseguenze:"
"dota_leaver_consequence_header_leave_match"	"Abbandonare questa partita avrà le seguenti conseguenze:"
"dota_leaver_consequence_LetDownTeammates"	"I tuoi compagni di squadra giocheranno svantaggiati."
"dota_leaver_consequence_SmallMatchmakingCooldown"	"Non potrai cercare partite per un po' di tempo."
"dota_leaver_consequence_CreditWithAbandon"	"Riceverai un abbandono."
"dota_leaver_consequence_ForcedLossForLeaver"	"Riceverai una sconfitta."
"dota_leaver_consequence_ForcedLossForLeaversParty"	"Tutti i giocatori del tuo gruppo riceveranno una sconfitta."
"dota_leaver_consequence_ForcedLossForLeaversTeam"	"La tua squadra, %s1, riceverà una sconfitta."
"dota_leaver_consequence_MMRLossForLeaver"	"Il tuo Livello di abilità (MMR) diminuirà."
"dota_leaver_consequence_MMRLossForLeaversParty"	"Il Livello di abilità (MMR) dei giocatori del tuo gruppo diminuirà."
"dota_leaver_consequence_MMRLossForLeaversTeam"	"Il Livello di abilità (MMR) della tua squadra, %s1, diminuirà."
"dota_leaver_consequence_MatchDiscardedForOtherPlayers"	"La partita non verrà registrata per gli altri giocatori."
"dota_leaver_consequence_NotDecrementLowPriGamesRemaining"	"La partita non verrà registrata come completata per te."
"dota_reconnect_popup_title"	"Riconnettersi?"
"dota_reconnect_popup_message"	"Vuoi riconnetterti alla partita?"
"dota_matchmaking_regions_refresh"	"Aggiorna"
"dota_matchmaking_region_ping"	"{s:region_ping}"
"dota_matchmaking_region_offline"	"Offline per manutenzione"
"dota_matchmaking_region_unknown_ping"	"Latenza: sconosciuta"
"dota_matchmaking_region_ping_time"	"Latenza: {i:ping_ms}ms"
"DOTA_VAC_Verification_Header"	"Valve Anti-Cheat (VAC)"
"DOTA_VAC_Verification_Header_Solo"	"Impossibile usare il sistema di ricerca di partite: qualcosa sul tuo computer sta bloccando il sistema VAC. Non usare programmi che interferiscono con il sistema VAC e controlla che Steam sia stato installato correttamente."
"DOTA_VAC_Verification_Button1"	"Altro"
"DOTA_VAC_Verification_Button2"	"Chiudi"
"dota_matchmaking_regions_button"	"{s:regions_selected}"
"dota_region_automatic"	"Regione: automatica"
"dota_regions_selected"	"Regioni: "
"dota_lobby_region_invalid"	"Nessuna"
"dota_play_no_language_selected"	"SCEGLI UNA LINGUA"
"dota_play_language"	"{s:match_language}"
"dota_play_language_many"	"LINGUE: {i:match_language_count}"
"dota_ready_fail"	"NON HAI ACCETTATO IN TEMPO"
"dota_ready_fail_desc"	"La partita era pronta, ma tu no e pertanto sei stato rimosso dalla coda di ricerca."
"dota_all_chat_label"	"[TUTTI]"
"dota_chatwheel_label_Ok"	"OK"
"dota_chatwheel_label_Care"	"Attenzione!"
"dota_chatwheel_label_GetBack"	"Tornate indietro!"
"dota_chatwheel_label_NeedWards"	"Servono Guardiani."
"dota_chatwheel_label_Stun"	"Stordiscilo!"
"dota_chatwheel_label_Help"	"Aiuto!"
"dota_chatwheel_label_Push"	"Spingete!"
"dota_chatwheel_label_GoodJob"	"Ben fatto!"
"dota_chatwheel_label_Missing"	"Manca qualcuno."
"dota_chatwheel_label_Missing_Top"	"Manca qualcuno in Top."
"dota_chatwheel_label_Missing_Mid"	"Manca qualcuno in Mid."
"dota_chatwheel_label_Missing_Bottom"	"Manca qualcuno in Bot."
"dota_chatwheel_label_Go"	"Via!"
"dota_chatwheel_label_Initiate"	"All'assalto!"
"dota_chatwheel_label_Follow"	"Seguitemi."
"dota_chatwheel_label_Group_Up"	"Raggruppatevi."
"dota_chatwheel_label_Spread_Out"	"Sparpagliatevi."
"dota_chatwheel_label_Split_Farm"	"Dividiamoci per ottenere oro ed esperienza."
"dota_chatwheel_label_Attack"	"Attaccate!"
"dota_chatwheel_label_BRB"	"Torno subito."
"dota_chatwheel_label_Dive"	"Tuffatevi!"
"dota_chatwheel_label_OMW"	"Sto arrivando."
"dota_chatwheel_label_Get_Ready"	"State pronti."
"dota_chatwheel_label_Bait"	"Fate da esca."
"dota_chatwheel_label_Heal"	"Cura."
"dota_chatwheel_label_Mana"	"Mana."
"dota_chatwheel_label_OOM"	"Sono senza mana."
"dota_chatwheel_label_Skill_Cooldown"	"Le mie abilità sono in ricarica."
"dota_chatwheel_label_Ulti_Ready"	"La mia ultimate è pronta."
"dota_chatwheel_label_Enemy_Returned"	"Il nemico è tornato."
"dota_chatwheel_label_All_Missing"	"I nemici sono spariti dalle corsie!"
"dota_chatwheel_label_Enemy_Incoming"	"Nemici in arrivo!"
"dota_chatwheel_label_Invis_Enemy"	"Nemico invisibile nelle vicinanze!"
"dota_chatwheel_label_Enemy_Had_Rune"	"Il nemico ha una Runa."
"dota_chatwheel_label_Split_Push"	"Spingete separati."
"dota_chatwheel_label_Coming_To_Gank"	"Arrivo per il gank."
"dota_chatwheel_label_Request_Gank"	"Richiedo un gank."
"dota_chatwheel_label_Fight_Under_Tower"	"Combattete sotto la torre."
"dota_chatwheel_label_Deny_Tower"	"Negate la torre!"
"dota_chatwheel_label_Buy_Courier"	"Qualcuno può acquistare il Corriere?"
"dota_chatwheel_label_Upgrade_Courier"	"Qualcuno può migliorare il Corriere?"
"dota_chatwheel_label_Need_Detection"	"Dobbiamo poterli vedere."
"dota_chatwheel_label_They_Have_Detection"	"Ci possono vedere."
"dota_chatwheel_label_Buy_TP"	"Acquistate una Pergamena."
"dota_chatwheel_label_Reuse_Courier"	"Riusate il Corriere."
"dota_chatwheel_label_Deward"	"Rimuovete i Guardiani nemici."
"dota_chatwheel_label_Building_Mek"	"Sto assemblando un Mekansm."
"dota_chatwheel_label_Building_Pipe"	"Sto assemblando una Pipa."
"dota_chatwheel_label_Stack_And_Pull"	"Ammassa e attira i creep."
"dota_chatwheel_label_Pull"	"Puoi attirare i creep?"
"dota_chatwheel_label_Pulling"	"Sto attirando i creep."
"dota_chatwheel_label_Stack"	"Ammassa i creep neutrali."
"dota_chatwheel_label_Jungling"	"Vado in giungla."
"dota_chatwheel_label_Roshan"	"Roshan."
"dota_chatwheel_label_Affirmative"	"Affermativo."
"dota_chatwheel_label_Wait"	"Aspettate!"
"dota_chatwheel_label_Pause"	"Mettete in pausa!"
"dota_chatwheel_label_Current_Time"	"Tempo attuale della partita"
"dota_chatwheel_label_Check_Runes"	"Controllate le Rune."
"dota_chatwheel_label_Smoke_Gank"	"Gank col Fumo del Raggiro!"
"dota_chatwheel_label_GLHF"	"Buona fortuna!"
"dota_chatwheel_label_Nice"	"Ottimo!"
"dota_chatwheel_label_Thanks"	"Grazie!"
"dota_chatwheel_label_Sorry"	"Scusatemi."
"dota_chatwheel_label_No_Give_Up"	"Non arrendetevi!"
"dota_chatwheel_label_Just_Happened"	"Visto che è successo?"
"dota_chatwheel_label_Game_Is_Hard"	"Questa partita è difficile."
"dota_chatwheel_label_New_Meta"	"Nuovo meta."
"dota_chatwheel_label_My_Bad"	"Colpa mia."
"dota_chatwheel_label_Regret"	"Mi pento immediatamente..."
"dota_chatwheel_label_Relax"	"Tranquilli."
"dota_chatwheel_label_GG"	"GG."
"dota_chatwheel_label_GGWP"	"GGWP."
"dota_chatwheel_label_All_GG"	"(Tutti) GG."
"dota_chatwheel_label_All_GGWP"	"(Tutti) GGWP."
"dota_chatwheel_label_What_To_Buy"	"Cosa dovrei comprare?"
"dota_chatwheel_label_Im_Retreating"	"Mi sto ritirando."
"dota_chatwheel_label_Space_Created"	"Vi ho dato spazio."
"dota_chatwheel_label_Whoops"	"Ops."
"dota_chatwheel_label_Tower_then_Back"	"Torre e poi si torna indietro."
"dota_chatwheel_label_Barracks_then_Back"	"Caserme e poi si torna indietro."
"dota_chatwheel_label_Ward_Bottom_Rune"	"Guardiano sulla Runa in Bot."
"dota_chatwheel_label_Ward_Top_Rune"	"Guardiano sulla Runa in Top."
"dota_chatwheel_label_Zeus_Ult"	"Zeus, usa l'ultimate!"
"dota_chatwheel_header_positioning"	"Posizionamento"
"dota_chatwheel_header_status"	"Stato"
"dota_chatwheel_header_enemy"	"Nemico"
"dota_chatwheel_header_lane"	"Corsia"
"dota_chatwheel_header_items"	"Oggetti"
"dota_chatwheel_header_neutrals"	"Neutrali"
"dota_chatwheel_header_misc"	"Vari"
"dota_chatwheel_header_flavor"	"Speciali"
"dota_chatwheel_message_Ok"	"OK."
"dota_chatwheel_message_Care"	"Fate attenzione!"
"dota_chatwheel_message_GetBack"	"Tornate indietro!"
"dota_chatwheel_message_NeedWards"	"Ci servono Guardiani."
"dota_chatwheel_message_Stun"	"Stordiscilo!"
"dota_chatwheel_message_Help"	"Aiuto!"
"dota_chatwheel_message_Push"	"Spingete!"
"dota_chatwheel_message_GoodJob"	"Ben fatto!"
"dota_chatwheel_message_Missing"	"Manca qualcuno!"
"dota_chatwheel_message_Missing_Top"	"Manca qualcuno in Top!"
"dota_chatwheel_message_Missing_Mid"	"Manca qualcuno in Mid!"
"dota_chatwheel_message_Missing_Bottom"	"Manca qualcuno in Bot!"
"dota_chatwheel_message_Go"	"Via!"
"dota_chatwheel_message_Initiate"	"All'assalto!"
"dota_chatwheel_message_Follow"	"Seguitemi."
"dota_chatwheel_message_Group_Up"	"Raggruppatevi."
"dota_chatwheel_message_Spread_Out"	"Sparpagliatevi."
"dota_chatwheel_message_Split_Farm"	"Dividiamoci per ottenere oro ed esperienza."
"dota_chatwheel_message_Attack"	"Attaccate!"
"dota_chatwheel_message_BRB"	"Torno subito."
"dota_chatwheel_message_Dive"	"Tuffatevi!"
"dota_chatwheel_message_OMW"	"Sto arrivando."
"dota_chatwheel_message_Get_Ready"	"State pronti."
"dota_chatwheel_message_Bait"	"Fate da esca."
"dota_chatwheel_message_Heal"	"Cura."
"dota_chatwheel_message_Mana"	"Mana."
"dota_chatwheel_message_OOM"	"Sono senza mana."
"dota_chatwheel_message_Skill_Cooldown"	"Le mie abilità sono in ricarica."
"dota_chatwheel_message_Ulti_Ready"	"La mia ultimate è pronta."
"dota_chatwheel_message_Enemy_Returned"	"Il nemico è ritornato."
"dota_chatwheel_message_All_Missing"	"Tutti gli Eroi nemici mancano dalle loro corsie!"
"dota_chatwheel_message_Enemy_Incoming"	"Nemici in arrivo!"
"dota_chatwheel_message_Invis_Enemy"	"Nemico invisibile nelle vicinanze!"
"dota_chatwheel_message_Enemy_Had_Rune"	"Il nemico ha una Runa."
"dota_chatwheel_message_Split_Push"	"Spingete separati."
"dota_chatwheel_message_Coming_To_Gank"	"Arrivo per il gank."
"dota_chatwheel_message_Request_Gank"	"Richiedo un gank."
"dota_chatwheel_message_Fight_Under_Tower"	"Combattete sotto la torre."
"dota_chatwheel_message_Deny_Tower"	"Negate la torre!"
"dota_chatwheel_message_Buy_Courier"	"Qualcuno può acquistare il Corriere?"
"dota_chatwheel_message_Upgrade_Courier"	"Qualcuno può migliorare il Corriere?"
"dota_chatwheel_message_Need_Detection"	"Dobbiamo poterli vedere."
"dota_chatwheel_message_They_Have_Detection"	"Ci possono vedere."
"dota_chatwheel_message_Buy_TP"	"Acquistate una Pergamena del Portale Cittadino."
"dota_chatwheel_message_Reuse_Courier"	"Riusate il Corriere."
"dota_chatwheel_message_Deward"	"Rimuovete i Guardiani nemici."
"dota_chatwheel_message_Building_Mek"	"Sto assemblando un Mekansm."
"dota_chatwheel_message_Building_Pipe"	"Sto assemblando una Pipa dell'Intuizione."
"dota_chatwheel_message_Stack_And_Pull"	"Ammassa i creep neutrali e attira i nostri verso di loro."
"dota_chatwheel_message_Pull"	"Puoi attirare i creep?"
"dota_chatwheel_message_Pulling"	"Sto attirando i creep."
"dota_chatwheel_message_Stack"	"Ammassa i creep neutrali."
"dota_chatwheel_message_Jungling"	"Vado in giungla."
"dota_chatwheel_message_Roshan"	"Roshan."
"dota_chatwheel_message_Affirmative"	"Affermativo."
"dota_chatwheel_message_Wait"	"Aspettate!"
"dota_chatwheel_message_Pause"	"Mettete in pausa la partita, per favore!"
"dota_chatwheel_message_Current_Time"	"Tempo attuale della partita"
"dota_chatwheel_message_Check_Runes"	"Controllate le Rune."
"dota_chatwheel_message_Smoke_Gank"	"Facciamo un gank col Fumo del Raggiro!"
"dota_chatwheel_message_GLHF"	"Buona fortuna, divertitevi!"
"dota_chatwheel_message_Nice"	"Ottimo!"
"dota_chatwheel_message_Thanks"	"Grazie!"
"dota_chatwheel_message_Sorry"	"Scusatemi."
"dota_chatwheel_message_No_Give_Up"	"Non arrendetevi!"
"dota_chatwheel_message_Just_Happened"	"Avete visto che è successo?"
"dota_chatwheel_message_Game_Is_Hard"	"Questa partita è difficile."
"dota_chatwheel_message_New_Meta"	"Nuovo meta."
"dota_chatwheel_message_My_Bad"	"Colpa mia."
"dota_chatwheel_message_Regret"	"Mi pento immediatamente della mia decisione."
"dota_chatwheel_message_Relax"	"Tranquilli, state andando bene."
"dota_chatwheel_message_MissingHero"	"Non vedo più %s1!"
"dota_chatwheel_message_ReturnedHero"	"Rivedo %s1!"
"dota_chatwheel_message_GG"	"Bella partita."
"dota_chatwheel_message_GGWP"	"Bella partita, avete giocato bene!"
"dota_chatwheel_message_All_GG"	"Bella partita."
"dota_chatwheel_message_All_GGWP"	"Bella partita, avete giocato bene!"
"dota_chatwheel_message_What_To_Buy"	"Cosa dovrei comprare?"
"dota_chatwheel_message_Im_Retreating"	"Mi sto ritirando."
"dota_chatwheel_message_Space_Created"	"Vi ho dato spazio."
"dota_chatwheel_message_Whoops"	"Ops."
"dota_chatwheel_message_Tower_then_Back"	"Distruggete la torre, poi tornate indietro."
"dota_chatwheel_message_Barracks_then_Back"	"Distruggete le caserme, poi tornate indietro."
"dota_chatwheel_message_Ward_Bottom_Rune"	"Mettete un Guardiano sulla Runa in Bot."
"dota_chatwheel_message_Ward_Top_Rune"	"Mettete un Guardiano sulla Runa in Top."
"dota_chatwheel_message_Zeus_Ult"	"Zeus, usa l'ultimate!"
"dota_settings_hotkeys"	"Scorciatoie"
"dota_settings_options"	"Opzioni"
"dota_settings_audio"	"Audio"
"dota_settings_voice"	"Voce"
"dota_settings_voice_level"	"Volume in trasmissione della voce"
"dota_settings_voice_steam_link"	"Puoi configurare il dispositivo di registrazione dalle <a href=\"event:DOTAShowSteamVoiceSettings()\">impostazioni della voce di Steam</a>."
"dota_settings_volume"	"Volume"
"dota_settings_video"	"Video"
"dota_settings_resetkeys"	"Reimposta scorciatoie..."
"dota_settings_legacykeys"	"Usa i tasti originali"
"dota_settings_abilities"	"Abilità"
"dota_settings_abilities_hero"	"Eroe"
"dota_settings_abilities_neutrals"	"Neutrali"
"dota_settings_abilities_courier"	"Corriere"
"dota_settings_abilities_primary1"	"1"
"dota_settings_abilities_primary2"	"2"
"dota_settings_abilities_primary3"	"3"
"dota_settings_abilities_secondary1"	"4"
"dota_settings_abilities_secondary2"	"5"
"dota_settings_abilities_neutral1"	"1"
"dota_settings_abilities_neutral2"	"2"
"dota_settings_abilities_neutral3"	"3"
"dota_settings_abilities_neutral4"	"4"
"dota_settings_abilities_courier1"	"1"
"dota_settings_abilities_courier2"	"2"
"dota_settings_abilities_courier3"	"3"
"dota_settings_abilities_courier4"	"4"
"dota_settings_abilities_courier5"	"5"
"dota_settings_abilities_courier6"	"6"
"dota_settings_abilities_ultimate"	"U"
"dota_settings_cast"	"Uso"
"dota_settings_autocast"	"Uso autom."
"dota_settings_quickcast"	"Uso rapido"
"dota_settings_mirror"	"Copia le scorciatoie del pannello \"Eroe\""
"dota_settings_abilitylearn"	"Apprendi abilità"
"dota_settings_upgradestats"	"Migliora le statistiche"
"dota_settings_unitactions"	"Azioni delle Unità"
"dota_settings_attack"	"Muovi e attacca / Attacco forzato"
"dota_settings_move"	"Muovi / Insegui"
"dota_settings_stop"	"Ferma"
"dota_settings_holdposition"	"Mantieni la posizione"
"dota_settings_selecthero"	"Seleziona l'Eroe"
"dota_settings_selectall"	"Seleziona tutte le Unità"
"dota_settings_selectallothers"	"Seleziona tutte le altre Unità"
"dota_settings_selectcourier"	"Seleziona il corriere"
"dota_settings_courierdeliver"	"Corriere: consegna gli oggetti"
"dota_settings_courierhaste"	"Corriere: usa lo Scatto"
"dota_settings_useactionitem"	"Oggetto ad attivazione"
"dota_settings_herotaunt"	"Provocazione"
"dota_settings_items"	"Oggetti"
"dota_settings_openshop"	"Apri il Negozio"
"dota_settings_purchasequickbuy"	"Acquisto rapido"
"dota_settings_purchasesticky"	"Acquista l'oggetto in evidenza"
"dota_settings_grabstashitems"	"Prendi gli oggetti dalla Scorta"
"dota_settings_camera"	"Telecamera"
"dota_settings_cameraactions"	"Azioni della telecamera"
"dota_settings_cameraup"	"Telecamera in avanti"
"dota_settings_cameradown"	"Telecamera indietro"
"dota_settings_cameraleft"	"Telecamera a sinistra"
"dota_settings_cameraright"	"Telecamera a destra"
"dota_settings_cameragrip"	"Aggancia la telecamera"
"dota_settings_recentevent"	"Mostra l'evento più recente"
"dota_settings_inspectheroinworld"	"Visuale d'esibizione"
"dota_settings_chat"	"Chat"
"dota_settings_phrases"	"Frasi"
"dota_settings_chatwheel_page"	"Chat radiale"
"dota_settings_chatteam"	"Chat di squadra"
"dota_settings_chatglobal"	"Chat globale"
"dota_settings_chatvoice_party"	"Voce (gruppo)"
"dota_settings_chatvoice_team"	"Voce (squadra)"
"dota_settings_chatwheel_show"	"Chat radiale"
"dota_settings_playeractions"	"Azioni del giocatore"
"dota_settings_activateglyph"	"Attiva il Glifo della fortificazione"
"dota_settings_scoreboardtoggle"	"Punteggi"
"dota_settings_pause"	"Metti in pausa la partita"
"dota_settings_screenshot"	"Scatta uno screenshot"
"dota_settings_console"	"Console"
"dota_settings_controlgroups"	"Gruppi di controllo"
"dota_settings_controlgroupsadditional"	"Altri gruppi di controllo"
"dota_settings_controlgroupcycle"	"Scorri tra le Unità controllabili"
"dota_settings_group1"	"Gruppo 1"
"dota_settings_group2"	"Gruppo 2"
"dota_settings_group3"	"Gruppo 3"
"dota_settings_group4"	"Gruppo 4"
"dota_settings_group5"	"Gruppo 5"
"dota_settings_group6"	"Gruppo 6"
"dota_settings_group7"	"Gruppo 7"
"dota_settings_group8"	"Gruppo 8"
"dota_settings_group9"	"Gruppo 9"
"dota_settings_group10"	"Gruppo 10"
"dota_settings_advancedpanel_goto"	"Avanzate"
"dota_settings_standardpanel_goto"	"Standard"
"dota_settings_spectatorandreplay"	"Controlli da spettatore/replay"
"dota_settings_spectatorandreplay_pt2"	"Controlli da spettatore/replay, 2"
"dota_settings_spectatorcameraup"	"Spettatore: telecamera in avanti"
"dota_settings_spectatorcameradown"	"Spettatore: telecamera indietro"
"dota_settings_spectatorcameraleft"	"Spettatore: telecamera a sinistra"
"dota_settings_spectatorcameraright"	"Spettatore: telecamera a destra"
"dota_settings_spectatorcameragrip"	"Spettatore: aggancia la telecamera"
"dota_settings_spectatorpause"	"Spettatore: pausa"
"dota_settings_spectatorchat"	"Chat degli spettatori"
"dota_settings_spectatorscoreboard"	"Spettatore: punteggi"
"dota_settings_spectatorbroadcastermenu"	"Apri il menu da commentatore"
"dota_settings_spectatorincreasereplayspeed"	"Aumenta la velocità del replay"
"dota_settings_spectatordecreasereplayspeed"	"Riduci la velocità del replay"
"dota_settings_spectatorstatsharvest"	"Spettatore: statistiche di guadagno"
"dota_settings_spectatorstatsitem"	"Spettatore: statistiche degli oggetti"
"dota_settings_spectatorstatsgold"	"Spettatore: grafico dell'oro"
"dota_settings_spectatorstatsxp"	"Spettatore: grafico dell'ESP"
"dota_settings_spectatorstatsfantasy"	"Spettatore: statistiche del FantaDota"
"dota_settings_spectatorfowboth"	"Spettatore: nebbia per le due squadre"
"dota_settings_spectatorfowradient"	"Spettatore: nebbia per i Radiant"
"dota_settings_spectatorfowdire"	"Spettatore: nebbia per i Dire"
"dota_settings_statsdropdown"	"Statistiche a comparsa"
"dota_settings_spectatordropdown_sort"	"Cambia ordine"
"dota_settings_spectatordropdown_close"	"Chiudi categoria"
"dota_settings_spectatordropdown_kda"	"Uccisioni/Morti/Aiuti"
"dota_settings_spectatordropdown_lasthits_denies"	"Colpi di grazia/Negazioni"
"dota_settings_spectatordropdown_level"	"Livello degli Eroi"
"dota_settings_spectatordropdown_xp_per_min"	"ESP al minuto"
"dota_settings_spectatordropdown_gold"	"Oro attuale"
"dota_settings_spectatordropdown_totalgold"	"Valore netto"
"dota_settings_spectatordropdown_gold_per_min"	"Oro al minuto"
"dota_settings_spectatordropdown_buyback"	"Stato dei rientri"
"dota_settings_spectatordropdown_fantasy"	"Punteggi del FantaDota"
"dota_settings_coaching"	"Mentore"
"dota_settings_spectatorcoach_viewtoggle"	"Mentore: prospettiva dell'allievo"
"dota_settings_keyboardtemplate"	"Scegli un modello per la tastiera"
"dota_settings_or"	"O"
"dota_settings_cancel"	"Annulla"
"dota_settings_apply"	"Applica"
"dota_settings_game"	"Gioco"
"dota_settings_autoattack"	"Auto-attacco"
"dota_settings_attackafterspell"	"Auto-attacca dopo aver usato un'abilità"
"dota_settings_autopurchase"	"Acquista automaticamente gli oggetti"
"dota_settings_autoselect"	"Seleziona automaticamente le Unità evocate"
"dota_settings_doubletapself"	"Premere due volte sull'abilità per usarla su di sé"
"dota_settings_unifiedorders"	"Ordini unificati delle Unità"
"dota_settings_teleportrequireshalt"	"Interrompi i teletrasporti solo col comando Ferma"
"dota_settings_herofinder"	"ALT evidenzia gli Eroi"
"dota_settings_alwaysshownames"	"Mostra i nomi dei giocatori sulle loro barre della salute"
"dota_settings_showhitpoints"	"Mostra i punti salute sulle barre della salute"
"dota_settings_forceshophotkeys"	"Il Negozio usa sempre le scorciatoie"
"dota_settings_usebroadcastermenu"	"Usa le statistiche dei commentatori"
"dota_settings_colorblind"	"Modalità per daltonici"
"dota_settings_reducedflash"	"Effetti luminosi ridotti"
"dota_settings_minimap"	"Minimappa"
"dota_settings_minimapsimplecolors"	"Usa colori semplificati sulla minimappa"
"dota_settings_minimaphidebackground"	"Nascondi lo sfondo della minimappa"
"dota_settings_cameradecel"	"Decelerazione della telecamera"
"dota_settings_cameraspeed"	"Velocità della telecamera"
"dota_settings_camerareversegrip"	"Inverti l'aggancio della telecamera"
"dota_settings_cameraedgepan"	"Permetti di scorrere la telecamera ai lati dello schermo"
"dota_settings_camerascreenshake"	"Attiva il tremolio dello schermo"
"dota_settings_cameraresetonspawn"	"Centra la telecamera sul tuo Eroe alla rinascita"
"dota_settings_cameradeadcolorshift"	"La telecamera cambia colore mentre sei morto"
"dota_settings_profile"	"Profilo"
"dota_settings_hideprofile"	"Nascondi i profili di Dota e Steam"
"dota_settings_exposematchdata"	"Condividi i dati delle partite pubbliche"
"dota_settings_ignorenonfriendparties"	"Blocca gli inviti ai gruppi di chi non è tuo amico"
"dota_settings_ignorenonfriendguilds"	"Blocca gli inviti alle gilde di chi non è tuo amico"
"dota_settings_allowtradeinvitesheader"	"Permetti gli scambi da:"
"dota_settings_trade_guildandfriends"	"Compagni di gilda ed amici"
"dota_settings_trade_friends"	"Solo dagli amici"
"dota_settings_trade_anyone"	"Tutti"
"dota_settings_network"	"Rete"
"dota_settings_networkquality"	"Qualità della connessione"
"dota_settings_networkquality_low"	"Bassa"
"dota_settings_networkquality_high"	"Alta"
"dota_settings_usenativeresolution"	"Usa la risoluzione attuale del monitor"
"dota_settings_customresolution"	"Usa le impostazioni avanzate"
"dota_settings_resolution"	"Risoluzione"
"dota_settings_rendering"	"Rendering"
"dota_settings_aspectratio"	"Formato d'immagine"
"dota_settings_aspectratio43"	"4:3"
"dota_settings_aspectratio169"	"16:9"
"dota_settings_aspectratio1610"	"16:10"
"dota_settings_resolution_size"	"Dimensioni"
"dota_settings_resolution_display_mode"	"Modalità di visualizzazione"
"dota_settings_fullscreen"	"Solo schermo intero"
"dota_settings_window"	"Finestra"
"dota_settings_borderless"	"Finestra senza bordi"
"dota_settings_videodefaults"	"Ripristina impostazioni predefinite"
"dota_settings_basicvideosettings"	"Usa impostazioni di base"
"dota_settings_fastestvideo"	"Velocità"
"dota_settings_appearancevideo"	"Qualità"
"dota_settings_advancedvideosettings"	"Usa impostazioni avanzate"
"dota_settings_antialiasing"	"Antialiasing"
"dota_settings_specular"	"Speculare"
"dota_settings_bloom"	"Scintille luminose e speculari"
"dota_settings_waterquality"	"Acqua di alta qualità"
"dota_settings_fog"	"Nebbia atmosferica"
"dota_settings_animateportrait"	"Ritratto animato"
"dota_settings_additivelight"	"Passaggio di luce additiva"
"dota_settings_worldlight"	"Illuminazione ambientale"
"dota_settings_ambientocclusion"	"Occlusione ambientale"
"dota_settings_ambientcreatures"	"Creature ambientali"
"dota_settings_normal_maps"	"Normal map"
"dota_settings_vsync"	"Sincronizzazione verticale"
"dota_settings_renderquality"	"Qualità del rendering del gioco"
"dota_settings_shadowquality"	"Qualità delle ombre"
"dota_settings_shadowquality_low"	"Bassa"
"dota_settings_shadowquality_med"	"Media"
"dota_settings_shadowquality_high"	"Alta"
"dota_settings_texturequality"	"Qualità delle texture"
"dota_settings_texturequality_low"	"Bassa"
"dota_settings_texturequality_med"	"Media"
"dota_settings_texturequality_high"	"Alta"
"dota_settings_mastervolume"	"Volume principale"
"dota_settings_gamevolume"	"Suoni di gioco"
"dota_settings_musicvolume"	"Musica"
"dota_settings_voicevolume"	"Voce"
"dota_settings_gamevoicevolume"	"Dialoghi delle Unità"
"dota_settings_openmic"	"Attiva il microfono aperto per comunicare con i giocatori del gruppo"
"dota_settings_openmicthreshold"	"Soglia del microfono aperto"
"dota_settings_audiodefaults"	"Impostazioni audio predefinite"
"dota_settings_defaultaudio"	"Predefinita"
"dota_settings_sounddevice"	"Dispositivo audio:"
"dota_settings_speakerconfig"	"Modalità degli altoparlanti:"
"dota_settings_headphones"	"Cuffie"
"dota_settings_2speakers"	"2 altoparlanti"
"dota_settings_4speakers"	"4 altoparlanti"
"dota_settings_5speakers"	"Altoparlanti 5.1"
"dota_settings_7speakers"	"Altoparlanti 7.1"
"dota_settings_captions"	"Attiva i sottotitoli"
"dota_settings_playsoundinbackground"	"Riproduci il suono del gioco in background"
"dota_settings_chatsounds"	"Suono dei messaggi di chat"
"dota_settings_mutecobroadcasters"	"Silenzia i co-commentatori"
"dota_settings_highqualityaudio"	"Audio di alta qualità"
"dota_settings_enhancestereo"	"Modalità stereo migliorata"
"dota_settings_unitspeeh"	"Dialoghi delle Unità"
"dota_settings_unitspeech_off"	"No"
"dota_settings_unitspeech_events"	"Eventi"
"dota_settings_unitspeech_all"	"Completo"
"OS_Default_Device"	"Dispositivo predefinito"
"DOTA_Keybind_ARROW"	"Frecce direzionali (predefinito)"
"DOTA_Keybind_WASD"	"WASD"
"DOTA_Keybind_MMO"	"MMO"
"DOTA_Keybind_LEGACY"	"Tasti originali"
"DOTA_Keybind_LOL"	"League of Legends"
"DOTA_Keybind_HON"	"Heroes of Newerth"
"DOTA_Keybind_SMITE"	"Smite"
"DOTA_Hotkeys_Tooltip_LearnAbility"	"Ti permette di apprendere o migliorare le abilità quando hai dei punti abilità da spendere."
"DOTA_Hotkeys_Tooltip_LearnStats"	"Aggiunge due punti a ciascuna delle tue statistiche quando hai punti abilità da spendere."
"DOTA_Hotkeys_Tooltip_HeroAttack"	"Ti muovi verso un punto, fermandoti per attaccare i nemici che incontri / Attacchi un'Unità alleata, se è negabile."
"DOTA_Hotkeys_Tooltip_HeroMove"	"Ti fa muovere verso un punto o ti fa seguire un'Unità senza attaccarla."
"DOTA_Hotkeys_Tooltip_HeroStop"	"Interrompe l'azione in corso."
"DOTA_Hotkeys_Tooltip_HeroHold"	"Interrompe l'azione in corso e ti fa mantenere la posizione."
"DOTA_Hotkeys_Tooltip_HeroSelect"	"Seleziona il tuo Eroe."
"DOTA_Hotkeys_Tooltip_SelectAll"	"Seleziona tutte le Unità sotto il tuo controllo."
"DOTA_Hotkeys_Tooltip_SelectAllOthers"	"Seleziona tutte le altre Unità che controlli (il tuo Eroe non verrà selezionato)."
"DOTA_Hotkeys_Tooltip_CourierSelect"	"Seleziona il Corriere."
"DOTA_Hotkeys_Tooltip_CourierDeliver"	"Ti fai consegnare gli oggetti nella Scorta dal Corriere."
"DOTA_Hotkeys_Tooltip_CourierHaste"	"Attivi il bonus alla velocità del Corriere, se è disponibile."
"DOTA_Hotkeys_Tooltip_UseActionItem"	"Usa l'oggetto ad attivazione."
"DOTA_Hotkeys_Tooltip_HeroTaunt"	"Usa la provocazione del tuo Eroe. Disponibile come oggetto equipaggiabile."
"DOTA_Hotkeys_Tooltip_ShopToggle"	"Apre il pannello del Negozio."
"DOTA_Hotkeys_Tooltip_PurchaseQuickbuy"	"Acquista il prossimo oggetto nella tua area di Acquisto rapido se te lo puoi permettere."
"DOTA_Hotkeys_Tooltip_PurchaseSticky"	"Acquista l'oggetto nell'area in evidenza se te lo puoi permettere."
"DOTA_Hotkeys_Tooltip_GrabStashItems"	"Trasferisce tutti gli oggetti dalla tua Scorta al tuo Eroe."
"DOTA_Hotkeys_Tooltip_RecentEvent"	"Sposta la telecamera verso l'evento più recente nella partita."
"DOTA_Hotkeys_Tooltip_InspectHeroInWorld"	"Ti fa osservare l'Unità selezionata da una prospettiva ravvicinata."
"DOTA_Hotkeys_Tooltip_ChatTeam"	"Ti fa scrivere un messaggio a tutti i membri della tua squadra."
"DOTA_Hotkeys_Tooltip_ChatGlobal"	"Ti fa scrivere un messaggio a tutti i giocatori della partita (aggiunge Maiusc come modificatore per la scorciatoia \"Chat di squadra\")."
"DOTA_Hotkeys_Tooltip_ChatVoiceParty"	"Ti fa usare il microfono per comunicare con i giocatori del gruppo. Attivando il microfono aperto, potrai usare il comando anche nella dashboard."
"DOTA_Hotkeys_Tooltip_ChatVoiceTeam"	"Ti fa usare il microfono per comunicare con i compagni di squadra."
"DOTA_Hotkeys_Tooltip_ChatWheel"	"Apre la chat radiale per comunicare usando frasi di uso comune."
"DOTA_Hotkeys_Tooltip_CameraGrip"	"Clicca e tieni premuto, quindi trascina il cursore per muovere la telecamera. Assegnato anche al pulsante centrale del mouse."
"DOTA_Hotkeys_Tooltip_ActivateGlyph"	"Attiva il Glifo della fortificazione per rendere le strutture della tua squadra invulnerabili per 5 secondi."
"DOTA_Hotkeys_Tooltip_ScoreboardToggle"	"Mostra i punteggi della partita."
"DOTA_Hotkeys_Tooltip_Pause"	"Mette in pausa o riprende la partita in corso."
"DOTA_Hotkeys_Tooltip_ScreenshotSettings"	"Scatta uno screenshot della visuale attuale del gioco."
"DOTA_Hotkeys_Tooltip_Console"	"Apre la console (solo per utenti esperti)."
"DOTA_Hotkeys_Tooltip_ControlGroupCycle"	"Ti fa scorrere tra le Unità del gruppo selezionato."
"DOTA_Hotkeys_Tooltip_Group"	"Seleziona un gruppo di controllo impostato in precedenza. Per definire un gruppo di controllo, seleziona le Unità desiderate e premi CTRL + una di queste scorciatoie."
"DOTA_Hotkeys_Tooltip_Legacy"	"Usa le scorciatoie associate a Dota 1. Le scorciatoie delle abilità cambieranno in base all'Eroe."
"DOTA_Hotkeys_Tooltip_Quickcast"	"Premendo la scorciatoia di utilizzo rapido assegnata a un'abilità, si attiverà sulla posizione attuale del cursore."
"DOTA_Hotkeys_Tooltip_Autocast"	"Attiva o disattiva l'utilizzo automatico dell'abilità quando è pronta. Disponibile solo per un numero limitato di abilità."
"DOTA_Hotkeys_Tooltip_Cast"	"Scorciatoie per l'utilizzo delle abilità dell'Eroe."
"DOTA_Hotkeys_Tooltip_ItemCast"	"Scorciatoie per l'utilizzo degli oggetti dell'inventario."
"DOTA_Hotkeys_Tooltip_ItemQuickcast"	"Premere la scorciatoia di utilizzo rapido assegnata a un oggetto lo attiverà sulla posizione attuale del cursore."
"DOTA_Settings_Tooltip_Autoattack"	"Ti permette di muoverti verso una posizione e di attaccare automaticamente ogni nemico nelle vicinanze."
"DOTA_Settings_Tooltip_AutoattackAfterSpell"	"Disattivando l'opzione, l'Eroe rimarrà immobile dopo aver usato un'abilità, in attesa del prossimo ordine."
"DOTA_Settings_Tooltip_AutoPurchase"	"Acquista automaticamente il prossimo oggetto della lista di quelli consigliati non appena hai abbastanza monete."
"DOTA_Settings_Tooltip_AutoSelectSummons"	"Fa sì che quando l'Eroe crea delle nuove Unità, queste vengano aggiunte alla tua selezione."
"DOTA_Settings_Tooltip_DoubleTap"	"Cliccare due volte su un'abilità o un oggetto, o premere due volte la scorciatoia farà sì che venga usata su te stesso."
"DOTA_Settings_Tooltip_UnifiedOrders"	"Tenendo premuto CTRL mentre invii un ordine, ogni Unità sotto il tuo controllo lo eseguirà."
"DOTA_Settings_Tooltip_TeleportStop"	"Il tuo Eroe potrà interrompere la canalizzazione del teletrasporto solo col comando Ferma. Solo per Pergamene e Stivali del Viaggiatore."
"DOTA_Settings_Tooltip_BroadcasterStats"	"Quando fai da spettatore, questa opzione ti mostrerà le statistiche a comparsa usate dal commentatore."
"DOTA_Settings_Tooltip_Deceleration"	"La velocità di arresto della telecamera dopo essere stata spostata. Un valore più alto indica un arresto più immediato."
"DOTA_Settings_Tooltip_Screenshake"	"Permette ad alcune abilità e stordimenti di scuotere la telecamera."
"DOTA_Settings_Tooltip_CameraRespawn"	"Fa tornare la telecamera sul tuo Eroe non appena rinasce."
"DOTA_Settings_Tooltip_HideProfile"	"Il tuo profilo di Dota 2 non sarà accessibile da nessuno. Il tuo profilo di Steam non sarà visibile tramite Dota 2."
"DOTA_Settings_Tooltip_ShareMatchData"	"Con questa opzione abilitata, condividerai i dati delle tue partite pubbliche con terzi."
"DOTA_Settings_Tooltip_NetworkQuality"	"Se hai una connessione lenta, impostare l'opzione su \"Bassa\" potrebbe migliorare le tue prestazioni di rete."
"DOTA_Settings_Tooltip_MinimapSimple"	"I colori della minimappa vengono determinati in base alla squadra invece che in base ai giocatori."
"DOTA_Settings_Tooltip_MinimapNamesIcon"	"Le icone o i nomi degli Eroi sono sempre visibili sulla minimappa. Tenere premuto ALT mostrerà X e O per nemici e alleati."
"DOTA_Settings_Tooltip_ShopHotkeys"	"Le scorciatoie del Negozio avranno la priorità su altre funzioni assegnate agli stessi tasti mentre il Negozio è aperto."
"DOTA_Settings_LegacyKeysActive"	"L'opzione \"Usa i tasti originali\" è attiva. Disattivala per personalizzare le scorciatoie individuali."
"DOTA_create_bot_practice_desc"	"Usa il sistema di ricerca per trovare dei compagni di squadra con cui giocare contro i bot."
"DOTA_Lobby_BotDifficulty"	"Difficoltà dei bot"
"DOTA_Lobby_BotDifficulty_no_bot"	"Nessun bot"
"DOTA_Lobby_BotDifficulty_passive"	"Passiva"
"DOTA_Lobby_BotDifficulty_easy"	"Facile"
"DOTA_Lobby_BotDifficulty_medium"	"Normale"
"DOTA_Lobby_BotDifficulty_hard"	"Difficile"
"DOTA_Lobby_BotDifficulty_unfair"	"Sleale"
"DOTA_Lobby_BotTeam"	"Scegli una squadra"
"DOTA_create_bot_practice_solo"	"Pratica da solo"
"DOTA_create_bot_practice_solo_desc"	"Fai pratica da solo contro i bot in una partita locale. Se non usi il sistema di ricerca puoi smettere di giocare quando vuoi."
"DOTA_create_bot_practice_coop"	"Partita cooperativa"
"DOTA_create_bot_practice_coop_desc"	"Usa il sistema di ricerca per trovare altri giocatori con cui giocare una partita contro i bot. <font color='#dd6666'>NOTA:</font> le partite cooperative vanno giocate per intero; se abbandoni riceverai delle penalità."
"DOTA_Lobby_BotDifficulty_bot_passive"	"Bot passivo"
"DOTA_Lobby_BotDifficulty_bot_easy"	"Bot facile"
"DOTA_Lobby_BotDifficulty_bot_medium"	"Bot normale"
"DOTA_Lobby_BotDifficulty_bot_hard"	"Bot difficile"
"DOTA_Lobby_BotDifficulty_bot_unfair"	"Bot sleale"
"dota_lobby_title"	"{s:lobby_name}"
"dota_lobby_title_local_game"	"Lobby locale"
"dota_lobby_title_default"	"Lobby"
"lobby_row_player_name"	"{s:player_name}"
"dota_lobby_row_game_name"	"{s:game_name}"
"dota_lobby_row_slots"	"{s:slots}"
"dota_lobby_row_game_mode"	"{s:game_mode}"
"dota_lobby_row_join"	"Unisciti"
"dota_lobby_row_leave"	"Esci"
"dota_lobby_coaches_title"	"Mentori"
"dota_lobby_browser_all_game_modes"	"Tutte le modalità"
"dota_lobby_browser_title"	"Sfoglia le lobby di Dota"
"dota_lobby_browser_num_available"	"(disponibili: {d:lobbies_available})"
"dota_lobby_browser_no_lobbies"	"Nessuna lobby trovata"
"dota_lobby_browser_no_matching_lobbies"	"Nessuna lobby trovata con i filtri impostati"
"dota_lobby_browser_updating"	"Aggiornamento della lista delle lobby..."
"dota_lobby_browser_search_placeholder"	"Cerca lobby"
"dota_lobby_browser_game_mode"	"Modalità"
"dota_lobby_browser_refresh"	"Aggiorna"
"dota_lobby_browser_filter_title"	"Filtri delle lobby"
"dota_lobby_submit_filter"	"Applica"
"dota_popup_lobby_password_title"	"Inserisci la password della lobby"
"DOTA_AttackCapability_Melee"	"Da mischia"
"DOTA_AttackCapability_Ranged"	"A distanza"
"DOTA_Item_OnMarket"	"Mercato"
"DOTA_Items_DefaultSet"	"Set predefinito"
"DOTA_Items_SetEquipped_Label"	"Equipaggiato"
"DOTA_EquippedItem_Label"	"Equipaggiato"
"DOTA_PreviewingItem_Label"	"Anteprima:"
"DOTA_EquippedItem_Rarity"	"{s:equipped_econ_set_rarity}"
"DOTA_EquippedItem_SetName"	"{s:equipped_econ_set_name}"
"DOTA_EquippedItem_DefaultSet"	"Set predefinito"
"DOTA_EquippedItem_PartialSet"	"Set parziale"
"DOTA_EquippedItem_Style"	"Stili: {i:equipped_econ_set_style_count}"
"DOTA_EquippedItem_Button_Details"	"{s:equipped_details_button_text}"
"DOTA_EquippedItem_Customize"	"Personalizza"
"DOTA_EquippedItem_CustomSet"	"Set personalizzato"
"DOTA_EquippedItem_Equip"	"Equipaggia"
"DOTA_EquippedItem_Unpack_And_Equip"	"Apri e equipaggia"
"DOTA_EquippedItem_Details"	"{s:equipped_econ_set_type_name} - Dettagli"
"DOTA_EquippedItem_Purchase_Button"	"Acquista"
"DOTA_EquippedItem_Marketplace_Button"	"Mercato"
"DOTA_EquippedItem_BundleName"	"Incluso nel pacchetto \"{s:equipped_econ_set_bundle}\""
"DOTA_EquippedItem_FilterText"	"In anteprima"
"DOTA_EquippedItem_SaleAmount"	"-{i:equipped_econ_set_sale_amount}%"
"DOTA_EquippedItem_RegularSetPrice"	"{s:equipped_econ_regular_set_price}"
"DOTA_EquippedItem_SetPrice"	"{s:equipped_econ_set_price}"
"DOTA_EquippedItem_TreasurePrice"	"{s:equipped_econ_treasure_price}"
"DOTA_HeroDemo_Button"	"Prova {s:econ_item_category_name}"
"DOTA_HeroDemo_Button_Tooltip"	"Avvia la modalità di prova per provare questo set o le abilità dell'Eroe scelto"
"DOTA_HeroDemo_Button_Return"	"Torna in gioco"
"DOTA_HeroDemo_Button_Return_Tooltip"	"Torna alla modalità di prova con il nuovo Eroe o set scelto"
"DOTA_HeroDemo_Button_DBQuit"	"Esci dalla modalità di prova"
"DOTA_EquippedItem_Bundle"	"Pacchetto"
"DOTA_EquippedItem_ItemSet"	"Set"
"DOTA_EquippedItem_Item"	"Oggetto"
"DOTA_EconItemSet_Name"	"{s:econ_set_name}"
"DOTA_EconItemSet_Rarity"	"{s:econ_set_rarity}"
"DOTA_EconItemSet_Status"	"{s:econ_set_status}"
"DOTA_EconItemSet_Price"	"{s:econ_set_price}"
"DOTA_EconItemSet_SaleAmount"	"-{i:econ_sale_amount}%"
"DOTA_EconItemSet_DeveloperOnly"	"Privato"
"DOTA_EconItemSet_Tooltip_InBundle"	"Questo set è incluso in un pacchetto"
"DOTA_EconItemSet_Tooltip_PartialSet"	"Include solo una parte del set."
"DOTA_EconItemSet_Tooltip_MultipleStyles"	"Include vari stili"
"DOTA_HeroRole_Carry"	"Carry"
"DOTA_HeroRole_Support"	"Support"
"DOTA_HeroRole_Nuker"	"Nuker"
"DOTA_HeroRole_Disabler"	"Disabler"
"DOTA_HeroRole_Jungler"	"Jungler"
"DOTA_HeroRole_Durable"	"Durable"
"DOTA_HeroRole_Escape"	"Escape"
"DOTA_HeroRole_LaneSupport"	"Lane Support"
"DOTA_HeroRole_Pusher"	"Pusher"
"DOTA_HeroRole_Initiator"	"Initiator"
"DOTA_HeroRole_Description_Carry"	"Diventerà utile nelle fasi avanzate della partita se ottiene un considerevole vantaggio in oro."
"DOTA_HeroRole_Description_Support"	"Può concentrarsi sull'uso delle proprie abilità per fornire un vantaggio alla squadra, invece che sull'accumulo di oro ed oggetti."
"DOTA_HeroRole_Description_Nuker"	"Può uccidere velocemente gli Eroi nemici usando abilità che infliggono danni elevati."
"DOTA_HeroRole_Description_Disabler"	"Ha una o più abilità che possono disabilitare gli Eroi nemici."
"DOTA_HeroRole_Description_Jungler"	"Può uccidere efficacemente i creep neutrali nella giungla nelle prime fasi della partita."
"DOTA_HeroRole_Description_Durable"	"Resiste più a lungo nei combattimenti di squadra."
"DOTA_HeroRole_Description_Escape"	"Può scappare velocemente da situazioni mortali."
"DOTA_HeroRole_Description_LaneSupport"	"Utile nelle prime fasi della partita per proteggere i carry della tua squadra e permettergli di accumulare farm."
"DOTA_HeroRole_Description_Pusher"	"Può distruggere rapidamente le strutture nemiche ed esercitare una forte pressione sul fronte delle corsie."
"DOTA_HeroRole_Description_Initiator"	"Può iniziare efficacemente i combattimenti di squadra."
"DOTA_HeroGrid_OptionCategory_Role"	"Ruoli:"
"DOTA_HeroGrid_OptionCategory_Attributes"	"Attributi:"
"DOTA_HeroGrid_OptionCategory_AttackType"	"Tipo di attacco:"
"DOTA_HeroLoadout_PreviousHeroName"	"{s:previous_hero_name}"
"DOTA_HeroLoadout_NextHeroName"	"{s:next_hero_name}"
"DOTA_HeroLoadout_CurrentHeroName"	"{s:hero_name}"
"DOTA_HeroLoadout_AttackType"	"{s:hero_attack_type}"
"DOTA_HeroLoadout_HeroFilterName"	"Eroe"
"DOTA_HeroLoadout_Search"	"Cerca tra gli oggetti per {s:hero_name}"
"DOTA_HeroCustomize_Title"	"Personalizza l'Eroe"
"DOTA_HeroCustomize_OwnedItems"	"Oggetti posseduti"
"DOTA_HeroCustomize_Slot"	"Slot"
"DOTA_HeroCustomize_SlotName"	"{s:slot_name}"
"DOTA_HeroCustomize_SlotEquippedItemName"	"{s:equipped_item_name}"
"DOTA_HeroCustomize_DefaultItemName"	"Oggetto predefinito"
"DOTA_HeroCustomize_PreviewItemName"	"{s:preview_item_name}"
"DOTA_HeroCustomize_PreviewStyle"	"{s:preview_style_name}"
"DOTA_HeroCustomize_PreviewItemSlot"	"{s:preview_item_slot}"
"DOTA_HeroCustomize_Rarity"	"{s:preview_item_rarity}"
"DOTA_HeroCustomize_StyleLocked"	"Prerequisito necessario"
"DOTA_UIEconItem_StyleIndex"	"{i:style_index}"
"dota_ready_up_num_accepted"	"Giocatori pronti: {i:num_accepted} / {i:total_players}"
"returning_top_of_queue"	"Ritorno alla ricerca di partite ad alta priorità..."
"returning_to_lobby"	"Ritorno alla lobby per cercare più giocatori..."
"GC_reconnecting"	"Ripristino della connessione al coordinatore del gioco..."
"GC_nosteam"	"Connessione a Steam perduta"
"GC_searching"	"Ricerca del coordinatore del gioco..."
"GC_noconnection"	"Non connesso al coordinatore del gioco."
"GC_connecting"	"Connessione al coordinatore del gioco..."
"GC_connected"	"Connesso al coordinatore del gioco."
"GC_down"	"Coordinatore del gioco attualmente offline."
"GC_Network_Full"	"Coordinatore del gioco attualmente a capacità massima."
"GC_Queue_Position"	"Coordinatore del gioco attualmente a capacità massima. Posizione in coda: {i:gc_queue_position}"
"GC_Queue_Wait_Time"	"Coordinatore del gioco attualmente a capacità massima. Posizione in coda: {i:gc_queue_position}; tempo di attesa stimato: {s:gc_queue_wait_time}"
"GC_Wait_Time"	"Tempo di attesa stimato: %s1"
"GC_Wait_Time_Unknown"	"Sconosciuto"
"GC_suspended"	"Account sospeso in seguito all'utilizzo di strumenti esterni collegati a Dota 2 rilevati dal sistema Valve Anti-Cheat."
"dota_practice_vs_bots"	"Avvia la pratica contro i bot"
"dota_practice_vs_bots_desc"	"Gioca una partita di pratica contro i bot. Dato che non viene usato il sistema di ricerca puoi smettere di giocare quando vuoi."
"dota_practice_vs_bots_difficulty"	"Difficoltà dei bot"
"dota_practice_vs_bots_team"	"In che squadra vuoi giocare?"
"DOTA_practice_vs_bots_team_radiant"	"Radiant"
"DOTA_practice_vs_bots_team_dire"	"Dire"
"DOTA_practice_vs_bots_team_random"	"Casuale"
"DOTA_EmoticonUpsell"	"Puoi sbloccare più emoticon acquistando specifici oggetti o i biglietti di certe leghe."
"DOTA_CurrentTime"	"{t:t:current_time}"
"DOTA_MonthlyPlayers"	"{s:users_last_month}"
"DOTA_MonthlyPlayersLabel"	"giocatori univoci questo mese"
"DOTA_CurrentPlayers"	"{s:current_users}"
"DOTA_CurrentPlayersLabel"	"giocatori attualmente in gioco"
"DOTA_Search_NoResults"	"Nessun risultato"
"DOTA_Search_ItemShortDescription"	"{s:item_slot} - <span class=\"ItemRarityColor\">{s:item_rarity}</span>"
"join_error_already_in_game"	"Impossibile unirsi alla lobby di pratica, sei già in un'altra partita."
"join_error_invalid_lobby"	"La lobby scelta non esiste più."
"join_error_incorrect_password"	"Password non corretta."
"join_error_access_denied"	"Accesso negato."
"join_error_generic"	" "
"join_error_in_team_party"	"Impossibile unirsi alla lobby di pratica. Devi sciogliere il gruppo della squadra prima di unirti a una partita di pratica."
"join_error_lobby_full"	"La lobby è al completo."
"join_error_timed_out"	"Richiesta scaduta."
"DOTA_Friends_Ready_To_Play"	"Partite aperte"
"DOTA_Friend_Finding_Match"	"Alla ricerca di una partita..."
"DOTA_Friend_In_Match"	"In una partita"
"DOTA_Friend_Solo_Open_Party"	"{s:player_name} è disponibile per giocare"
"DOTA_Friend_In_Party_Open"	"{s:player_name} è in un gruppo aperto"
"DOTA_Friend_Solo_Open_Party_Self"	"Stai cercando altri giocatori per il gruppo"
"DOTA_Friend_In_Open_Party_Self"	"Sei in un gruppo aperto"
"DOTA_Friends_In_Party_Open"	"{d:num_friends} amici in un gruppo aperto"
"DOTA_Friend_Lobby_Mode_Self"	"Sei in una lobby di \"{s:game_mode}\""
"DOTA_Friend_Lobby_Mode_1_Friend"	"{s:player_name} è in una lobby di \"{s:game_mode}\""
"DOTA_Friend_Lobby_Mode_N_Friends"	"{d:num_friends} amici in una lobby di \"{s:game_mode}\""
"DOTA_Friend_Lobby_Mode_Small"	"Lobby di \"{s:game_mode}\""
"DOTA_Friend_Lobby_Players"	"{d:player_count} / {d:max_player_count}"
"DOTA_Friend_Lobby_Join_Button"	"{s:join_button_text}"
"DOTA_Friend_Lobby_Friend_Count"	"+{d:extra_friend_count}"
"DOTA_Friend_Invite_To_Party"	"Invita nel gruppo"
"DOTA_Friend_SuggestInviteToParty"	"Proponi l'invito al gruppo"
"DOTA_Request_Join_Party"	"Chiedi di unirti al gruppo"
"DOTA_Request_Merge_Parties"	"Chiedi di unire i gruppi"
"DOTA_Request_Merge_Parties_NotLeader"	"Il leader può richiedere l'unione dei gruppi."
"DOTA_Friend_PartyInvitePending"	"Invito al gruppo in sospeso"
"DOTA_Friend_PartyInvitePending_Leader"	"Invito al gruppo in sospeso<br/>Clicca qui per annullare l'invito"
"DOTA_Friend_PartyMergeRequestPending"	"Richiesta di fusione dei gruppi in sospeso"
"DOTA_Friend_PartyMergeRequestPending_Leader"	"Richiesta di fusione dei gruppi in sospeso<br/>Clicca qui per annullare la richiesta"
"DOTA_Friend_JoinParty"	"Unisciti al gruppo"
"DOTA_Friend_Watch"	"Guarda"
"DOTA_PartyVisTooltip_SoloTitleOpen"	"Disponibile per giocare"
"DOTA_PartyMerge_Error_Title"	"Richiesta non riuscita"
"DOTA_PartyMerge_Error_NOT_LEADER"	"Le richieste riguardanti il gruppo possono essere gestite solo dal leader"
"DOTA_PartyMerge_Error_TOO_MANY_PLAYERS"	"Impossibile unire i gruppi: ci sono troppi giocatori."
"DOTA_PartyMerge_Error_TOO_MANY_COACHES"	"Impossibile unire i gruppi: ci sono troppi mentori."
"DOTA_PartyMerge_Error_ENGINE_MISMATCH"	"Impossibile unire i gruppi: l'altro gruppo sta giocando a una versione diversa di Dota"
"DOTA_PartyMerge_Error_NO_SUCH_GROUP"	"Il gruppo non esiste più."
"DOTA_PartyMerge_Error_OTHER_GROUP_NOT_OPEN"	"Il gruppo non accetta le richieste."
"DOTA_Feed_Timestamp_Recently"	"Proprio ora"
"DOTA_Feed_Timestamp_MinutesAgo"	"{i:value} minuti fa"
"DOTA_Feed_Timestamp_HourAgo"	"{i:value} ora fa"
"DOTA_Feed_Timestamp_HoursAgo"	"{i:value} ore fa"
"DOTA_Feed_Timestamp_Yesterday"	"Ieri"
"DOTA_Feed_Timestamp_Date"	"{s:day} {s:month}"
"dota_lobby_type_general"	"Non classificata"
"dota_lobby_type_practice"	"Pratica"
"dota_lobby_type_practice_game_mode_custom"	"Modalità personalizzata"
"dota_lobby_type_tournament"	"Torneo"
"dota_lobby_type_coop_bot"	"Coop con i bot"
"dota_lobby_type_competitive"	"Classificata"
"dota_lobby_type_casual_1v1"	"Partita 1vs1"
"dota_lobby_unknown"	"Sconosciuto"
"DOTA_Lobby_No_Players_Title"	"NESSUN GIOCATORE IN SQUADRA"
"DOTA_Lobby_No_Players_Desc"	"Devi avere almeno un giocatore nei Radiant o i Dire."
"dota_match_result_won"	"Vittoria"
"dota_match_result_lost"	"Sconfitta"
"dota_match_result_none"	"???"
"dota_social_feed_loading"	"Caricamento..."
"DOTA_LoadingPlayerUnknown"	"-"
"DOTA_LoadingPlayerLoading"	"Caricamento..."
"DOTA_LoadingPlayerFullyConnected"	"Pronto"
"DOTA_LoadingPlayerFailed"	"Non riuscito"
"LoadingScreenTimer"	"{t:d:countdown_timer_seconds}"
"HeroSelectionTimer"	"{i:timer_seconds}"
"LoadingScreenMapInfo"	"Mappa: {s:map_name}"
"LoadingScreenPlayersInfo"	"Giocatori: {i:players_loaded}/{i:players_total}"
"LoadingScreenSpectatorsInfo"	"Spettatori: {i:spectators_loaded}/{i:spectators_total}"
"custom_end_screen_victory_message"	"Vittoria di {s:winning_team_name}!"
"custom_end_screen_legend_player"	"Giocatore"
"custom_end_screen_legend_level"	"Livello"
"custom_end_screen_legend_hero"	"Eroe"
"custom_end_screen_legend_kills"	"U"
"custom_end_screen_legend_deaths"	"M"
"custom_end_screen_legend_assists"	"A"
"custom_end_screen_legend_items"	"Oggetti"
"custom_end_screen_legend_gold"	"Oro"
"custom_end_screen_legend_team_score"	"Punti"
"custom_scoreboard_hero_name_and_desc"	"Liv. {i:hero_level} - {s:hero_name}"
"CustomEndScreenClose"	"Chiudi"
"DOTA_Armory_Category_Heroes"	"Eroi"
"DOTA_Armory_Category_Companions"	"Creature"
"DOTA_Armory_Category_Couriers"	"Corrieri"
"DOTA_Armory_Category_Pets"	"Animaletti"
"DOTA_Armory_Category_World"	"Mondo di gioco"
"DOTA_Armory_Category_Wards"	"Guardiani"
"DOTA_Armory_Category_Weather"	"Effetti meteorologici"
"DOTA_Armory_Category_Effigies"	"Effigi"
"DOTA_Armory_Category_Interface"	"Interfaccia"
"DOTA_Armory_Category_Emoticons"	"Emoticon"
"DOTA_Armory_Category_LoadingScreens"	"Schermate di caricamento"
"DOTA_Armory_Category_HUDs"	"Skin dell'interfaccia"
"DOTA_Armory_Category_CursorPacks"	"Pacchetti di cursori"
"DOTA_Armory_Category_Audio"	"Audio"
"DOTA_Armory_Category_VoicePacks"	"Voci"
"DOTA_Armory_Category_AnnouncerPacks"	"Annunciatori"
"DOTA_Armory_Category_Music"	"Musiche"
"DOTA_Armory_Category_All"	"Tutto"
"DOTA_Armory_Category_Other"	"Oggetti vari"
"DOTA_Armory_Category_View"	"Mostra le categorie"
"DOTA_Armory_Filter"	"Imposta un filtro"
"DOTA_Armory_SortBy"	"Ordine:"
"DOTA_Armory_SortBy_Rarity"	"Rarità"
"DOTA_Armory_SortBy_Quality"	"Qualità"
"DOTA_Armory_SortBy_Name"	"Nome"
"DOTA_Armory_SortBy_Recent"	"Data di acquisizione"
"DOTA_Armory_SortBy_Sockets"	"Numero di incavi"
"DOTA_Armory_Search"	"Cerca tra gli oggetti dell'Arsenale"
"DOTA_Armory_ContextMenu_Socketing"	"Incastonamento"
"DOTA_Armory_ContextMenu_GiftWrap"	"Manda in dono"
"DOTA_Armory_ContextMenu_Delete"	"Elimina"
"dota_page_match_details_loading"	"Caricamento della partita..."
"dota_page_match_details_victory"	"Vittoria di: {s:winner}"
"dota_page_match_details_legend_player"	"Giocatore"
"dota_page_match_details_legend_level"	"Livello"
"dota_page_match_details_legend_hero"	"Eroe"
"dota_page_match_details_legend_kills"	"U"
"dota_page_match_details_legend_deaths"	"M"
"dota_page_match_details_legend_assists"	"A"
"dota_page_match_details_legend_items"	"Oggetti"
"dota_page_match_details_legend_gold"	"Oro"
"dota_page_match_details_legend_last_hits"	"Cdg"
"dota_page_match_details_legend_denies"	"Neg."
"dota_page_match_details_legend_gold_per_min"	"Oro/min"
"dota_page_match_details_legend_xp_per_min"	"Esp./min"
"dota_page_match_details_legend_winner_tooltip"	"Squadra vincitrice"
"dota_page_match_details_legend_kills_tooltip"	"Uccisioni"
"dota_page_match_details_legend_deaths_tooltip"	"Morti"
"dota_page_match_details_legend_assists_tooltip"	"Aiuti"
"dota_page_match_details_legend_last_hits_tooltip"	"Colpi di grazia sui creep"
"dota_page_match_details_legend_denies_tooltip"	"Negazioni di creep"
"dota_page_match_details_legend_gold_per_min_tooltip"	"Oro al minuto"
"dota_page_match_details_legend_xp_per_min_tooltip"	"Esperienza al minuto"
"dota_page_match_details_header_league_name"	"Nome della lega"
"dota_page_match_details_header_custom_game_map_name"	"Nome della mappa"
"dota_page_match_details_header_match_id"	"ID della partita"
"dota_page_match_details_header_game_mode"	"Modalità"
"dota_page_match_details_header_duration"	"Durata"
"dota_page_match_details_header_timestamp"	"Data / Ora della partita"
"dota_page_match_details_voting_votes"	"{i:num_votes} voti"
"dota_page_match_details_match_discussion"	"Discussioni sulla partita"
"dota_page_match_details_comment_placeholder"	"Scrivi un commento..."
"dota_page_match_details_comment_loading_comments"	"Caricamento dei commenti..."
"dota_page_match_details_comment_no_comments"	"Nessun commento disponibile per questa partita"
"dota_page_match_details_replay_existence_unknown"	"Ricerca del replay..."
"dota_page_match_details_replay_existence_cdn_found"	"Scarica il replay"
"dota_page_match_details_replay_existence_not_found"	"Replay non disponibile"
"dota_page_match_details_replay_existence_downloading"	"Download in corso..."
"dota_page_match_details_replay_existence_disk_found_replay"	"Guarda il replay"
"dota_page_match_details_replay_existence_disk_found_highlights"	"Guarda i momenti salienti"
"dota_page_match_details_replay_existence_wrong_engine"	"I replay delle partite di Source 1 non sono disponibili su Source 2"
"dota_profile_content_tab_activity_feed"	"Feed dell'attività"
"dota_profile_content_tab_recent_games"	"Partite recenti"
"dota_profile_recent_game_header_timestamp"	"Data / Ora"
"dota_profile_recent_game_header_hero_name"	"Eroe giocato"
"dota_profile_recent_game_header_result"	"Risultato"
"dota_profile_recent_game_header_duration"	"Durata"
"dota_profile_recent_game_header_type"	"Tipo"
"dota_profile_recent_game_result_win"	"Vittoria"
"dota_profile_recent_game_result_loss"	"Sconfitta"
"dota_profile_recent_game_result_abandon"	"Abbandono"
"dota_profile_recent_game_icon_source1"	"S1"
"dota_profile_hero_with_index"	"{d:hero_index} {s:hero_name}"
"dota_profile_hero"	"{s:hero_name}"
"dota_replay_manager_error_not_found"	"Impossibile trovare il replay sul CDN."
"dota_replay_manager_error_existing_partial"	"Eliminazione del file parziale del replay non riuscita."
"dota_replay_manager_error_creation_failure"	"Creazione del file parziale del replay non riuscita."
"dota_replay_manager_error_disk_full"	"Allocazione dello spazio per il file del replay non riuscita."
"dota_replay_manager_error_chunk_failed"	"Impossibile scaricare il file del replay."
"dota_replay_manager_error_write_failure"	"Scrittura del file parziale del replay non riuscita."
"dota_replay_manager_error_partial_compressed_open_failure"	"Apertura del file compresso del replay non riuscita."
"dota_replay_manager_error_partial_decompressed_open_failure"	"Apertura del file decompresso del replay non riuscita."
"dota_replay_manager_error_partial_decompression_failure"	"Decompressione del file del replay non riuscita."
"dota_replay_manager_error_partial_decompression_write_failure"	"Scrittura del file decompresso del replay non riuscita."
"dota_page_match_details_replay_error_not_found"	"Replay non trovato su disco."
"DOTA_tooltip_econ_item_name"	"{s:item_name}"
"DOTA_tooltip_econ_item_description"	"{s:item_description}"
"DOTA_tooltip_econ_item_set"	"Parte del set: <font color='#dddddd'>{s:item_set}</font>"
"DOTA_tooltip_econ_item_rarity_label"	"Rarità: "
"DOTA_tooltip_econ_item_rarity"	"{s:item_rarity}"
"DOTA_tooltip_econ_item_slot"	"Slot: {s:item_slot}"
"DOTA_tooltip_econ_item_gifter"	"{g:dota_persona:gifter_name}"
"DOTA_tooltip_econ_item_gift_received_date"	"Data di ricezione: {t:T:gift_received_date_time}"
"DOTA_tooltip_econ_item_market_restriction_permanent"	"Non vendibile"
"DOTA_tooltip_econ_item_gift_restriction_permanent"	"Non donabile"
"DOTA_tooltip_econ_item_gift_restriction_date"	"Donabile in data: {t:s:giftable_after_date_time}, ore {t:T:giftable_after_date_time}"
"DOTA_tooltip_econ_item_gem_type"	"{s:gem_type}"
"DOTA_tooltip_econ_item_gem_strange_count"	"{d:strange_count}"
"DOTA_tooltip_econ_item_gem_description"	"{s:gem_description}"
"DOTA_tooltip_econ_item_partner"	"{s:partner}"
"DOTA_econ_item_details_item_name"	"{s:item_name}"
"DOTA_econ_item_details_item_creation_date"	"DATA DI CREAZIONE: {t:l:creation_date}"
"DOTA_econ_item_details_set_includes"	"Include i seguenti oggetti:"
"DOTA_econ_item_details_item_set"	"Parte del set: <font color='#dddddd'>{s:item_set}</font>"
"DOTA_econ_item_details_rarity_label"	"Rarità: "
"DOTA_econ_item_details_item_rarity"	"{s:item_rarity}"
"DOTA_econ_item_details_item_slot"	"Slot: {s:item_slot}"
"DOTA_econ_item_details_item_description"	"{s:item_description}"
"DOTA_econ_item_details_gem_type"	"{s:gem_type}"
"DOTA_econ_item_details_gem_strange_count"	"{d:strange_count}"
"DOTA_econ_item_details_gem_description"	"{s:gem_description}"
"DOTA_Treasure_Name"	"{s:treasure_name}"
"DOTA_Treasure_Rarity"	"Tesoro - <span class=\"ItemRarityColor\">{s:treasure_rarity}</span>"
"DOTA_Voice_Party"	"Chat vocale del gruppo"
"custom_game_mismatch_title"	"Errore dei dati della modalità"
"custom_game_mismatch_desc"	"L'archivio della modalità personalizzata di client e server non corrisponde."
"custom_game_team_select"	"Scegli una squadra"
"custom_game_team_select_timer"	"{i:countdown_timer_seconds}"
"custom_game_team_select_shuffle"	"Mischia tutti"
"custom_game_team_select_auto_start"	"Inizio tra"
"custom_game_team_select_starting"	"Inizio"
"custom_game_team_select_unassigned_players"	"Giocatori non assegnati"
"custom_game_team_select_lock_start"	"Conferma e inizia"
"custom_game_team_select_cancel_unlock"	"Annulla e torna indietro"
"custom_game_team_select_join"	"Unisciti"
"custom_game_team_select_empty_slot"	"Slot vuoto"
"custom_game_team_select_auto_assign"	"Auto-assegna"
"custom_game_default_gameinfo_text"	"Torna presto per ulteriori informazioni su questa modalità personalizzata!"
"CouldntFindCompendium"	"Impossibile caricare il file di test del compendio: {s:s1}"
"CompendiumPageError_Pages"	"Impossibile trovare il blocco \"pages\" nel file di dati del compendio."
"CompendiumPageError_Template"	"Impossibile trovare l'elemento \"template\" per la pagina del compendio \"{s:s1}\" (pagina numero {s:s2})"
"CompendiumPageError_Template2"	"Impossibile trovare il template \"{s:s1}\" nella pagina del compendio \"{s:s2}\""
"CompendiumPageError_Image"	"Impossibile trovare l'immagine \"{s:s1}\" nella pagina del compendio \"{s:s2}\""
"CompendiumPageError_Text"	"Impossibile trovare il blocco di testo \"{s:s1}\" nella pagina del compendio \"{s:s2}\""
"CompendiumPageError_Video"	"Impossibile trovare il video \"{s:s1}\" nella pagina \"{s:s2}\" del compendio"
"CompendiumPageError_Scrollbar"	"Impossibile trovare la barra di scorrimento \"{s:s1}\" nella pagina del compendio \"{s:s2}\""
"CompendiumPageError_Selection"	"Impossibile trovare la selezione \"{s:s1}\" nella pagina del compendio \"{s:s2}\""
"CompendiumPageError_PageNames"	"La pagina incorporata \"{s:s1}\" ha lo stesso nome di un'altra pagina. I nomi delle pagine devono essere unici."
"CompendiumPageError_CustomText"	"Errore nel blocco di testo personalizzato \"{s:s1}\" nella pagina del compendio \"{s:s2}\"."
"CompendiumPageError_CustomImg"	"Errore nel blocco di immagine personalizzato \"{s:s1}\"."
"CompendiumPageError_CustomBar"	"Errore nella barra dei progressi personalizzata \"{s:s1}\" nella pagina \"{s:s2}\" del compendio"
"CompendiumPageError_CustomEle"	"L'istanza dell'elemento personalizzato \"{s:s1}\" nella pagina del compendio \"{s:s2}\" è fallita"
"CompendiumPageError_CTFont"	"Il font \"{s:s1}\" specificato nella pagina del compendio \"{s:s2}\" non è valido. Font validi:\ntext, textbold, title"
"CompendiumPageError_CTAlign"	"Valore di allineamento \"{s:s1}\" specificato nella pagina del compendio \"{s:s2}\" non valido. Valori di allineamento validi:\n left, right, center"
"CompendiumPageError_CTDepth"	"Il valore di profondità \"{s:s1}\" non è valido. Valori di profondità validi:\n front, back"
"CompendiumPageError_LinePos"	"La riga \"{s:s1}\" non ha i blocchi di posizione \"start\" e \"end\"."
"CompendiumPageError_CTPoints"	"Indice di selezione \"{s:s1}\" non valido nella sezione \"points\" del testo personalizzato \"{s:s2}\"."
"CompendiumPageError_CTPoints2"	"Indice di selezione \"{s:s1}\" non valido nella sezione \"points\" del testo personalizzato \"{s:s2}\". Non è stata trovata alcuna selezione con quell'indice."
"CompendiumPageError_SelDesc"	"Impossibile trovare una chiave \"description\" per la selezione \"{s:s1}\" nella pagina del compendio \"{s:s2}\""
"CompendiumPageError_Points"	"\"points\" specificati mancanti (o azzerati) per la selezione \"{s:s1}\" della pagina del compendio \"{s:s2}\""
"CompendiumPageError_SelType"	"\"choice_type\" per la selezione \"{s:s1}\" della pagina del compendio \"{s:s2}\""
"CompendiumPageError_BarType"	"Campo \"data\" mancante per la barra dei progressi \"{s:s1}\" nella pagina \"{s:s2}\" del compendio"
"CompendiumPageError_NoTime"	"Valore \"time\" mancante o non valido per la selezione \"{s:s1}\" in \"{s:s2}\""
"CompendiumPageError_ElementType"	"\"elementtype\" mancante o non valido per l'elemento \"{s:s1}\" nella pagina del compendio \"{s:s2}\""
"CompendiumPageError_SelTimer"	"Il timer \"{s:s1}\" nella pagina del compendio \"{s:s2}\" è sconosciuto"
"CompendiumPageError_BadElement"	"L'elemento SF \"{s:s1}\" nella pagina del compendio \"{s:s2}\" è sconosciuto"
"CompendiumPageError_SelNoTimer"	"Nessun timer trovato nella pagina del compendio \"{s:s1}\" (ha delle parti selezionabili che richiedono un timer)"
"CompendiumPageError_SelUnknown"	"\"choice_type\" di \"{s:s1}\" per la selezione \"{s:s2}\" non valida"
"CompendiumPageError_BarUnknown"	"Campo \"data\" non valido con il valore \"{s:s1}\" per la selezione \"{s:s2}\""
"CompendiumPageError_InvalidEquation"	"Equazione non valida: \"{s:s1}\" per \"{s:s2}\""
"CompendiumPageError_SelChoices"	"Blocco \"choices\" mancante per la selezione \"{s:s1}\" della pagina del compendio \"{s:s2}\""
"CompendiumPageError_NoHero"	"Impossibile trovare l'Eroe corrispondente all'ID \"{s:s1}\" per la selezione \"{s:s2}\""
"CompendiumPageError_Unknown"	"Errore logico interno del compendio. Contatta Valve per risolvere questo problema."
"CompendiumPageError_ImageDL"	"Impossibile iniziare il download dell'immagine del compendio \"{s:s1}\" ({s:s2})"
"CompendiumPageError_ImageDLErr"	"Impossibile scaricare l'immagine del compendio \"%s\" ({s:s2})"
"CompendiumPageError_BtnNoElem"	"Nessun blocco \"selection_elements\" trovato per il pulsante \"{s:s1}\" nella pagina del compendio \"{s:s2}\""
"CompendiumPageError_BtnBadVal"	"Il valore di selezione \"{s:s1}\" del pulsante \"{s:s1}\" non è nella lista delle scelte per quell'indice di selezione"
"CompendiumPageError_BtnBadSel"	"L'impostazione \"selection_force_to\" dell'elemento \"{s:s1}\" non è nella lista delle scelte per la selezione \"{s:s2}\""
"CompendiumPageError_BtnSelIdx"	"Il pulsante \"{s:s1}\" nella pagina del compendio \"{s:s2}\" ha un \"selection_index\" mancante o non valido"
"CompendiumPageError_CmdSelIdx"	"L'elemento \"{s:s1}\" nella pagina del compedio \"{s:s2}\" ha i comandi \"selection_index\" o \"force_selection_index\" mancanti o non validi."
"CompendiumPageError_ImgSelIdx"	"Campo \"selection_index\" di \"{s:s1}\" non valido nell'immagine \"{s:s2}\"."
"CompendiumPageError_ImgShowSelIdx"	"\"show_selection_index\" non valido di \"{s:s1}\" nell'immagine \"{s:s2}\"."
"CompendiumPageError_ImgSelVal"	"Scelta di selezione \"{s:s1}\" non valida nella sezione \"show_selection_images\" dell'immagine \"{s:s2}\"."
"CompendiumPageError_ImgBadStyle"	"Stile \"{s:s1}\" non valido per l'immagine \"{s:s2}\"."
"CompendiumPageError_DynTxtSel"	"Il testo \"{s:s1}\" nella pagina \"{s:s2}\" contiene una % selection_X % non valida. Nessuna selezione preregistrata per quell'indice."
"CompendiumPageError_NoTxtList"	"Impossibile trovare la lista di testo \"{s:s1}\" nella pagina \"{s:s2}\""
"CompendiumPageError_TOCPage"	"La pagina table_of_contents_page \"{s:s1}\" non esiste."
"CompendiumPageError_SelIndex"	"La selezione \"{s:s1}\" nella pagina del compendio \"{s:s2}\" ha un \"selection_index\" mancante o non valido"
"CompendiumPageError_SelUsed"	"La selezione \"{s:s1}\" nella pagina del compendio \"{s:s2}\" non ha un \"selection_index\" unico"
"CompendiumPageError_SelVal"	"La selezione \"{s:s1}\" nella pagina del compendio \"{s:s2}\" presenta scelte con gli stessi valori."
"CompendiumPageError_SelValInv"	"La selezione \"{s:s1}\" nella pagina del compendio \"{s:s2}\" presenta una scelta con un valore <= 0. I valori delle scelte devono essere maggiori di 0."
"CompendiumPageError_SelTTVal"	"La selezione \"{s:s1}\" nella pagina del compendio \"{s:s2}\" ha un campo tooltip_data con un valore non presente nella lista delle scelte."
"CompendiumPageError_NoAnswer"	"La selezione \"{s:s1}\" nella pagina del compendio {s:s2}\" non ha una chiave \"answer\" o \"answers\" nella sezione \"result\""
"CompendiumPageError_MissAnswer"	"La selezione \"{s:s1}\" nella pagina del compendio \"{s:s2}\" ha una chiave \"answer\" o \"answers\" che non corrisponde a nessuna delle scelte"
"CompendiumPageError_Timer"	"Il timer \"{s:s1}\" ha un Unix Time non valido"
"CompendiumPageError_UnknownAction"	"L'oggetto \"{s:s1}\" fa riferimento all'azione sconosciuta \"{s:s2}\""
"CompendiumPageError_SameElement"	"Il sistema di visibilità ha riscontrato più elementi chiamati \"{s:s1}\" nella pagina \"{s:s2}\""
"CompendiumPageError_DupeKey"	"Il blocco di valori chiave \"{s:s1}\" contiene diverse chiavi con lo stesso nome \"{s:s2}\"."
"CompendiumError_Template"	"Impossibile trovare il template \"{s:s1}\""
"CompendiumError_DupeTemplate"	"Diversi template \"{s:s1}\" trovati"
"CompendiumError_NoDefines"	"Il template \"{s:s1}\" richiede dei define, ma la sua istanza \"{s:s2}\" non ha un blocco \"define\"."
"CompendiumError_MissingDef"	"L'istanza derivata \"{s:s1}\" non contiene un define chiamato \"{s:s2}\", ma il template da esso derivato lo richiede."
"CompendiumError_BadDef"	"L'istanza derivata \"{s:s1}\" contiene una define chiamata \"{s:s2}\" che non inizia per \"%def\", come richiesto."
"CompendiumError_FailedPanoramaGen"	"Creazione del layout di Panorama non riuscita per la pagina \"{s:s1}\"."
"CompendiumError_FailedXMLWrite"	"Scrittura dei dati XML non riuscita per la pagina \"{s:s1}\" del file chiamato \"{s:s2}\"."
"CompendiumError_FailedCSSWrite"	"Scrittura dei dati CSS non riuscita per la pagina \"{s:s1}\" del file chiamato \"{s:s2}\"."
"DOTA_GlobalItems_Companions"	"Creature"
"DOTA_GlobalItems_Couriers"	"Corrieri"
"DOTA_GlobalItems_Pets"	"Animaletti"
"DOTA_GlobalItems_World"	"Mondo di gioco"
"DOTA_GlobalItems_Wards"	"Guardiani"
"DOTA_GlobalItems_Effigies"	"Effigi"
"DOTA_GlobalItems_Weather"	"Effetti meteorologici"
"DOTA_GlobalItems_Interface"	"Interfaccia"
"DOTA_GlobalItems_Emoticons"	"Emoticon"
"DOTA_GlobalItems_LoadingScreens"	"Schermate di caricamento"
"DOTA_GlobalItems_HUDs"	"Skin dell'interfaccia"
"DOTA_GlobalItems_Audio"	"Audio"
"DOTA_GlobalItems_Announcers"	"Annunciatori"
"DOTA_GlobalItems_Music"	"Musiche"
"DOTA_Search"	"Cerca"
"DOTA_Start"	"Avvia"
"DOTA_PleaseWait"	"Attendi..."
"DOTA_ProfileCard_HeroHover"	"Mostra al passaggio del cursore:"
"DOTA_ChallengeGroup_2_Desc"	"Fai pratica con gli Eroi controllati dal computer per allenarti in tutta tranquillità."
"DOTA_ChatTab_ToggleSounds"	"Riproduci un suono quando ricevo un messaggio in questo canale."
"dota_lobby_balanced_shuffle"	"Bilancia le squadre"
"dota_lobby_swap_teams"	"Scambia le squadre"
"dota_lobby_unassigned_players"	"Giocatori non assegnati"
"dota_lobby_settings"	"Impostazioni della lobby"
"dota_lobby_settings_edit"	"Modifica"
"dota_lobby_leave"	"Esci dalla lobby"
"DOTA_Custom_Game_View_Lobby_List"	"Mostra la lista delle lobby"
"DOTA_Custom_Game_Lobby_List_Title"	"Lista delle lobby"
"DOTA_Custom_Game_Browse_All"	"Sfoglia le modalità"
"DOTA_Custom_Game_Friends_Ready"	"Amici pronti a giocare"
"DOTA_Custom_Game_Friends_Who_Play"	"Amici che ci giocano"
"DOTA_Custom_Game_Friends_Playing_Now"	"Amici in gioco"
"DOTA_Custom_Game_Browse_Sort"	"Ordine:"
"DOTA_Custom_Game_Sort_Popular_Today"	"Più votate (oggi)"
"DOTA_Custom_Game_Sort_Popular_Week"	"Più votate (questa settimana)"
"DOTA_Custom_Game_Sort_Top_Rated"	"Più votate (di sempre)"
"DOTA_Custom_Game_Sort_Date"	"Data di pubblicazione"
"DOTA_WatchLive_WatchLabel"	"GUARDA SU:"
"DOTA_WatchLive_ThirdParty"	"SITO ESTERNO"
"DOTA_WatchLive_Steam"	"STEAM"
"DOTA_WatchLive_InGame"	"CLIENT"
"DOTA_WatchLive_Broadcaster0"	"Guarda {g:dota_persona:b:broadcaster_account_id_0}"
"DOTA_WatchLive_Broadcaster1"	"Guarda {g:dota_persona:b:broadcaster_account_id_1}"
"DOTA_WatchLive_Broadcaster2"	"Guarda {g:dota_persona:b:broadcaster_account_id_2}"
"DOTA_WatchLive_Broadcaster3"	"Guarda {g:dota_persona:b:broadcaster_account_id_3}"
"DOTA_WatchLive_Broadcaster4"	"Guarda {g:dota_persona:b:broadcaster_account_id_4}"
"DOTA_WatchLive_Broadcaster5"	"Guarda {g:dota_persona:b:broadcaster_account_id_5}"
"DOTA_WatchLive_Broadcaster6"	"Guarda {g:dota_persona:b:broadcaster_account_id_6}"
"DOTA_WatchLive_Broadcaster7"	"Guarda {g:dota_persona:b:broadcaster_account_id_7}"
"DOTA_WatchLive_Broadcaster8"	"Guarda {g:dota_persona:b:broadcaster_account_id_8}"
"DOTA_WatchLive_Broadcaster9"	"Guarda {g:dota_persona:b:broadcaster_account_id_9}"
"dota_matchmaking_region_title_confirm"	"Conferma le regioni di ricerca"
"dota_play_host_loading"	"L'host sta caricando..."
"dota_play_connecting_to_server"	"Connessione..."
"dota_reconnecting"	"Riconnessione..."
"dota_matchmaking_regions_retry"	"Riprova"
"dota_matchmaking_region_ping_calculating"	"Ping: calcolo in corso..."
"dota_matchmaking_region_ping_failed"	"Ping: N/D"
"dota_matchmaking_region_or"	"O"
"dota_matchmaking_region_selected_offline"	"Una o più regioni selezionate sono al momento offline."
"dota_matchmaking_region_selected_unreachable"	"Impossibile confermare la connettività di rete di una o più regioni selezionate."
"dota_matchmaking_region_all_unavailable"	"Impossibile ricevere il ping dalle regioni. Controlla la tua connessione a Internet."
"dota_matchmaking_region_check_internet"	"Controlla la tua connessione a Internet."
"dota_matchmaking_region_poor_choices"	"Le regioni selezionate potrebbero fornire una connessione lenta al server."
"dota_settings_open_party_manual_accept_invites"	"In un gruppo aperto, non accettare automaticamente inviti ai gruppi"
"dota_settings_networkhud"	"Mostra le informazioni di rete"
"dota_settings_fullscreenbrightness"	"Luminosità"
"dota_settings_dashboard_renderquality"	"Dashboard ad alta qualità"
"dota_settings_lowlatency_audio"	"Rileva automaticamente la latenza dell'audio"
"dota_settings_quicktargetattack"	"Attacco rapido"
"dota_settings_chat_whispers"	"Mostra i messaggi ricevuti su Steam come sussurri"
"dota_settings_no_mode_resolutions"	"Nessuna risoluzione supportata"
"DOTA_Settings_Tooltip_QuickTargetAttack"	"Premendo il tasto d'attacco, attaccherai nel punto in cui si trova il cursore del mouse."
"dota_lobby_browser_header_name"	"Nome della lobby"
"dota_lobby_browser_header_slots"	"Slot"
"dota_lobby_browser_header_game_mode"	"Modalità"
"dota_lobby_browser_region"	"Regione"
"dota_lobby_browser_lobby_name"	"Nome della lobby"
"DOTA_Friend_Game_Mode_Self"	"Sei in una partita di \"{s:game_mode}\""
"DOTA_Friend_Game_Mode_1_Friend"	"{s:player_name} sta giocando a \"{s:game_mode}\""
"DOTA_Friend_Game_Mode_N_Friends"	"{d:num_friends} amici stanno giocando a \"{s:game_mode}\""
"custom_game_lobby_mismatch"	"L'archivio della modalità personalizzata non corrisponde a quello del leader della lobby."
"CompendiumError_XMLLoadFail"	"Errore durante il caricamento dell'XML della pagina \"{s:s1}\" nel file \"{s:s2}\"."
"CompendiumError_XMLParseFail"	"Errore durante il parsing dell'XML per la pagina \"{s:s1}\" del file \"{s:s2}\"."
"Compendium_DefaultText_TimerTitle_Active"	"LE SELEZIONI TERMINANO TRA"
"Compendium_DefaultText_TimerTitle_Expired"	"LE SELEZIONI SONO TERMINATE"
"Compendium_DefaultText_CD_Days"	"giorni"
"Compendium_DefaultText_CD_Hours"	"ore"
"Compendium_DefaultText_CD_Minutes"	"minuti"
"Compendium_DefaultText_CD_Seconds"	"secondi"
"NetGraph_FPS"	"fps: {d:fps}"
"NetGraph_Ping"	"ping: {d:ping}ms"
"NetGraph_Loss"	"perdite: {d:loss}%"
"DOTA_Credits"	"Riconoscimenti"
"DOTA_ActorCredits_1_Name"	"Dee Bradley Baker"
"DOTA_ActorCredits_1_Heroes"	"techies"
"DOTA_ActorCredits_2_Name"	"Dennis Bateman"
"DOTA_ActorCredits_2_Heroes"	"invoker"
"DOTA_ActorCredits_3_Name"	"Tom Chantler"
"DOTA_ActorCredits_3_Heroes"	"centaur,lion,obsidian_destroyer,riki,slark,tusk,witch_doctor"
"DOTA_ActorCredits_4_Name"	"Merle Dandridge"
"DOTA_ActorCredits_4_Heroes"	"legion_commander,winter_wyvern"
"DOTA_ActorCredits_5_Name"	"Barry Dennen"
"DOTA_ActorCredits_5_Heroes"	"chaos_knight,phantom_lancer,rubick"
"DOTA_ActorCredits_6_Name"	"Dave Fennoy"
"DOTA_ActorCredits_6_Heroes"	"batrider,ember_spirit,faceless_void,jakiro,venomancer,skeleton_king"
"DOTA_ActorCredits_7_Name"	"Jim French"
"DOTA_ActorCredits_7_Heroes"	"elder_titan"
"DOTA_ActorCredits_8_Name"	"Michael Gregory"
"DOTA_ActorCredits_8_Heroes"	"bounty_hunter,clinkz,silencer"
"DOTA_ActorCredits_9_Name"	"Gin Hammond"
"DOTA_ActorCredits_9_Heroes"	"crystal_maiden,drow_ranger,enchantress,mirana,phantom_assassin,spectre,vengefulspirit"
"DOTA_ActorCredits_10_Name"	"John Patrick Lowrie"
"DOTA_ActorCredits_10_Heroes"	"ancient_apparition,dark_seer,doom_bringer,earthshaker,pudge,nevermore,storm_spirit"
"DOTA_ActorCredits_11_Name"	"Ellen McLain"
"DOTA_ActorCredits_11_Heroes"	"broodmother,death_prophet"
"DOTA_ActorCredits_12_Name"	"Bruce Miles"
"DOTA_ActorCredits_12_Heroes"	"alchemist,life_stealer,omniknight"
"DOTA_ActorCredits_13_Name"	"Linda K. Morris"
"DOTA_ActorCredits_13_Heroes"	"luna,naga_siren,queenofpain,templar_assassin"
"DOTA_ActorCredits_13_Extra"	"Annunciatrice"
"DOTA_ActorCredits_14_Name"	"Sam A. Mowry"
"DOTA_ActorCredits_14_Heroes"	"antimage,beastmaster,rattletrap,necrolyte,slardar,warlock"
"DOTA_ActorCredits_14_Extra"	"Negoziante Segreto"
"DOTA_ActorCredits_15_Name"	"Eric Newsome"
"DOTA_ActorCredits_15_Heroes"	"chen,leshrac,furion,razor,tidehunter,tiny,zuus"
"DOTA_ActorCredits_16_Name"	"Nolan North"
"DOTA_ActorCredits_16_Heroes"	"brewmaster,earth_spirit,gyrocopter,keeper_of_the_light,lone_druid,lycan,meepo,ogre_magi,shadow_demon,troll_warlord"
"DOTA_ActorCredits_17_Name"	"Dempsey Pappion"
"DOTA_ActorCredits_17_Heroes"	"magnataur,nyx_assassin,visage"
"DOTA_ActorCredits_18_Name"	"TJ Ramini"
"DOTA_ActorCredits_18_Heroes"	"abaddon,bristleback,skywrath_mage,shredder"
"DOTA_ActorCredits_19_Name"	"Harry S. Robins"
"DOTA_ActorCredits_19_Heroes"	"tinker"
"DOTA_ActorCredits_20_Name"	"Gary Schwartz"
"DOTA_ActorCredits_20_Heroes"	"lich,pugna"
"DOTA_ActorCredits_21_Name"	"David Scully"
"DOTA_ActorCredits_21_Heroes"	"bane,dazzle,juggernaut,morphling,sand_king,sven,weaver"
"DOTA_ActorCredits_22_Name"	"Mike Shapiro"
"DOTA_ActorCredits_22_Heroes"	"oracle"
"DOTA_ActorCredits_23_Name"	"David Sobolov"
"DOTA_ActorCredits_23_Heroes"	"terrorblade"
"DOTA_ActorCredits_24_Name"	"Jon St. John"
"DOTA_ActorCredits_24_Heroes"	"axe,bloodseeker,enigma,kunkka"
"DOTA_ActorCredits_25_Name"	"Fred Tatasciore"
"DOTA_ActorCredits_25_Heroes"	"disruptor,spirit_breaker,treant,undying,ursa"
"DOTA_ActorCredits_25_Extra"	"Golem di Warlock"
"DOTA_ActorCredits_26_Name"	"Jen Taylor"
"DOTA_ActorCredits_26_Heroes"	"lina,medusa,puck,windrunner"
"DOTA_ActorCredits_27_Name"	"Tony Todd"
"DOTA_ActorCredits_27_Heroes"	"dragon_knight,night_stalker,viper"
"DOTA_ActorCredits_28_Name"	" "
"DOTA_ActorCredits_28_Heroes"	" "
"DOTA_PlayerContextMenu_Trade"	"Proponi uno scambio"
"DOTA_Custom_Game_Finished_Vote_Title"	"Valuta la modalità"
"DOTA_Custom_Game_Finished_Vote_Question"	"Cosa ne pensi di questa modalità personalizzata?"
"DOTA_Custom_Game_Finished_Vote_Skip"	"Salta"
"DOTA_TabName_ModsLobbyList"	"Lista delle lobby"
"DOTA_WatchLive_Fullscreen"	"SCHERMO INTERO"
"DOTA_JoinChatChannel_ChannelName"	"Nome del canale"
"DOTA_JoinChatChannel_ChannelMemberCount"	"Membri"
"DOTA_Chat_ChannelMemberCount"	"{d:channel_member_count}"
"dota_settings_coop_fullscreen"	"Schermo intero per desktop"
"DOTA_Trading_UI_Body_Outgoing"	"In attesa che {s:player_name} risponda alla tua richiesta..."
"DOTA_GiftWrap_Item"	"Incartamento di \"{g:dota_item_name:gift_item_def}\"."
"DOTA_GiftWrap_ConfirmDedication_Title"	"Conferma la dedica"
"DOTA_GiftWrap_ConfirmDedication_Message"	"Sei sicuro di voler aggiungere la dedica: \"{s:gift_dedication}\"?"
"DOTA_GiftWrap_Success_Header"	"Fatto!"
"DOTA_GiftWrap_Success"	"Il dono è stato recapitato."
"DOTA_GiftWrap_Error_RateLimitedNormal"	"Puoi donare al massimo {d:gift_limit_count} oggetti ogni {d:gift_limit_hours} ore. Hai già raggiunto il limite. Attendi prima di inviare questo dono."
"DOTA_GiftWrap_Error_RateLimitedCharge"	"Il livello del tuo profilo di Dota ti permette di inviare al massimo {d:gift_limit_count} oggetti non scambiabili ogni {d:gift_limit_hours} ore. Questo dono non può essere inviato al momento."
"DOTA_GiftWrap_Error_RateLimitedChargeNone"	"Il livello del tuo profilo di Dota non ti permette di inviare doni non scambiabili. Questo dono non può essere inviato al momento."
"DOTA_Custom_Game_Sort_Most_Played"	"Più popolari (questa settimana)"
"dota_settings_about"	"Informazioni"
"dota_settings_fullscreen_focus_behavior"	"La modalità a schermo intero con accesso facilitato al desktop riduce a icona il gioco quando è in background"
"DOTA_EquippedItem_AddToShuffle"	"Aggiungi alla selezione casuale"
"DOTA_EquippedItem_RemoveFromShuffle"	"Rimuovi dalla selezione casuale"
"DOTA_EquippedItem_Unpack_And_AddToShuffle"	"Apri e aggiungi alla selezione casuale"
"DOTA_ClientVersion"	"Versione: <span class=\"VersionNumber\">{d:client_version_number}</span>"
"DOTA_GameplayVersion"	"Versione del gameplay: <span class=\"VersionNumber\">{s:gameplay_version_number}</span>"
"DOTA_Recycling"	"Riciclo"
"DOTA_Recycling_Action"	"Ricicla"
"DOTA_Recycling_DragItems"	"Trascina qui i tuoi oggetti non desiderati"
"DOTA_Recycling_Outputs"	"Riceverai"
"DOTA_Recycling_Confirm"	"Sei sicuro di voler riciclare questi oggetti?"
"DOTA_RecyclingCharm_Name"	"Amuleto del Fulcro Ingioiellato II"
"DOTA_RecyclingCharm_Bonus"	"25 monete del Compendio"
"custom_game_file_error"	"Errore durante l'accesso ai file della modalità personalizzata."
"DOTA_Previous"	"Precedente"
"DOTA_PreviousShort"	"Prec."
"DOTA_Next"	"Succ."
"DOTA_Friends_Add_Friend_Tooltip"	"Chiedi amicizia"
"DOTA_Friends_Add_Friend_Entry_Placeholder"	"Inserisci l'ID da cercare"
"DOTA_Friends_Add_Friend_Your_ID"	"Il tuo ID è: "
"dota_settings_voice_always_sample_mic"	"Push-to-talk semplificato"
"dota_settings_voice_always_sample_mic_tooltip"	"Mantiene l'audio del dispositivo di registrazione attivo per evitare che il gioco si blocchi su certi tipi di hardware."
"DOTA_EconItemSet_Tooltip_MultipleTeams"	"Ha stili diversi per i Radiant e i Dire"
"DOTA_HeroLoadout_Add_All_To_Shuffle"	"Aggiungi tutto"
"DOTA_HeroLoadout_Clear_Shuffle"	"Cancella la selezione casuale"
"DOTA_Armory_ActiveFilter"	"{s:filter_field} {s:filter_op} {s:filter_value}"
"DOTA_Treasure_Purchase"	"Acquista il tesoro"
"DOTA_Treasure_CharmPurchase"	"Acquista l'amuleto"
"DOTA_Treasure_SearchPlaceholder"	"Cerca tra i tesori"
"DOTA_Treasure_ViewAll"	"Mostra tutti i tesori"
"DOTA_Treasure_QuantityOption"	"Q.tà: {d:quantity}"
"DOTA_Treasure_Gift"	"Dono"
"DOTA_Treasure_Open"	"Apri"
"DOTA_Treasure_OpenQuantity"	"{d:owned_quantity}"
"DOTA_Treasure_Owned"	"In possesso"
"DOTA_Treasure_Received"	"Ricevuto"
"DOTA_Treasure_Autographed"	"Autografo:"
"DOTA_Treasure_AutographName"	"{s:treasure_autograph_name}"
"DOTA_OpenTreasureTooltip_NormalTitle"	"Include i seguenti oggetti:"
"DOTA_OpenTreasureTooltip_UnitName"	"{g:dota_item_unit_name:item_def}"
"DOTA_OpenTreasureTooltip_ItemName"	" - {g:dota_item_name:item_def}"
"dota_profile_content_tab_official_info"	"Dati ufficiali"
"dota_profile_oi_player_name"	"NOME"
"dota_profile_oi_player_name_sub"	"Deve essere riconoscibile dai giocatori di tutto il mondo e non deve includere le affiliazioni a squadre o sponsor."
"dota_profile_oi_team"	"SQUADRA"
"dota_profile_oi_team_sub"	"Se giochi con una squadra di Dota a livello ufficiale, selezionala qui. La tag verrà mostrata prima del tuo nome."
"dota_profile_oi_sponsor"	"SPONSOR"
"dota_profile_oi_sponsor_sub"	"Gli sponsor verranno aggiunti al tuo nome."
"dota_profile_oi_country"	"PAESE"
"dota_profile_oi_role"	"RUOLO"
"dota_profile_oi_role_sub"	"Scegli il ruolo che giochi. Quello principale rappresenta i giocatori che possono giocare come carry, mid o off-lane."
"dota_profile_oi_preview"	"Ecco come apparirà il tuo nome nelle classifiche e nelle partite di lega:"
"dota_profile_oi_preview_warning"	"Questi dati possono essere modificati ogni due settimane, perciò verifica che siano giusti prima di aggiornarli!"
"dota_profile_oi_submit_pending"	"Invio in corso..."
"dota_profile_oi_submit_success"	"Operazione riuscita!"
"dota_profile_oi_submit_failure"	"Errore: riprova."
"dota_role_core"	"Principale"
"dota_role_support"	"Supporto"
"Compendium_GenerateFail"	"Impossibile generare il file delle risorse \"{s:s1}\"."
"Compendium_PreparePublish"	"Preparazione alla pubblicazione"
"Compendium_PublishError"	"Impossibile copiare \"{s:s1}\" nella cartella del compendio situata in \"{s:s2}\"."
"Compendium_PublishFinishedTitle"	"Pubblicazione riuscita"
"Compendium_PublishFinished"	"I file compilati sono stati copiati nella cartella dei file di dati.\n\nCarica tutti i file .vxml_c, .vtex_c e .vcss_c quando invii il Compendio alla pagina web della lega."
"DOTA_Treasure"	"Tesoro"
"DOTA_Blog"	"Novità in Dota 2"
"DOTA_SortBy"	"Ordina per"
"DOTA_SortOption_Newest"	"Recenti"
"DOTA_SortOption_Owned"	"Posseduti"
"DOTA_SortOption_Price"	"Prezzo"
"DOTA_SortOption_Alphabetical"	"Ordine alfabetico"
"Action_Use"	"Usa"
"DOTA_BadgeLevel"	"{d:badge_level}"
"DOTA_AHC_CurrentHero"	"Eroe attuale"
"DOTA_AHC_CurrentHeroName"	"{s:current_hero_name}"
"DOTA_AHC_InProgress"	"In corso"
"DOTA_AHC_CurrentHeroAttempts"	"Tentativi: {s:current_hero_attempts}"
"DOTA_AHC_CurrentHeroAverage"	"Media globale"
"DOTA_AHC_CurrentHeroAverageAttempts"	"Tentativi: {s:current_hero_average_attempts}"
"DOTA_AHC_NextHero"	"Eroe seguente"
"DOTA_AHC_NextHeroName"	"{s:next_hero_name}"
"DOTA_AHC_ChallengeProgress"	"Progresso attuale ({d:challenge_progress_percent}%)"
"DOTA_AHC_HeroesCompleted"	"Eroi completati"
"DOTA_AHC_HeroesCompletedValue"	"{d:heroes_completed} / {d:heroes_total}"
"DOTA_AHC_TotalAttempts"	"Tentativi totali"
"DOTA_AHC_TotalAttemptsValue"	"Partite: {d:challenge_total_attempts}"
"DOTA_AHC_EquivalentWorldAverage"	"Media globale equivalente"
"DOTA_AHC_EquivalentWorldAverageValue"	"Partite: {d:challenge_average_total_attempts}"
"DOTA_AHC_LifetimeStats"	"Statistiche complessive della sfida"
"DOTA_AHC_FullChallengesCompleted"	"Sfide complessive completate"
"DOTA_AHC_FullChallengesCompletedValue"	"{d:full_challenges_completed}"
"DOTA_AHC_BestFullChallenge"	"Migliore sfida complessiva"
"DOTA_AHC_BestFullChallengeValueNone"	"N/D"
"DOTA_AHC_BestFullChallengeValue"	"Partite: {d:best_full_challenge}"
"DOTA_AHC_FullChallengeAverage"	"Media delle sfide complessive globali"
"DOTA_AHC_FullChallengeAverageValue"	"Partite: {s:full_challenge_average}"
"DOTA_AHC_ChallengeReward"	"Ricompensa della sfida"
"DOTA_AHC_ChallengeTrophyName"	"{s:challenge_trophy_name}"
"DOTA_AHC_ChallengeTrophyLevel"	"Livello {d:challenge_trophy_level}"
"DOTA_Trophies_ViewEarned"	"Ottenuti"
"DOTA_Party_Add_Friends"	"Aggiungi degli amici per creare un gruppo"
"DOTA_ItemSet_Count_text"	"{d:item_current_group} / {d:item_group_count}"
"DOTA_Custom_Game_Map_AnyNumbered"	"Qualsiasi ({d:map_choices})"
"dota_settings_enable_console"	"Attiva la console"
"dota_settings_enable_console_tooltip"	"Le opzioni di avvio che attivano la console, come -dev o -console, ignoreranno lo stato di questa opzione"
"dota_settings_binding_options"	"Comandi"
"dota_settings_allow_gui_key_to_bind"	"Consenti l'assegnazione del tasto Windows / Command"
"DOTA_HeroLoadout_Loadout"	"Equipaggiamento"
"DOTA_HeroLoadout_About"	"Informazioni"
"DOTA_HeroLoadout_Guides"	"Guide"
"DOTA_HeroLoadout_Roles"	"Ruoli"
"DOTA_HeroLoadout_Biography"	"Storia"
"DOTA_Feed_Say_Something"	"Di' qualcosa nel tuo feed..."
"DOTA_Armory_ClearFilter"	"Rimuovi filtro"
"DOTA_Armory_ContextMenu_Tags"	"Etichette..."
"DOTA_EffigyEditor_CreateEffigy"	"Crea l'Effigie"
"DOTA_EffigyEditor_PoseEffigy"	"Metti in posa l'Effigie"
"DOTA_EffigyEditor_ReforgeEffigy"	"Riforgia l'Effigie"
"DOTA_EffigyEditor_Model"	"Eroe"
"DOTA_EffigyEditor_Loadout"	"Vai all'equipaggiamento"
"DOTA_EffigyEditor_Inscription"	"Iscrizione:"
"DOTA_EffigyEditor_Animation"	"Animazione:"
"DOTA_EffigyEditor_Frame"	"Scegli il frame:"
"DOTA_EffigyEditor"	"Editor delle Effigi"
"DOTA_EffigyEditor_ConfirmCreate"	"Creare l'Effigie Eroica consumerà il Blocco da Effigie. L'Effigie potrà essere rimodificata in futuro solo usando un Riforgiatore di Effigi. Procedere?"
"DOTA_EffigyEditor_ConfirmReforge"	"Riforgiare l'Effigie Eroica consumerà il Riforgiatore di Effigi. Procedere?"
"DOTA_EffigyEditor_Error"	"Impossibile creare l'Effigie."
"DOTA_EffigyEditor_ErrorReforge"	"Impossibile riforgiare l'Effigie."
"DOTA_EffigyEditor_ErrorPose"	"Impossibile mettere in posa l'Effigie della Fama."
"DOTA_EffigyEditor_Success"	"L'Effigie è stata creata."
"DOTA_EffigyEditor_SuccessReforge"	"L'Effigie è stata riforgiata."
"DOTA_EffigyEditor_SuccessPose"	"L'Effigie è stata messa in posa."
"dota_profile_content_tab_all_hero_challenge"	"Sfida degli Eroi"
"DOTA_tooltip_econ_item_delete_restriction"	"Non eliminabile"
"DOTA_tooltip_econ_item_modifiers"	"Modificatori"
"DOTA_tooltip_econ_item_modifier_animation"	"Animazione"
"DOTA_tooltip_econ_item_modifier_announcer"	"Annunciatore"
"DOTA_tooltip_econ_item_modifier_HUD"	"Interfaccia"
"DOTA_tooltip_econ_item_modifier_health_bar"	"Barra della salute"
"DOTA_tooltip_econ_item_modifier_ability_name"	"Nome dell'abilità"
"DOTA_tooltip_econ_item_modifier_loading_screen"	"Schermata di caricamento"
"DOTA_tooltip_econ_item_modifier_cursor_pack"	"Pacchetto di cursori"
"DOTA_tooltip_econ_item_modifier_portrait"	"Ritratto"
"DOTA_tooltip_econ_item_modifier_ambient_effects"	"Effetti ambientali"
"DOTA_tooltip_econ_item_modifier_kill_effects"	"Effetti per le uccisioni"
"DOTA_tooltip_econ_item_modifier_spell_effects"	"Effetti per le abilità"
"DOTA_tooltip_econ_item_modifier_model"	"Modello"
"DOTA_tooltip_econ_item_modifier_scale"	"Dimensioni"
"DOTA_tooltip_econ_item_modifier_wearable"	"Oggetto indossabile"
"DOTA_tooltip_econ_item_modifier_courier"	"Corriere"
"DOTA_tooltip_econ_item_modifier_flying_courier"	"Corriere volante"
"DOTA_tooltip_econ_item_modifier_pet"	"Animaletto"
"DOTA_tooltip_econ_item_modifier_weather"	"Effetto meteorologico"
"DOTA_tooltip_econ_item_modifier_sound"	"Audio"
"DOTA_tooltip_econ_item_modifier_soundscape"	"Paesaggio sonoro"
"DOTA_tooltip_econ_item_modifier_voice"	"Voce"
"DOTA_tooltip_econ_item_modifier_icon"	"Icona"
"DOTA_econ_item_details_style_label"	"Stile:"
"DOTA_econ_item_details_gift_label"	"Dono da parte di:"
"Compendium_Downloading"	"Download del Compendio..."
"Compendium_DLFailed"	"Download non riuscito"
"Compendium_DLFailed_Desc"	"Impossibile scaricare il Compendio.\n\nRiprova più tardi."
"Compendium_Error"	"Errore del Compendio"
"Compendium_Error_Desc"	"Si è verificato un problema con il Compendio che stiamo cercando di risolvere.\n\nRiprova più tardi."
"Compendium_Retry"	"Riprova"
"Compendium_preview_mode"	"SOLO IN ANTEPRIMA"
"Compendium_level"	"LIVELLO"
"Compendium_to_next_level"	"AL PROSSIMO LIVELLO"
"Compendium_LevelupPts_Singular"	"1 p.to"
"Compendium_LevelupPts_Plural"	"{d:next_comp_level} p.ti"
"DOTA_GlobalItems_MegaKill"	"Serie di uccisioni"
"DOTA_Treasure_BonusReward"	"Ricompensa bonus"
"DOTA_OpenTreasureTooltip_ExtraItems"	"... +{d:extra_items_count}!"
"DOTA_AASystem_Green"	"Tempo di gioco online: {s:playtime}. Stai giocando entro limiti di tempo salutari. Divertiti!"
"DOTA_AASystem_Yellow"	"Tempo di gioco online: {s:playtime}. Hai superato i limiti di tempo salutari. Faresti meglio a fare una pausa!"
"DOTA_AASystem_Red"	"Tempo di gioco online: {s:playtime}. Hai superato i limiti di tempo salutari. Ti consigliamo caldamente di staccare e riposarti!"
"DOTA_AntiAddiction_Initial_With_ID_18Plus"	"Ultima volta online: %s1\nUltimo indirizzo IP: %s2"
"DOTA_AntiAddiction_Initial_With_ID_Under_18"	"Hai meno di 18 anni. Il sistema anti-assuefazione è attivo.\nUltima volta online: %s1\nUltimo indirizzo IP: %s2"
"DOTA_AntiAddiction_Initial_No_ID"	"Il tuo account non è registrato.\nUltima volta online: %s1\nUltimo indirizzo IP: %s2"
"DOTA_AntiAddiction_Blocked_Time_Exceeded"	"Tempo di gioco massimo superato secondo il sistema anti-assuefazione. Chiusura in corso..."
"DOTA_AntiAddiction_Initial_No_ID_Popup"	"La registrazione del tuo account non è completa. Vuoi inserire i dati mancanti?"
"DOTA_AntiAddiction_CompleteInfoNow"	"Inserisci i dati"
"DOTA_AntiAddiction_CompleteInfoNotNow"	"Non ora"
"DOTA_AntiAddiction_Initial_DateFormat"	"%s1Y%s2M%s3D %s4:%s5:%s6"
"DOTA_AntiAddiction_Label_Green"	"Tempo di gioco: {s:playtime} ( Salutare )"
"DOTA_AntiAddiction_Label_Yellow"	"Tempo di gioco: {s:playtime} ( Poco salutare )"
"DOTA_AntiAddiction_Label_Red"	"Tempo di gioco: {s:playtime} ( Oltre i limiti )"
"DOTA_Workshop_Browse"	"Sfoglia"
"DOTA_Workshop_TextureName_color"	"Colore"
"DOTA_Workshop_MaterialName_MetalnessTexture"	"Metallicità"
"DOTA_Workshop_MaterialName_NormalTexture"	"Normal map"
"DOTA_Workshop_MaterialName_RimMaskTexture"	"Maschera di rim lighting"
"DOTA_Workshop_MaterialName_SpecMaskTexture"	"Maschera di specularità"
"DOTA_Workshop_MaterialDetail_ColorTexture"	"Questo è la texture del colore! Solo del colore."
"DOTA_Workshop_MaterialDetail_MetalnessTexture"	"Questa è la texture della metallicità! Rappresenta la metallicità della superficie."
"DOTA_Workshop_MaterialDetail_NormalTexture"	"Questa è la texture della normal map! Rappresenta le normali."
"DOTA_Workshop_MaterialDetail_RimMaskTexture"	"Questa è la texture della maschera di rim lighting! Rappresenta la maschera di rim lighting."
"DOTA_Workshop_MaterialDetail_SelfIllumTexture"	"Questa è la texture dell'emissività! Rappresenta l'emissività."
"DOTA_Workshop_MaterialDetail_SpecMaskTexture"	"Questa è la texture della maschera di specularità! Rappresenta la maschera di specularità."
"DOTA_Workshop_Model"	"Modello"
"DOTA_Workshop_Animations"	"Animazioni"
"DOTA_Workshop_Misc"	"Varie"
"DOTA_Workshop_SubmissionType_Ward"	"Guardiano"
"DOTA_Workshop_ImportP4"	"Importa (P4)"
"DOTA_Workshop_ImportNoP4"	"Importa (senza P4)"
"DOTA_Workshop_SaveSettings"	"Salva impostazioni"
"DOTA_Workshop_LoadSettings"	"Carica impostazioni"
"DOTA_Workshop_Ready"	"Pronto"
"DOTA_Workshop_Optional"	"Facoltativo"
"DOTA_Workshop_Required"	"Necessario"
"DOTA_Workshop_Required_Texture"	"Necessario (le texture saranno ridotte a: %s1)"
"DOTA_Workshop_Required_Geometry"	"Necessario (triangoli massimi: %s1)"
"DOTA_Workshop_NotRequired_Geometry"	"(Triangoli massimi: %s1)"
"DOTA_Workshop_NotRequired_Texture"	"(Le texture saranno ridotte a: %s1)"
"DOTA_Workshop_ItemName_Desc"	"Questo è il nome del file in output per il tuo oggetto. Non è visibile dai giocatori e non può superare i 50 caratteri."
"DOTA_Workshop_GenericModelName_Desc"	"Questo è il nome del modello che hai importato, usato internamente da Valve; scegli un nome unico o descrittivo. Non è visibile ai giocatori e non può superare i 50 caratteri."
"DOTA_Workshop_LOD1Desc"	"Questo è il file .DMX, .SMD o .FBX che contiene la geometria comprensiva di mappatura delle texture per il tuo oggetto che sarà visibile in gioco."
"DOTA_Workshop_Texture_Desc"	"Questa è la serie di quattro file .TGA che formano la texture di questa geometria. Sfoglia e seleziona i file .TGA _color , _normal, _mask1 o _mask2, e noi cercheremo i restanti file nella stessa cartella."
"DOTA_Workshop_Texturing"	"Aiuto per le texture"
"DOTA_Workshop_Modelling"	"Aiuto per la modellazione"
"DOTA_Workshop_Animation"	"Aiuto per le animazioni"
"DOTA_Workshop_AbilityIconsHelp"	"Aiuto per le icone delle abilità"
"DOTA_Workshop_DisableNICE"	"Disattiva il filtro delle texture"
"DOTA_Workshop_DisableNICE_Desc"	"Su alcune texture, i filtri che usiamo possono produrre delle mipmap che non mantengono alcuni dettagli specifici delle texture. Se le tue texture presentano tale problema, prova ad abilitare quest'opzione per vedere se risultano più leggibili."
"DOTA_Workshop_Reimport"	"Aggiorna"
"DOTA_Workshop_Marketing_Desc"	"Un file .PSD contenente una selezione di immagini di marketing da usare per promuovere il tuo contenuto. Clicca sul collegamento di aiuto per il marketing per vedere i requisiti, il formato consigliato o il tuo file .PSD."
"DOTA_Workshop_Marketing_Help"	"Aiuto per il marketing"
"DOTA_Workshop_Particles_Desc"	"Questo modello avrà un sistema di particelle ad esso collegato in gioco per ragioni di gameplay. Questo è il file .DMX, .SMD o .FBX che contiene i vertici che specificano come va collegato il sistema di particelle."
"DOTA_Workshop_Particles_Help"	"Aiuto per le particelle"
"DOTA_Workshop_HudSkin_Intro"	"Le skin dell'interfaccia sono una serie di immagini che sostituiscono l'interfaccia del gioco una volta combinate."
"DOTA_Workshop_HudSkin_Desc"	"Una serie di file .PNG che sono stati prodotti con lo strumento di esportazione di Photoshop per skin dell'interfaccia. Sfoglia e seleziona uno qualsiasi dei file .PNG e cercheremo noi il resto. Devono essere situati nella stessa struttura delle cartelle creata dallo strumento di esportazione."
"DOTA_Workshop_HudSkin_Help"	"Aiuto per le skin dell'interfaccia"
"DOTA_Workshop_CursorPack_Intro"	"I pacchetti di cursori sono una serie di immagini che sostituiscono i cursori del gioco."
"DOTA_Workshop_CursorPack_Help"	"Aiuto per i pacchetti di cursori"
"DOTA_Workshop_ImportLoadingScreen"	"IMPORTA SCHERMATA DI CARICAMENTO"
"DOTA_Workshop_LoadingScreen_Intro"	"Un'immagine per sostituire la schermata di caricamento di Dota 2"
"DOTA_Workshop_LoadingScreen_Desc"	"Cerca loadingscreen.png."
"DOTA_Workshop_LoadScreen_Preview_Title"	"Anteprima dei formati d'immagine"
"DOTA_UI_LoadScreen_16_9"	"Formato d'immagine 16:9"
"DOTA_UI_LoadScreen_16_10"	"Formato d'immagine 16:10"
"DOTA_UI_LoadScreen_4_3"	"Formato d'immagine 4:3"
"DOTA_Workshop_ImportChatEmoticon"	"IMPORTA EMOTICON PER LA CHAT"
"DOTA_Workshop_ChatEmoticon_Intro"	"Un'emoticon animata per la chat"
"DOTA_Workshop_ChatEmoticon_Help"	"Aiuto per le emoticon della chat"
"DOTA_Workshop_ChatEmoticon_Title"	"File immagine di origine"
"DOTA_Workshop_ChatEmoticon_ItemName"	"Parola chiave dell'emoticon"
"DOTA_Workshop_ChatEmoticon_ItemName_Desc"	"Parola chiave proposta per l'emoticon"
"DOTA_Workshop_ChatEmoticon_AnimationSpeed"	"Durata dei frame"
"DOTA_Workshop_ChatEmoticon_AnimationSpeed_Desc"	"Durata dei frame, in millisecondi. La maggior parte delle emoticon usa 100 millisecondi per frame."
"DOTA_Workshop_ChatEmoticon_DefaultFrame"	"Frame predefinito"
"DOTA_Workshop_ChatEmoticon_DefaultFrame_Desc"	"Il frame mostrato quando l'emoticon non è animata. È una cifra che va da 0 al numero di frame -1. Usa -1 per scegliere automaticamente l'ultimo frame esistente. Se non specifichi un frame predefinito, useremo il primo esistente (0)."
"DOTA_Workshop_ChatEmoticon_Preview_Title"	"Anteprima dell'emoticon in chat"
"DOTA_Workshop_ImportChatEmoticon_Preview"	"Anteprima"
"DOTA_Workshop_File_ChatEmoticon"	"Immagine di origine (file .png)"
"DOTA_Workshop_Attachments_Desc"	"I punti di ancoraggio rappresentano le zone di un modello su cui il gioco può posizionare certi effetti. Ogni punto di ancoraggio ha sia una posizione che un angolo derivato da un bone del modello. Specifica il nome del bone per ogni punto di ancoraggio richiesto. Una volta compilato il modello importato, l'anteprima ti mostrerà il punto di ancoraggio affinché tu possa verificarne la posizione."
"DOTA_Workshop_Attachments_UIBlock"	"Punto di ancoraggio %s1"
"DOTA_Workshop_Attachment_HitLocation"	"Nome del bone per la hitbox"
"DOTA_Workshop_Attachment_HitLocation_Desc"	"Specifica il punto del modello che i nemici dovranno raggiungere con i loro colpi. Una buona posizione è al di sopra del centro del modello, come la zona centrale della testa di un umanoide."
"DOTA_Workshop_Attachment_LeftEye"	"Nome del bone per l'occhio sinistro"
"DOTA_Workshop_Attachment_RightEye"	"Nome del bone per l'occhio destro"
"DOTA_Workshop_Attachment_AttackPoint"	"Nome del bone per il punto di attacco"
"DOTA_Workshop_Attachment_AttackPoint_Desc"	"Per le unità a distanza, questo punto di ancoraggio specifica da dove devono partire i colpi. Per le unità da mischia, è da qui che facciamo uscire gli effetti del colpo, come gli spruzzi di sangue."
"DOTA_Workshop_Attachment_AttackPoint2"	"Nome del bone per il punto di attacco secondario"
"DOTA_Workshop_Attachment_AttackPoint2_Desc"	"Quando l'animazione di un ATTACCO SECONDARIO viene usata al posto dell'ATTACCO di base, questo punto di attacco sarà usato per generare gli effetti di impatto e i colpi."
"DOTA_Workshop_Attachment_Mouth"	"Nome del bone per la bocca"
"DOTA_Workshop_Attachment_Mouth_Desc"	"Specifica dove mettere gli effetti particellari relativi alla bocca del modello dell'Unità."
"DOTA_Workshop_Attachment_BowTop"	"Punto di ancoraggio superiore della corda dell'arco"
"DOTA_Workshop_Attachment_BowTop_Desc"	"Specifica il punto del modello a cui viene ancorato l'effetto particellare per la parte superiore della corda dell'arco."
"DOTA_Workshop_Attachment_BowMid"	"Punto di ancoraggio centrale della corda dell'arco"
"DOTA_Workshop_Attachment_BowMid_Desc"	"Specifica il punto del modello a cui viene ancorato l'effetto particellare per la parte centrale della corda dell'arco. Viene usato per piegare la corda dell'arco."
"DOTA_Workshop_Attachment_BowBot"	"Punto di ancoraggio inferiore della corda dell'arco"
"DOTA_Workshop_Attachment_BowBot_Desc"	"Specifica il punto del modello a cui viene ancorato l'effetto particellare per la parte inferiore della corda dell'arco."
"DOTA_Workshop_Attachment_LowerStaff"	"Punto di ancoraggio inferiore del bastone di Earth Spirit"
"DOTA_Workshop_Attachment_LowerStaff_Desc"	"Specifica il punto del modello a cui viene ancorato l'effetto particellare per la parte inferiore del bastone."
"DOTA_Workshop_Attachment_UpperStaff"	"Punto di ancoraggio superiore del bastone di Earth Spirit"
"DOTA_Workshop_Attachment_UppperStaff_Desc"	"Specifica il punto del modello a cui viene ancorato l'effetto particellare per la parte superiore del bastone."
"DOTA_Workshop_Animation_Desc"	"Le animazioni sono in formato .DMX, .SMD o .FBX. Ogni file contiene una singola animazione per il tuo modello."
"DOTA_Workshop_Animation_UIBlock"	"Animazioni %s1"
"DOTA_Workshop_Preview_Anim"	"Animazione:"
"DOTA_Workshop_Preview_Gesture"	"Sovraimpressione:"
"DOTA_Workshop_Preview_Skin"	"Texture:"
"DOTA_Workshop_Preview_Model"	"Modello:"
"DOTA_Workshop_Preview_Attachment"	"Mostra punto di ancoraggio:"
"DOTA_Workshop_Preview_NoAttachment"	"Nessuno"
"DOTA_Workshop_Preview_ShowReference"	"Mostra il modello di riferimento"
"DOTA_Workshop_Preview_ToggleLOD"	"Mostra modello a bassa risoluzione"
"DOTA_Workshop_Preview_TogglePedestal"	"Attiva piedistallo"
"DOTA_Workshop_Preview_ToggleUI"	"Attiva interfaccia"
"DOTA_Workshop_ImportError_Validation"	"Convalida non riuscita"
"DOTA_Workshop_ImportError"	"Errore di importazione"
"DOTA_Workshop_Error_VMTCount"	"Il modello \"%s1\" sta usando più di un materiale. È permesso l'utilizzo di un solo materiale per tutti i livelli di dettaglio di un modello.\nMateriali trovati:\n\n%s2"
"DOTA_Workshop_Error_TextureNameA"	"Impossibile riconoscere il nome del file .TGA. Le texture devono terminare con uno dei seguenti suffissi: _color, _normal, _mask1, _mask2"
"DOTA_Workshop_Error_TextureNameB"	"Impossibile trovare file .TGA con suffisso:\n %s1"
"DOTA_Workshop_RequiredFileError"	"Il file richiesto non è stato trovato!"
"DOTA_Workshop_RequiredFile_Name"	"Impossibile trovare il file richiesto con il nome seguente:\n %s1"
"DOTA_Workshop_ZipError"	"Errore del file!"
"DOTA_Workshop_ZipError_Desc"	"Impossibile creare un file .zip temporaneo per l'oggetto in: %s1"
"DOTA_Workshop_Error"	"Errore di importazione"
"DOTA_Workshop_Error_NoManifest"	"Il file .zip non contiene il file manifest.txt."
"DOTA_Workshop_Quicksave_Fail"	"Salvataggio non riuscito"
"DOTA_Workshop_Quicksave_Fail_Desc"	"Impossibile salvare lo stato dell'importazione in %s1"
"DOTA_Workshop_Quickload_Fail"	"Caricamento non riuscito"
"DOTA_Workshop_Quickload_Fail_Desc"	"Impossibile caricare: file di salvataggio non trovato in %s1"
"DOTA_Workshop_NotInTest"	"Impossibile pubblicare in Dota 2 Test"
"DOTA_Workshop_NotInTest_Desc"	"Usa il client principale di Dota 2 per interagire con lo Steam Workshop."
"DOTA_Workshop_Import"	"Importa"
"DOTA_Workshop_Import_Success"	"IMPORTAZIONE RIUSCITA"
"DOTA_Workshop_Import_Failed"	"IMPORTAZIONE NON RIUSCITA"
"DOTA_Workshop_LOD0Desc_Ward"	"Questo è il file .DMX, .SMD o .FBX che contiene la geometria a risoluzione più alta per il tuo Guardiano. Verrà utilizzata nel ritratto, nell'equipaggiamento e nella visuale d'esibizione."
"DOTA_Workshop_LOD1Desc_Ward"	"Questo è il file .DMX, .SMD o .FBX che contiene la geometria comprensiva di mappatura delle texture per il tuo Guardiano che sarà visibile in gioco."
"DOTA_Workshop_Mat0Desc_Ward"	"Questo è il file _color .TGA che contiene le texture usate dalla geometria per il Guardiano Osservatore. I file .TGA _normal, _mask1 e _mask2 sono opzionali per i Guardiani, ma li useremo se si trovano nella stessa cartella."
"DOTA_Workshop_Mat1Desc_Ward"	"Questo è il file _color .TGA che contiene le texture usate dalla geometria per il Guardiano Sentinella. I file .TGA _normal, _mask1 e _mask2 sono opzionali per i Guardiani, ma li useremo se si trovano nella stessa cartella."
"DOTA_Workshop_Animation_Attack_Desc"	"Le animazioni di attacco devono corrispondere alle tempistiche di quelle predefinite per l'Unità. L'animazione di attacco per questa Unità deve durare %s2 secondi e il punto di attacco avverrà dopo %s1 secondi dall'inizio."
"DOTA_Workshop_Animation_AttackB_Desc"	"Un'animazione alternativa di attacco che verrà riprodotta casualmente al posto dell'animazione di ATTACCO. Deve avere la stessa durata e le stesse tempistiche dell'animazione di ATTACCO."
"DOTA_Workshop_Animation_Attack2_Desc"	"Un'animazione di attacco alternativa che verrà riprodotta casualmente al posto dell'animazione di ATTACCO. Gli effetti di impatto o i colpi verranno generati dal punto di ancoraggio di ATTACCO SECONDARIO anziché dal PUNTO DI ATTACCO di base. Deve avere la stessa durata e le stesse tempistiche dell'animazione di ATTACCO."
"DOTA_Workshop_Animation_Attack2B_Desc"	"Un'animazione di attacco alternativa che verrà riprodotta casualmente al posto dell'animazione di ATTACCO. Gli effetti di impatto o i colpi verranno generati dal punto di ancoraggio di ATTACCO SECONDARIO anziché dal PUNTO DI ATTACCO di base. Deve avere la stessa durata e le stesse tempistiche dell'animazione di ATTACCO."
"DOTA_Workshop_Animation_Flail_Desc"	"Un'animazione ciclica usata quando l'unità è disabilitata e in movimento (in un ciclone, un buco nero, scagliata in aria)"
"DOTA_Workshop_Animation_TurnPoseCenter_Desc"	"Una posa a singolo frame dell'Unità che guarda in avanti. Puoi riutilizzare il frame 0 dell'animazione per la corsa. Se impostato, dovrai anche fornire le pose per la svolta verso sinistra e verso destra."
"DOTA_Workshop_Animation_TurnPoseLeft_Desc"	"Una posa a singolo frame dell'unità che svolta a sinistra. Appena l'unità svolta a sinistra, fonderemo questa posa con quella centrale. Se impostato, dovrai anche fornire le pose per la svolta centrale e verso destra."
"DOTA_Workshop_Animation_TurnPoseRight_Desc"	"Una posa a singolo frame dell'unità che svolta a destra. Appena l'unità svolta a destra, fonderemo questa posa con quella centrale. Se impostato, dovrai anche fornire le pose per la svolta centrale e verso sinistra."
"DOTA_Workshop_Animation_Center_Desc"	"Questa è l'animazione centrale. Verrà combinata con le versioni di destra e di sinistra della stessa animazione, in modo che questa unità possa seguire le altre nel gioco senza problemi"
"DOTA_Workshop_Animation_BackLeft_Desc"	"Questa è un'animazione completa che deve avere lo stesso numero di frame della versione centrale. L'Unità deve essere però girata in modo da puntare a 179 gradi verso sinistra. Ad esempio, la parte inferiore del modello dovrebbe continuare a puntare in avanti, ma la parte superiore dovrebbe roteare quasi completamente nella direzione opposta verso sinistra."
"DOTA_Workshop_Animation_Left_Desc"	"Questa è un'animazione completa che deve avere lo stesso numero di frame della versione centrale. L'Unità deve essere però girata in modo da puntare a 90 gradi verso sinistra. Ad esempio, la parte inferiore del modello dovrebbe continuare a puntare in avanti, ma la parte superiore dovrebbe roteare direttamente verso sinistra."
"DOTA_Workshop_Animation_Right_Desc"	"Questa è un'animazione completa che deve avere lo stesso numero di frame della versione centrale. L'Unità deve essere però girata in modo da puntare a 90 gradi verso destra. Ad esempio, la parte inferiore del modello dovrebbe continuare a puntare in avanti, ma la parte superiore dovrebbe roteare direttamente verso destra."
"DOTA_Workshop_Animation_BackRight_Desc"	"Questa è un'animazione completa che deve avere lo stesso numero di frame della versione centrale. L'Unità deve essere però girata in modo da puntare a 179 gradi verso destra. Ad esempio, la parte inferiore del modello dovrebbe continuare a puntare in avanti, ma la parte superiore dovrebbe roteare quasi completamente nella direzione opposta verso destra."
"DOTA_Workshop_LD_Trueform_Ability1"	"EVOCAZIONE DELLO SPIRITO ORSO"
"DOTA_Workshop_LD_Trueform_Ability1_Desc"	"Lunga 40 frame, l'evocazione avviene al frame 15."
"DOTA_Workshop_LD_Trueform_Ability2"	"RABBIA"
"DOTA_Workshop_LD_Trueform_Ability2_Desc"	"Lunga 30 frame, l'evocazione avviene al frame 0."
"DOTA_Workshop_LD_Trueform_Ability4"	"URLO DI BATTAGLIA"
"DOTA_Workshop_LD_Trueform_Ability4_Desc"	"Lunga 40 frame, l'evocazione avviene al frame 15."
"DOTA_Workshop_LD_Trueform_AbilityUlt"	"FORMA DI DRUIDO"
"DOTA_Workshop_LD_Trueform_AbilityUlt_Desc"	"Ritorna nella forma di druido. Lunga 70 frame, dovrebbe sparire sotto il terreno al frame 58."
"DOTA_Workshop_Animation_Victory"	"VITTORIA"
"DOTA_Workshop_Animation_Defeat"	"SCONFITTA"
"DOTA_Workshop_Animation_IdleOutOfRange"	"INATTIVO (FUORI GITTATA)"
"DOTA_Workshop_Animation_IdleOutOfRange_Desc_SB"	"Questa animazione di attesa viene usata quando Lone Druid è troppo lontano dal suo orso per permettergli di attaccare."
"DOTA_Workshop_Animation_RunOutOfRange"	"CORSA (FUORI GITTATA)"
"DOTA_Workshop_Animation_RunOutOfRange_Desc_SB"	"Questa animazione di corsa viene usata quando Lone Druid è troppo lontano dal suo orso per permettergli di attaccare."
"DOTA_Workshop_Animation_Die_Forward"	"MORTE FRONTALE"
"DOTA_Workshop_AmbientLight"	"Luce ambientale"
"DOTA_Workshop_BackgroundColor"	"Colore dello sfondo"
"DOTA_Workshop_BackgroundTexture"	"Texture dello sfondo"
"DOTA_Workshop_Camera"	"Telecamera"
"DOTA_Workshop_CameraFOV"	"Campo visivo della telecamera"
"DOTA_Workshop_EditAngles"	"Modifica gli angoli"
"DOTA_Workshop_EditAttachments"	"Modifica i punti di ancoraggio"
"DOTA_Workshop_EditGeneric"	"Modifica generalità"
"DOTA_Workshop_EditOrigin"	"Modifica l'origine"
"DOTA_Workshop_EditPortrait"	"Modifica il ritratto"
"DOTA_Workshop_GameDay"	"Giorno"
"DOTA_Workshop_GameNight"	"Notte"
"DOTA_Workshop_ImportLog"	"Log di importazione"
"DOTA_Workshop_Next"	"Avanti"
"DOTA_Workshop_PickType"	"Scegli il tipo"
"DOTA_Workshop_Portrait"	"Ritratto"
"DOTA_Workshop_Prev"	"Indietro"
"DOTA_Workshop_Preview"	"Anteprima"
"DOTA_Workshop_PreviewInGame"	"Anteprima in gioco"
"DOTA_Workshop_SelectInputs"	"Seleziona gli input"
"DOTA_Workshop_SelectWearables"	"Seleziona gli oggetti indossabili"
"DOTA_Workshop_ShadowColor"	"Colore dell'ombra"
"DOTA_Workshop_ShowLowResModel"	"Mostra il modello a bassa risoluzione"
"DOTA_Workshop_ShowPedestal"	"Mostra il piedistallo"
"DOTA_Workshop_ShowReferenceModel"	"Mostra il modello di riferimento"
"DOTA_Workshop_SpotLight"	"Riflettore"
"DOTA_Workshop_SpotlightDistance"	"Distanza del riflettore"
"DOTA_Workshop_SpotlightSize"	"Dimensioni del riflettore"
"DOTA_Workshop_Submit"	"Pubblica"
"DOTA_Workshop_Texture"	"Texture"
"DOTA_Workshop_TurnTable"	"Piattaforma girevole"
"DOTA_Workshop_WorkshopImportDialog"	"Finestra dell'importazione del Workshop"
"DOTA_Workshop_Err_MissingInput"	"Input richiesto mancante: \"%1\""
"DOTA_Workshop_Err_InvalidFile"	"File non valido: \"%1\""
"DOTA_Workshop_Err_FileDoesNotExist"	"Il file di origine \"%1\" non esiste"
"DOTA_Workshop_Err_FailedToCopy"	"Impossibile copiare alla destinazione \"%1\""
"DOTA_Workshop_Err_FailedToWrite"	"Impossibile scrivere alla destinazione \"%1\""
"DOTA_Workshop_Err_FailedToCompile"	"Impossibile compilare \"%1\""
"DOTA_Workshop_Err_SerializeVMDL"	"Errore interno (serializzazione del VMDL)"
"DOTA_Workshop_Err_ZipExists"	"Errore interno (file .zip univoco già esistente)"
"DOTA_Workshop_Err_FileNotInAssetSystem"	"Errore interno (file non trovato nell'assetsystem) \"%1\""
"DOTA_Workshop_Err_NoGameFile"	"Errore interno (file del gioco mancante) \"%1\""
"DOTA_Workshop_Err_NoContentFile"	"Errore interno (file dei contenuti mancante) \"%1\""
"DOTA_Workshop_Err_AssetNotInTestbed"	"Errore interno (risorsa non trovata nel testbed) \"%1\""
"DOTA_Workshop_BrowseForZipCaption"	"Seleziona il file .zip"
"DOTA_Workshop_BrowseForSessionCaption"	"Seleziona la sessione del Workshop"
"DOTA_Workshop_LoadSessionError"	"Impossibile caricare la sessione"
"DOTA_Workshop_SaveSessionError"	"Impossibile salvare la sessione"
"DOTA_Workshop_Err_SessionSaveKV3"	"Errore interno (salvataggio del KV3: %1)"
"DOTA_Workshop_Err_SessionSaveNoTemplate"	"Errore interno (nessun template)"
"DOTA_Workshop_Err_SessionLoadBadData"	"Errore interno (problema di caricamento dati: %1)"
"DOTA_Workshop_Err_SessionLoadBadTemplate"	"Nome del template non riconosciuto: \"%1\""
"DOTA_Workshop_Err_Misc"	"Errore interno (%1)"
"DOTA_Workshop_Err_BadCfg"	"Errore interno (\"%1\": %2 previsto mancante)"
"DOTA_Workshop_Err_BadUI"	"Errore interno (interfaccia mal configurata, risultato previsto \"%1\": %2)"
"DOTA_Workshop_Err_BadSession"	"Errore interno (sessione mal configurata, risultato previsto \"%1\": %2)"
"DOTA_Filter_Field_Category"	"Etichette"
"DOTA_Armory_Tags_Popup_Title"	"Imposta le etichette"
"DOTA_Armory_Attributes"	"Attributi"
"DOTA_Event_Level"	"Livello"
"DOTA_Skip"	"Salta"
"DOTA_Done"	"Fatto"
"DOTA_TryAgain"	"Riprova"
"DOTA_Treasure_OpenAnother"	"Apri un altro"
"DOTA_Treasure_OpenTreasure"	"Apri il tesoro"
"DOTA_Treasure_OpenNoDupe"	"I tesori che apri contengono {d:items_per_treasure} degli oggetti normali mostrati. Non riceverai doppioni finché non ottieni una copia di ciascun oggetto. Se la fortuna è dalla tua parte, troverai anche un oggetto raro."
"DOTA_Treasure_OpenDupe"	"I tesori che apri contengono {d:items_per_treasure} degli oggetti normali mostrati. Potresti ricevere dei doppioni. Se la fortuna è dalla tua parte, troverai anche un oggetto raro."
"DOTA_Treasure_OpenFailed_NoItem"	"Impossibile trovare un tesoro da aprire nell'Arsenale."
"DOTA_Treasure_OpenFailed_NoItemsReceived"	"Impossibile recuperare la lista degli oggetti ricevuti dal tesoro."
"DOTA_Treasure_OpenSuccess"	"Complimenti! Hai ottenuto:"
"dota_settings_force_right_click_attack"	"Forza l'attacco con il clic destro"
"DOTA_Settings_Tooltip_Force_Right_Click_Attack"	"Cliccando col pulsante destro su un'Unità alleata, il tuo Eroe proverà ad attaccarla."
"DOTA_Effigy_AcceptCustomize"	"Accetta la posa dell'Effigie"
"DOTA_Effigy_CancelCustomize"	"Annulla la posa dell'Effigie"
}
