"dota"
{
"DOTA_Accept"	"Αποδοχή"
"DOTA_Cancel"	"Άκυρο"
"DOTA_Console"	"Κονσόλα"
"DOTA_Create"	"Δημιουργία"
"DOTA_Decline"	"Απόρριψη"
"DOTA_Error"	"Σφάλμα"
"DOTA_Join"	"Σύνδεση"
"DOTA_Leave"	"Αποχώρηση"
"DOTA_New"	"ΝΕΟ"
"DOTA_Ok"	"OK"
"DOTA_Sale"	"Προσφορά"
"DOTA_Close"	"Κλείσιμο"
"DOTA_Continue"	"Συνέχεια"
"DOTA_Add"	"Προσθήκη"
"DOTA_Edit"	"Επεξεργασία"
"DOTA_Enable"	"Ενεργοποίηση"
"DOTA_Disable"	"Απενεργοποίηση"
"DOTA_Refresh"	"Ανανέωση"
"DOTA_Loading"	"Φόρτωση"
"DOTA_None"	"Κανένα"
"DOTA_Customize"	"Προσαρμογή"
"DOTA_AcceptChanges"	"Αποδοχή αλλαγών"
"dota_team_radiant"	"Radiant"
"dota_team_dire"	"Dire"
"Unknown"	"Άγνωστο"
"UI_Yes"	"ΝΑΙ"
"UI_No"	"ΟΧΙ"
"UI_File_Filter_Any"	"Όλα τα αρχεία (*.*)"
"DOTA_MainMenu_Heroes"	"ΗΡΩΕΣ"
"DOTA_MainMenu_Watch"	"ΠΑΡΑΚΟΛΟΥΘΗΣΗ"
"DOTA_MainMenu_Learn"	"ΕΚΜΑΘΗΣΗ"
"DOTA_MainMenu_Mods"	"ΠΡΟΣΑΡΜΟΣΜΕΝΑ ΠΑΙΧΝΙΔΙΑ"
"DOTA_TabName_Treasury"	"Θησαυροφυλάκιο"
"DOTA_TabName_Armory"	"Οπλοστάσιο"
"DOTA_ConfirmQuit"	"Επιβεβαίωση εξόδου"
"DOTA_ConfirmQuitDesc"	"Επιθυμείτε πραγματικά την έξοδο από το Dota;"
"DOTA_ConfirmQuitDescUnsafe"	"Η αποχώρηση από ένα παιχνίδι πριν τελειώσει μπορεί να καταστρέψει το παιχνίδι και για τους υπόλοιπους παίκτες. Επιθυμείτε πραγματικά την έξοδο από το Dota 2;"
"DOTA_InvalidPersonaName"	"[άγνωστο]"
"DOTA_Friends_WindowTitle"	"ΦΙΛΟΙ"
"DOTA_FriendsCategory_ReadyToPlay"	"Σε ανοικτά παιχνίδια <font color='#63C290'><b></b>({d:friend_count})</font>"
"DOTA_FriendsCategory_PlayingDota"	"Στο Dota <font color='#ACEBA9'>({d:friend_count})</font>"
"DOTA_FriendsCategory_Online"	"Συνδεδεμένοι <font color='#6a9dcc'>({d:friend_count})</font>"
"DOTA_FriendsCategory_Pending"	"Εκκρεμείς <font color='#eeee82'>({d:friend_count})</font>"
"DOTA_FriendsCategory_Offline"	"Εκτός σύνδεσης <font color='#676666'>({d:friend_count})</font>"
"DOTA_Friends_Empty"	"Η λίστα φίλων σας είναι άδεια αυτή τη στιγμή"
"DOTA_FriendsMenu_Tooltip_NoneReady"	"Φίλοι"
"DOTA_UserName"	"{g:dota_persona:user_account_id}"
"DOTA_UserNamePro"	"{g:dota_persona_pro:user_account_id}"
"DOTA_UserNickname"	"{g:dota_persona_nickname:user_account_id}"
"DOTA_UserRichPresence"	"{s:user_rich_presence}"
"DOTA_ProfileCard_StatTitle_SoloRank"	"Solo MMR"
"DOTA_ProfileCard_StatTitle_PartyRank"	"MMR παρέας"
"DOTA_ProfileCard_StatTitle_Wins"	"Νίκες"
"DOTA_ProfileCard_StatTitle_Commends"	"ΣΥΣΤΑΣΕΙΣ"
"DOTA_ProfileCard_StatTitle_GamesPlayed"	"Αγώνες"
"DOTA_ProfileCard_StatTitle_FirstMatchDate"	"Πρώτος αγώνας"
"DOTA_ProfileCard_StatValue_Int"	"{d:stat_value}"
"DOTA_ProfileCard_StatValue_Date"	"{t:s:stat_value}"
"DOTA_ProfileCard_StatValue_String"	"{s:stat_value}"
"DOTA_ProfileCard_SlotTab_Trophies"	"Τρόπαια"
"DOTA_ProfileCard_SlotTab_Items"	"Οπλοστάσιο"
"DOTA_ProfileCard_SlotTab_Heroes"	"Ήρωες"
"DOTA_ProfileCard_SlotTab_Emoticons"	"Emoticon"
"DOTA_ProfileCard_NoTrophies"	"Δεν υπάρχουν διαθέσιμα τρόπαια."
"DOTA_ProfileCard_NoItems"	"Δεν υπάρχουν διαθέσιμα αντικείμενα."
"DOTA_ProfileCard_HeroOnly"	"Μόνο ήρωες"
"DOTA_ProfileCard_HeroShowWins"	"Εμφάνιση νικών"
"DOTA_ProfileCard_ItemSearchPrefix"	"Αναζήτηση για:"
"DOTA_ProfileCard_ItemSearchPlaceholder"	"Αντικείμενα ανά όνομα"
"DOTA_ProfileCard_ItemArmoryLink"	"Προβολή πλήρους οπλοστασίου"
"DOTA_HeroTooltip_HeroName"	"{s:hero_name}"
"DOTA_HeroTooltip_HeroRecord"	"{s:hero_wins_string}, {s:hero_losses_string}"
"DOTA_ProfileCard_HeroSearchPlaceholder"	"Αναζήτηση ανά όνομα ήρωα"
"DOTA_Wins_Singular"	"1 νίκη"
"DOTA_Wins_Plural"	"{d:hero_wins} νίκες"
"DOTA_Losses_Singular"	"1 ήττα"
"DOTA_Losses_Plural"	"{d:hero_losses} ήττες"
"DOTA_Profile_TotalGames"	"Συνολικοί αγώνες"
"DOTA_Profile_Solo_MMR"	"Solo MMR"
"DOTA_Profile_Team_MMR"	"MMR ομάδας"
"DOTA_Profile_Party_MMR"	"MMR παρέας"
"DOTA_Profile_VictoryCount"	"Νίκες"
"DOTA_Profile_ProfilePage"	"ΠΡΟΦΙΛ"
"DOTA_Profile_TrophyPage"	"Τρόπαια"
"DOTA_Profile_RecentGamesPage"	"ΠΡΟΣΦΑΤΑ ΠΑΙΧΝΙΔΙΑ"
"DOTA_Profile_HeroPage"	"ΗΡΩΕΣ"
"DOTA_Profile_PlayStyle"	"ΣΤΥΛ ΠΑΙΧΝΙΔΙΟΥ"
"DOTA_Profile_MostRecent"	"Πιο πρόσφατα {s:num_style_games} παιχνίδια"
"DOTA_Profile_RecentActivity"	"Πρόσφατη δραστηριότητα"
"DOTA_Profile_Fighting_Tooltip"	"Παίκτες που πολεμάνε σε πολλές μάχες με αντίπαλους ήρωες."
"DOTA_Profile_Tooltip_Value"	"{s:CurrentStatValue}"
"DOTA_Profile_Tooltip_Comparison"	"{s:CurrentComparisonValue}"
"DOTA_Profile_StatsCompare"	"Σύγκριση με τα στατιστικά μου"
"DOTA_Profile_Self"	"Εγώ"
"DOTA_Profile_GPM"	"Μέσος Χ/Λ"
"DOTA_Profile_XPM"	"Μέση Ε/Λ"
"DOTA_Profile_LH"	"Μέσες τελικές επιθέσεις"
"DOTA_Profile_CourierKills"	"Σκοτωμένοι μεταφορείς"
"DOTA_Profile_CheeseEaten"	"Φαγωμένα τυριά"
"DOTA_Profile_GPMValue"	"{s:GPM}"
"DOTA_Profile_XPMValue"	"{s:XPM}"
"DOTA_Profile_LHValue"	"{s:LH}"
"DOTA_Profile_RampagesValue"	"{d:Rampages}"
"DOTA_Profile_TripleKillsValue"	"{d:TripleKills}"
"DOTA_Profile_FirstBloodValue"	"{d:FirstBlood}"
"DOTA_Profile_FirstBledValue"	"{d:FirstBled}"
"DOTA_Profile_CourierKillsValue"	"{d:CourierKills}"
"DOTA_Profile_AegisesValue"	"{d:Aegises}"
"DOTA_Profile_CheeseEatenValue"	"{d:CheeseEaten}"
"DOTA_Profile_CreepStackValue"	"{d:CreepStack}"
"DOTA_Profile_GPMLocalValue"	"{s:GPMLocal}"
"DOTA_Profile_XPMLocalValue"	"{s:XPMLocal}"
"DOTA_Profile_LHLocalValue"	"{s:LHLocal}"
"DOTA_Profile_RampagesLocalValue"	"{d:RampagesLocal}"
"DOTA_Profile_TripleKillsLocalValue"	"{d:TripleKillsLocal}"
"DOTA_Profile_FirstBloodLocalValue"	"{d:FirstBloodLocal}"
"DOTA_Profile_FirstBledLocalValue"	"{d:FirstBledLocal}"
"DOTA_Profile_CourierKillsLocalValue"	"{d:CourierKillsLocal}"
"DOTA_Profile_AegisesLocalValue"	"{d:AegisesLocal}"
"DOTA_Profile_CheeseEatenLocalValue"	"{d:CheeseEatenLocal}"
"DOTA_Profile_CreepStackLocalValue"	"{d:CreepStackLocal}"
"DOTA_RecentGames_Title"	"Πρόσφατα παιχνίδια"
"DOTA_RecentGames_TimeStamp"	"ΗΜΕΡΟΜΗΝΙΑ/ΩΡΑ"
"DOTA_RecentGames_GameResult"	"ΑΠΟΤΕΛΕΣΜΑ"
"DOTA_RecentGames_GameLength"	"ΔΙΑΡΚΕΙΑ"
"DOTA_RecentGames_Team"	"Ομάδα"
"DOTA_RecentGames_GameType"	"ΤΥΠΟΣ"
"DOTA_RecentGames_Items"	"Αντικείμενα"
"DOTA_RecentGame_Timestamp_Entry"	"{t:s:timestamp} {t:t:timestamp}"
"DOTA_RecentGame_Duration"	"{t:d:duration}"
"DOTA_RecentGame_Downloading"	"{s:DownloadPercent} σε λήψη"
"DOTA_RecentGame_Watch"	"Παρακολούθηση επανάληψης"
"DOTA_RecentGame_NoReplay"	"Καμία επανάληψη"
"DOTA_RecentGame_Expired"	"Η επανάληψη έληξε"
"DOTA_RecentGame_Finding"	"Εύρεση..."
"DOTA_RecentGame_Download"	"Λήψη αγώνα"
"DOTA_RecentGame_Pending"	"Εκκρεμής επανάληψη"
"DOTA_RecentGame_Unavailable"	"Μη διαθέσιμη επανάληψη"
"DOTA_RecentGame_MatchID"	"ID αγώνα: #{s:match_id}"
"DOTA_No_Team_Name"	"--"
"DOTA_TrophyCount"	"{d:trophy_count} τρόπαιο"
"DOTA_TrophiesCount"	"{d:trophy_count} τρόπαια"
"DOTA_TrophyCount_Number"	"{d:trophy_count}"
"DOTA_TrophyCount_NoNum"	"Τρόπαιο"
"DOTA_TrophiesCount_NoNum"	"Τρόπαια"
"DOTA_Trophies_ViewAll"	"Όλα"
"DOTA_TrophyName"	"{s:trophy_name}"
"DOTA_TrophyCategory"	"{s:trophy_category}"
"DOTA_TrophyDescription"	"{s:trophy_description}"
"DOTA_TrophyXP"	"{d:trophy_xp} εμπειρία"
"DOTA_NextTrophy"	"Επόμενο βραβείο"
"DOTA_NewPlayerQuestion_Title"	"ΚΑΛΩΣ ΟΡΙΣΑΤΕ ΣΤΟ DOTA 2"
"DOTA_PlayerOriginQuestion_Question"	"Για τη βελτίωση της εμπειρίας παιχνιδιού σας, κοινοποιήστε την εξοικείωση σας με το Dota 2 και παρόμοια παιχνίδια:"
"DOTA_PlayerOriginQuestion_BeginnerButton"	"Είμαι αρχάριος."
"DOTA_PlayerOriginQuestion_RTSButton"	"Έχω παίξει παιχνίδια στρατηγικής (RTS)."
"DOTA_PlayerOriginQuestion_MOBAButton"	"Έχω παίξει παιχνίδι παρόμοιο με το Dota 2."
"DOTA_PlayerOriginQuestion_Dota2Button"	"Έχω παίξει Dota 2."
"DOTA_PlayerOriginQuestion_MOBAExplanation"	"Επιλέξτε το παιχνίδι με το οποίο είστε πιο άνετος:"
"DOTA_OtherGames_LOL"	"League of Legends"
"DOTA_OtherGames_DOTA"	"Dota 1"
"DOTA_OtherGames_HON"	"Heroes of Newerth"
"DOTA_OtherGames_Smite"	"Smite"
"DOTA_OtherGames_Other"	"Άλλο παιχνίδι"
"DOTA_PlayerOriginQuestion_ConfirmationButton"	"ΑΣ ΠΑΙΞΟΥΜΕ"
"DOTA_PlayerOriginQuestion_ConfirmationTutorial"	"Ως νέος παίκτης στο Dota 2, μπορεί να σας ενδιαφέρει η εκμάθηση στο τμήμα Εκμάθηση της καρτέλας Παιχνίδι."
"DOTA_PlayerOriginQuestion_ConfirmationSettings"	"Τα πλήκτρα και οι επιλογές σας έχουν οριστεί με τις πιο συχνά χρησιμοποιούμενες ρυθμίσεις για παίκτες με τη δική σας εμπειρία. Μπορείτε να τις προσαρμόσετε ανά πάσα στιγμή πατώντας στο εικονίδιο ρυθμίσεων."
"DOTA_Tutorial_SkipButton"	"Παράλειψη εκμάθησης"
"DOTA_ConfirmSkip"	"Παράλειψη εισαγωγής Dota 2;"
"DOTA_ConfirmSkipDesc"	"Σίγουρα θέλετε να παραλείψετε την εκμάθηση του Dota 2?"
"DOTA_Tutorial_Start_Quest"	"ΕΚΚΙΝΗΣΗ ΑΠΟΣΤΟΛΗΣ"
"DOTA_Tutorial_Quest0_Title"	"ΑΠΟΣΤΟΛΗ 1"
"DOTA_Tutorial_Quest0DetailsDesc"	"Αυτή η αποστολή θα πάρει περίπου\n10 λεπτά για να ολοκληρωθεί."
"DOTA_Tutorial_QuestDetailsLearn"	"Θα μάθετε:"
"DOTA_Tutorial_Quest1_Title"	"ΑΠΟΣΤΟΛΗ 2"
"DOTA_Tutorial_Quest1DetailsDesc"	"Αυτή η αποστολή θα πάρει περίπου\n10 λεπτά για να ολοκληρωθεί."
"DOTA_Tutorial_Quest2_Title"	"ΑΠΟΣΤΟΛΗ 3"
"DOTA_Tutorial_Quest2DetailsDesc"	"Αυτή η αποστολή θα πάρει περίπου\n10 - 15 λεπτά για να ολοκληρωθεί."
"DOTA_Challenges_Title"	"Εκμάθηση"
"DOTA_ChallengeGroup_0_Title"	"Μηχανισμοί"
"DOTA_ChallengeGroup_1_Desc"	"Εκκίνηση εδώ!"
"DOTA_ChallengeGroup_Locked"	"Κλειδωμένο"
"DOTA_LearnMechanics_Title"	"Μηχανισμοί"
"DOTA_GuidedBotMatches_0_Title"	"Luna"
"DOTA_GuidedBotMatches_1_Title"	"Sven"
"DOTA_GuidedBotMatches_2_Title"	"Lina"
"DOTA_LearnBotMatches_Title"	"Παιχνίδια με Bot"
"DOTA_BotMatches_0_Desc"	"Εκμάθηση νέου ήρωα."
"DOTA_BotMatches_1_Desc"	"Νιώστε άνετα."
"DOTA_BotMatches_2_Desc"	"Προκαλέστε τον εαυτό σας."
"DOTA_BotMatches_3_Desc"	"Βλάψτε τον εαυτό σας."
"FileOpenDialog_Open"	"Άνοιγμα"
"FileOpenDialog_Save"	"Αποθήκευση"
"FileOpenDialog_Select"	"Επιλογή"
"FileOpenDialog_FileType_Folder"	"Φάκελος"
"DOTA_FindMatch"	"Εύρεση αγώνα"
"DOTA_FindingMatch"	"Εύρεση αγώνα ( {s:find_match_time} )"
"DOTA_FindMatchTime"	"{s:find_match_time}"
"DOTA_Searching"	"Αναζήτηση"
"DOTA_StartSoloBotMatch"	"Εκκίνηση αγώνα Bot"
"DOTA_Create_Lobby"	"ΔΗΜΙΟΥΡΓΙΑ"
"DOTA_Join_Lobby"	"Σύνδεση στο λόμπι"
"DOTA_LobbyStartGame"	"Εκκίνηση παιχνιδιού"
"DOTA_ReturnToLobby"	"Πίσω στο λόμπι"
"DOTA_FindMatchStatus"	"{s:searching_matchtype} / {s:searching_gamemodes} / {s:searching_region}"
"DOTA_FindGameModesMany"	"Είδη παιχνιδιού: "
"DOTA_FindRegionsMany"	"Περιοχές: "
"DOTA_GameMode_AllPick"	"All Pick"
"DOTA_GameMode_SingleDraft"	"Single Draft"
"DOTA_GameMode_CaptainsMode"	"Captains Mode"
"DOTA_GameMode_RandomDraft"	"Random Draft"
"DOTA_GameMode_AbilityDraft"	"Ability Draft"
"DOTA_GameMode_LeastPlayed"	"Least Played"
"DOTA_GameMode_AllRandom"	"All Random"
"DOTA_GameMode_LimitedHeroes"	"Limited Heroes"
"DOTA_GameMode_CaptainsDraft"	"Captains Draft"
"DOTA_GameMode_AllRandomDeathMatch"	"All Random Death Match"
"DOTA_ImmediatePurchase_SendFailed"	"Αποτυχία αποστολής αιτήματος αγοράς. Οι διακομιστές του Dota μπορεί να βρίσκονται εκτός σύνδεσης. Προσπαθήστε ξανά αργότερα."
"DOTA_ImmediatePurchase_Success_Title"	"Επιτυχία"
"DOTA_ImmediatePurchase_Success_Text"	"Η αγορά ολοκληρώθηκε επιτυχώς! Τα αντικείμενά σας θα εμφανιστούν στο Οπλοστάσιο σύντομα."
"DOTA_ImmediatePurchase_Cancelled_Title"	"Ακυρώθηκε"
"DOTA_ImmediatePurchase_LateCancel"	"Η αγορά προηγουμένως ακυρώθηκε. Δεν έχετε χρεωθεί."
"DOTA_ConfirmPurchaseTitle"	"Επιβεβαίωση αγοράς"
"DOTA_ConfirmPurchaseText"	"Θέλετε να αγοράσετε αυτό το αντικείμενο;"
"DOTA_PurchaseInProgress_Title"	"Αγορά σε εξέλιξη"
"DOTA_PurchaseInProgress_Text"	"Το αίτημα αγοράς σας επεξεργάζεται."
"DOTA_UnbundleInProgress_Title"	"Ξεπακετάρισμα σε εξέλιξη"
"DOTA_UnbundleInProgress_Text"	"Το πακέτο σας ξεπακετάρεται."
"DOTA_PartnerPurchase_Purchase"	"{g:dota_item_price:item_def}"
"DOTA_PartnerPurchase_Balance"	"Υπόλοιπο: {m:balance}"
"DOTA_PartnerRecharge_Close"	"Επιστροφή στην αγορά"
"StoreCheckout_Error_Title"	"Σφάλμα"
"StoreCheckout_NoItems"	"Το καλάθι αγορών σας είναι άδειο!"
"StoreCheckout_TooManyItems"	"Έχετε πάρα πολλά αντικείμενα στο καλάθι αγορών σας!"
"StoreCheckout_Loading"	"Ολοκλήρωση αγοράς..."
"StoreCheckout_Unavailable"	"Δεν είναι δυνατή η ολοκλήρωση της αγοράς σας αυτή τη στιγμή."
"StoreCheckout_Cancelling"	"Γίνεται ακύρωση..."
"StoreCheckout_Fail"	"Το Κατάστημα εντός παιχνιδιού είναι προσωρινά κλειστό."
"StoreCheckout_InvalidParam"	"Ένας προγραμματιστής τα έκανε θάλασσα! Μια μη έγκυρη παράμετρος πέρασε στον συντονιστή παιχνιδιού. Επιχειρήστε ξανά την αγορά."
"StoreCheckout_InternalError"	"Παρουσιάστηκε ένα σφάλμα κατά την αρχικοποίηση ή ενημέρωση της συναλλαγής σας. Περιμένετε λιγάκι και προσπαθήστε ξανά ή επικοινωνήστε με την υποστήριξη για βοήθεια."
"StoreCheckout_ContactSupport"	"Υπήρξε ένα σφάλμα με τη συναλλαγή σας. Επικοινωνήστε με την υποστήριξη για βοήθεια."
"StoreCheckout_NotApproved"	"Ο συντονιστής παιχνιδιού δεν μπόρεσε να εγκρίνει τη συναλλαγή σας με το Steam. Προσπαθήστε ξανά την αγορά αργότερα."
"StoreCheckout_NotLoggedin"	"Πρέπει να είστε συνδεδεμένος στο Steam για να ολοκληρώσετε μια αγορά."
"StoreCheckout_WrongCurrency"	"Το νόμισμα της συναλλαγής δεν ταιριάζει με το νόμισμα του πορτοφολιού σας."
"StoreCheckout_NoAccount"	"Ο λογαριασμός σας στο Steam είναι προσωρινά μη διαθέσιμος. Προσπαθήστε ξανά την αγορά αργότερα."
"StoreCheckout_InsufficientFunds"	"Δεν έχετε αρκετά χρήματα για να ολοκληρώσετε την αγορά."
"StoreCheckout_TimedOut"	"Η συναλλαγή σας έληξε. Προσπαθήστε την αγορά ξανά."
"StoreCheckout_SteamAccountDisabled"	"Ο λογαριασμός σας στο Steam είναι απενεργοποιημένος και δεν μπορεί να πραγματοποιήσει αγορές."
"StoreCheckout_SteamAccountNoPurchase"	"Οι συναλλαγές με το πορτοφόλι Steam έχουν απενεργοποιηθεί σε αυτόν το λογαριασμό."
"StoreCheckout_OldPriceSheet"	"Η τοπική λίστα προϊόντων σας δεν είναι ενημερωμένη. Γίνεται λήψη νέας."
"StoreCheckout_TransactionNotFound"	"Η ταυτότητα αυτής της συναλλαγής δε βρέθηκε από το συντονιστή παιχνιδιού. Προσπαθήστε την αγορά σας ξανά."
"StoreCheckout_TransactionCancelled"	"Η συναλλαγή ακυρώθηκε. Δεν έχετε χρεωθεί."
"StoreCheckout_TransactionCompleted"	"Η συναλλαγή ολοκληρώθηκε!\\\nΑπολαύστε τα λάφυρά σας!"
"StoreCheckout_CompleteButUnfinalized"	"Αδυναμία επιβεβαίωσης επιτυχίας. Σε περίπτωση επιτυχίας, τα αντικείμενά σας θα παραδοθούν σε κάποια αργότερη ημερομηνία."
"StoreCheckout_NotEnoughRoom"	"Δεν έχετε αρκετό χώρο στο οπλοστάσιό σας για την αγορά τόσων πολλών αντικειμένων."
"StoreCheckout_ContactSupport_Dialog_Title"	"Προειδοποίηση"
"StoreCheckout_ContactSupport_Dialog_Btn"	"Επικοινωνία"
"StoreCheckout_LimitedQuantityItemsUnavailable"	"Ένα αντικείμενο που προσπαθείτε να αγοράσετε έχει εξαντληθεί ή δεν είναι πλέον διαθέσιμο."
"StoreCheckout_Nexon_InsufficientFunds"	"Δεν έχετε αρκετά χρήματα για να ολοκληρώσετε τη συναλλαγή."
"StoreCheckout_Nexon_FundsLocked"	"Το κλείδωμα μετρητών του Nexon είναι ενεργό."
"npc_dota_hero_broodmother_hype"	"Κρυμμένη σχεδόν αόρατη μέσα στους ιστούς της, η Broodmother γεννά μια στρατιά αραχνιδίων για να οδηγήσει την ομάδα της προς τη βάση των αντιπάλων. Καθώς το θύμα περιπλανιέται κοντά, επιτίθεται μαζί με τα παιδιά της, επιβραδύνοντας και καθιστώντας ανίκανους τους εχθρούς της με τα τσιμπήματά της, καθώς ικανοποιεί την ακόρεστη πείνα της."
"npc_dota_hero_chaos_knight_hype"	"Ο Chaos Knight είναι μια στρατιά από μόνος του. Ικανός να κλητεύσει ένα ιππικό από κλώνους για να συντρίψει τις άμυνες των εχθρών, όταν ο εχθρός του παρουσιαστεί, δημιουργεί ένα ρήγμα στην πραγματικότητα τραβώντας τον ίδιο και τη στρατιά του αρκετά κοντά για να μεταφέρει βάναυσα χτυπήματα εναντίον του."
"npc_dota_hero_dazzle_hype"	"Γεννημένος να υποστηρίζει τις ομάδες του στη μάχη, ο Dazzle κρατά στη ζωή τους τραυματισμένους του συμμάχους έτσι ώστε αργότερα να σπείρουν το θάνατο στον εχθρό. Η παράξενη μαγεία του μετατρέπεται σε κοντινή πανοπλία, που αποδυναμώνει τους εχθρούς και ισχυροποιεί τους συμμάχους."
"npc_dota_hero_doom_bringer_hype"	"Με τον έναν ή με τον άλλο τρόπο, ο Doom αποτελειώνει τους εχθρούς του. Καταβροχθίζει τις μονάδες για να ανακτήσει τις διάφορες ικανότητες που είχαν εν ζωή, μπορεί να θέσει μια μακροχρόνια σιγή στις ικανότητες και στα αντικείμενα του αντιπάλου του με την απόλυτη ικανότητά του καθώς κατακαίει τους αντιπάλους του."
"npc_dota_hero_dragon_knight_hype"	"Καθώς παίρνει την φοβερή μορφή του, ο Dragon Knight σπέρνει τον τρόμο σε οποιονδήποτε τον αντικρύζει. Ισχυρός και προσαρμόσιμος, μπορεί να σαστίσει και να κάψει όλους τους εχθρούς που στέκονται μπροστά του, συχνά παρέχοντας στους συμμάχους του την ορμή που χρειάζονται για να τους οδηγήσει στη νίκη."
"npc_dota_hero_meepo_hype"	"Κλητεύοντας μέχρι και πέντε μόνιμα αντίγραφα του εαυτού του, ο Meepo μπορεί να πολεμήσει από κάθε μέτωπο με μιάς. Εξαπλώνοντας τους κλώνους του σε όλο το πεδίο της μάχης, όταν βρει έναν εχθρό, τον δένει, μαζεύει τους εαυτούς του με μια αστραπιαία τηλεμεταφορά, έπειτα θάβει ότι έχει απομείνει."
"DOTA_AbilityTooltip_Name"	"{s:name}"
"DOTA_AbilityTooltip_Level"	"Επίπεδο {s:level}"
"DOTA_AbilityTooltip_TargetType"	"ΕΠΗΡΕΑΖΕΙ: {s:targettype}"
"DOTA_AbilityTooltip_CastType"	"ΙΚΑΝΟΤΗΤΑ: {s:casttype}"
"DOTA_AbilityTooltip_DamageType"	"ΤΥΠΟΣ ΖΗΜΙΑΣ: {s:damagetype}"
"DOTA_AbilityTooltip_Description"	"{s:description}"
"DOTA_AbilityTooltip_ScepterDescription"	"{s:scepterdescription}"
"DOTA_AbilityTooltip_ExtraDescription"	"{s:extradescription}"
"DOTA_AbilityTooltip_Attributes"	"{s:attributes}"
"DOTA_AbilityTooltip_Cooldown"	"{s:cooldown}"
"DOTA_AbilityTooltip_ManaCost"	"{s:manacost}"
"DOTA_AbilityTooltip_Lore"	"{s:lore}"
"DOTA_AbilityTooltip_UpgradeLevel"	"Αναβάθμιση σε επίπεδο ήρωα {d:upgradelevel}"
"DOTA_AbilityTooltip_BuildHeader"	"Οδηγός ικανοτήτων"
"DOTA_AbilityTooltip_BuildComment"	"{s:buildcomment}"
"DOTA_PersonaTooltip_Title"	"{g:dota_persona:account_id}"
"DOTA_PersonaTooltip_TitlePro"	"{g:dota_persona_pro:account_id}"
"DOTA_PendingInvites"	"Προσκλήσεις παρέας"
"DOTA_PendingInvitesTooltip_None"	"Καμία πρόσκληση σε εκκρεμότητα"
"DOTA_PendingInvitesTooltip_1"	"1 πρόσκληση σε εκκρεμότητα"
"DOTA_PendingInvitesTooltip_N"	"{d:pending_invite_count} προσκλήσεις σε εκκρεμότητα"
"DOTA_PendingInvitesTooltip_Leader"	"Πατήστε για διαχείριση των προσκλήσεων."
"DOTA_PendingInvitesTooltip_NonLeader"	"Πατήστε για προβολή των προσκλήσεων."
"DOTA_PendingInvitesCancelAll"	"Ακύρωση όλων των προσκλήσεων"
"DOTA_PendingInvitesNotPartyLeader"	"Μόνο ο αρχηγός της παρέας μπορεί να διαχειριστεί τις προσκλήσεις"
"DOTA_ChatTab_NotInChannelMessage"	"Κανείς δεν σας ακούει."
"DOTA_ChatTab_ToggleGlobal"	"Εμφάνιση μηνυμάτων από αυτό το κανάλι σε όλες τις καρτέλες."
"DOTA_ChatTab_Close"	"Κλείσιμο καρτέλας."
"DOTA_ChatTab_Leave"	"Αποχώρηση από κανάλι."
"DOTA_JoinChatChannel_Title"	"Σύνδεση σε κανάλι"
"DOTA_JoinChatChannel_Description"	"Δημιουργία ή σύνδεση σε κανάλι συνομιλίας."
"DOTA_JoinChatChannel_AddToCurrentTab"	"Προσθήκη στην τρέχουσα καρτέλα «{s:current_tab_name}»"
"DOTA_JoinChatChannel_CreateNewTab"	"Δημιουργία νέας καρτέλας:"
"DOTA_Chat_ChannelName"	"{s:channel_name}"
"DOTA_Chat_ChannelMemberCount_Singular"	"1 Μέλος"
"DOTA_Chat_ChannelMemberCount_Plural"	"{d:channel_member_count} μέλη"
"DOTA_EditChatTab_Title"	"Τροποποίηση καρτέλας συνομιλίας"
"DOTA_EditChatTab_Description"	"Επιλέξτε ποια μηνύματα θέλετε να εμφανίζονται σε αυτή την καρτέλα."
"DOTA_EditChatTab_AddNewChannel"	"Προσθήκη νέου καναλιού..."
"DOTA_EditChatTab_TabName"	"Όνομα καρτέλας:"
"DOTA_EditChatTab_ChannelToggleDisabled"	"Το {s:target} πρέπει να είναι τουλάχιστον σε μια καρτέλα."
"DOTA_EditChatTab_Target"	"{s:target}"
"DOTA_Chat_TimestampFormat"	"{t:t:timestamp}"
"DOTA_Chat_Autocomplete_Title"	"{s:autocomplete_title}"
"DOTA_Chat_Autocomplete_InviteFriends"	"Πρόσκληση φίλου"
"DOTA_Chat_Autocomplete_Channels"	"Κανάλια"
"DOTA_Chat_Autocomplete_Commands"	"Εντολές"
"DOTA_Chat_Autocomplete_CommandName"	"/{s:command_name}"
"DOTA_Chat_Autocomplete_CommandDescription"	"{s:command_description}"
"dota_suggest_invite_format"	"Προσκαλέστε τον %s1 στην παρέα."
"dota_suggest_invite_format_leader"	"Προσκαλέστε τον {s:invite_persona} στην παρέα. ( <a href=\"event:DOTAInviteToParty({s:invite_persona_steamid})\" class=\"InviteButton\">Αποστολή πρόσκλησης</a> )"
"dota_suggest_invite_format_lobby"	"Προσκαλέστε τον {s:invite_persona} στο λόμπι."
"dota_suggest_invite_format_lobby_leader"	"Προσκαλέστε τον {s:invite_persona} στο λόμπι. ( <a href=\"event:DOTAInviteToLobby({s:invite_persona_steamid})\" class=\"InviteButton\">Αποστολή πρόσκλησης</a> )"
"DOTA_ChatMessage_Default"	"<span class=\"{s:target_class}\"><span class=\"ChatTarget\">(<a href=\"{s:target_link}\">{s:target}</a>)</span> <span class=\"ChatPersona\">[{s:event_crest}{s:persona}]</span>: {g:dota_filtered_string:message}</span>"
"DOTA_ChatMessage_WhisperTo"	"<span class=\"{s:target_class}\">Προς <span class=\"ChatPersona\">[{s:event_crest}{s:persona}]</span>: {g:dota_filtered_string:message}</span>"
"DOTA_ChatMessage_WhisperFrom"	"<span class=\"{s:target_class}\">Από <span class=\"ChatPersona\">[{s:event_crest}{s:persona}]</span>: {g:dota_filtered_string:message}</span>"
"DOTA_ChatMessage_System"	"<span class=\"{s:target_class}\"><span class=\"ChatTarget\">({s:target})</span>: {g:dota_filtered_string:message}</span>"
"DOTA_ChatTarget_Format_Default"	"{s:target}"
"DOTA_ChatTarget_Prompt_Default"	"Προς ({s:target}):"
"DOTA_ChatTarget_Format_Whisper"	"{s:persona}"
"DOTA_ChatTarget_Prompt_Whisper"	"Προς [{s:persona}]:"
"DOTA_ChatTarget_Party"	"Παρέα"
"DOTA_ChatTarget_Lobby"	"Λόμπι"
"DOTA_ChatTarget_Team"	"Ομάδα"
"DOTA_ChatTarget_Guild"	"Σύλλογος"
"DOTA_ChatTarget_Fantasy"	"Εικονικό"
"DOTA_ChatTarget_Console"	"Κονσόλα"
"DOTA_ChatTarget_Invalid"	"Χωρίς κανάλι"
"DOTA_ChatTarget_GameAll"	"Όλα"
"DOTA_ChatTarget_GameAllies"	"Σύμμαχοι"
"DOTA_ChatTarget_GameCoaching"	"Καθοδήγηση"
"DOTA_ChatTarget_GameSpectator"	"Θεατής"
"DOTA_ChatTargetMenu_Title"	"{s:target}"
"DOTA_ChatTargetMenu_ToggleEnabled"	"{s:toggle_enabled}"
"DOTA_ChatTargetMenu_NotActive"	"(Μη ενεργό)"
"DOTA_Chat_Placeholder"	"Πληκτρολογήστε εδώ για να μιλήσετε. Χρησιμοποιήστε το «/» για εντολές."
"DOTA_Chat_MissedMessages"	"{s:missed_message_count}"
"DOTA_ChatCommand_Party"	"p"
"DOTA_ChatCommand_Party_Name"	"Παρέα"
"DOTA_ChatCommand_Party_Description"	"Συνομιλία με την τρέχουσα παρέα σας."
"DOTA_ChatCommand_Lobby"	"l"
"DOTA_ChatCommand_Lobby_Name"	"Λόμπι"
"DOTA_ChatCommand_Channel"	"c"
"DOTA_ChatCommand_Channel_Name"	"Κανάλι"
"DOTA_ChatCommand_Channel_Description"	"Συνομιλία με ένα συγκεκριμένο κανάλι."
"DOTA_ChatCommand_Whisper"	"w"
"DOTA_ChatCommand_Reply"	"r"
"DOTA_ChatCommand_Reply_Name"	"Απάντηση"
"DOTA_ChatCommand_Help"	"?"
"DOTA_ChatCommand_Help_Name"	"Βοήθεια"
"DOTA_ChatCommand_Help_Description"	"Προβολή βοήθειας για τις εντολές συνομιλίας."
"DOTA_ChatCommand_InviteToParty"	"partyinvite"
"DOTA_ChatCommand_LeaveParty_Name"	"Έξοδος από παρέα"
"DOTA_ChatCommand_GameCoaching"	"καθοδηγητής"
"DOTA_ChatCommand_GameCoaching_Name"	"Καθοδήγηση"
"DOTA_ChatCommand_GameSpectator"	"θεατής"
"DOTA_ChatCommand_GameSpectator_Name"	"Θεατής"
"DOTA_ChatCommand_Clear"	"εκκαθάριση"
"DOTA_ChatCommand_Clear_Name"	"Εκκαθάριση"
"DOTA_Chat_UnknownCommandMessage"	"Άγνωστη εντολή «{s:chat_command}»"
"DOTA_ChatHelp_NameFormat"	"{s:command_name}:"
"DOTA_ChatHelp_CommandFormat"	"/{s:command}"
"DOTA_Chat_JoinedParty"	"Συνδεθήκατε σε παρέα: {s:party_members}"
"DOTA_Chat_InvitedToJoinParty"	"Προσκλήθηκαν: {s:party_members}"
"DOTA_Chat_PartyMemberSeparator"	", "
"DOTA_Feature_Under_Construction_Title"	"Υπό κατασκευή"
"DOTA_Invite_IOfN"	"{d:received_invite_index} από {d:received_invite_count}"
"DOTA_PartyInvite_Coach"	"Καθοδηγητής:"
"DOTA_PartyVisTooltip_TitleOpen"	"Αναζητεί μέλη παρέας"
"DOTA_PartyVisTooltip_TitleNotOpen"	"Δεν αναζητεί μέλη παρέας"
"DOTA_PartyVisTooltip_SoloNotOpen"	"Πατήστε για να αλλάξετε την κατάστασή σας."
"DOTA_PartySettings"	"Επιλογές παρέας"
"DOTA_LobbyInvite_Title"	"Πρόσκληση λόμπι"
"DOTA_LobbyKicked_Header"	"Διώξιμο από το λόμπι"
"DOTA_LobbyKicked_Message"	"Ο υπεύθυνος παιχνιδιού σας έδιωξε από το λόμπι."
"DOTA_PlayerContextMenu_ViewProfile"	"Προβολή προφίλ"
"DOTA_PlayerContextMenu_ChatWithPlayer"	"Αποστολή μηνύματος"
"DOTA_PlayerContextMenu_LeaveParty"	"Έξοδος από παρέα"
"DOTA_PlayerContextMenu_CoachParty"	"Καθοδήγηση παρέας"
"DOTA_PlayerContextMenu_StopCoachingParty"	"Διακοπή καθοδήγησης παρέας"
"DOTA_PlayerContextMenu_AddFriend"	"Προσθήκη φίλου"
"DOTA_PlayerContextMenu_RemoveFriend"	"Αφαίρεση φίλου"
"DOTA_PlayerContextMenu_AcceptFriendRequest"	"Αποδοχή αιτήματος φιλίας"
"DOTA_PlayerContextMenu_IgnoreFriendRequest"	"Αγνόηση αιτήματος φιλίας"
"DOTA_PlayerContextMenu_Spectate"	"Παρακολούθηση παιχνιδιού"
"DOTA_PlayerContextMenu_InviteToLobby"	"Πρόσκληση στο λόμπι"
"DOTA_PlayerContextMenu_SuggestInviteToLobby"	"Πρόταση πρόσκλησης σε λόμπι"
"DOTA_PlayerContextMenu_KickFromLobby"	"Διώξιμο από το λόμπι"
"DOTA_PlayerContextMenu_KickFromLobbyTeam"	"Διώξιμο από το ομαδικό λόμπι"
"DOTA_FeaturedHero_UnableToLoad"	"Αδυναμία φόρτωσης προαβαλλόμενων ηρώων."
"DOTA_FeaturedHero_ViewGrid"	"Προβολή πλέγματος"
"DOTA_FeaturedHero_HeroName"	"{s:hero_name}"
"DOTA_FeaturedHero_ItemName"	"{g:dota_item_name:item_def}"
"DOTA_FeaturedHeroReason_NewItem"	"Νέο {s:item_rarity}"
"DOTA_FeaturedHeroReason_FrequentlyPlayedHero"	"Επειδή παίξατε"
"DOTA_FeaturedHeroReason_FeaturedItem"	"Προβαλλόμενο αντικείμενο"
"DOTA_FeaturedHeroReason_PopularItem"	"Κορυφαίος πωλητής"
"DOTA_FeaturedHeroReason_SaleItem"	"Σε προσφορά"
"DOTA_NewFeaturedHero_WinterWyvern"	"Με έναν ψυχρό αέρα, το Eldwurm έρχεται."
"DOTA_HeroSelectorCategory_Default"	"Όλοι οι ήρωες"
"DOTA_HeroSelectorCategory_NewItems"	"Νέα αντικείμενα"
"DOTA_HeroSelectorCategory_Favorites"	"Αγαπημένα"
"DOTA_HeroSelectorCategory_HaveItems"	"Έχω αντικείμενα για"
"DOTA_HeroSelectorCategory_PrimaryAttribute_Strength"	"Δύναμη"
"DOTA_HeroSelectorCategory_PrimaryAttribute_Agility"	"Σβελτάδα"
"DOTA_HeroSelectorCategory_PrimaryAttribute_Intelligence"	"Ευφυΐα"
"DOTA_HeroSelectorCategory_AttackRange_Melee"	"Εξ επαφής"
"DOTA_HeroSelector_SelectHero_Label"	"Επιλογή"
"DOTA_HeroSelector_ClearFilters"	"Εκκαθάριση φίλτρων"
"DOTA_OwnedItemSet_Selector_Title"	"Στην κατοχή"
"DOTA_EquippedItemSet_Selector_Title"	"Εξοπλισμένο"
"DOTA_OwnedItemSet_Available_Title"	"Διαθέσιμο"
"DOTA_FeaturedItemSet_Selector_Title"	"Προβαλλόμενο"
"DOTA_AllItemSet_Selector_Title"	"Όλα"
"DOTA_ConfirmLANLobby_title"	"ΤΟΠΙΚΟ ΠΑΙΧΝΙΔΙ"
"DOTA_ConfirmLANLobby_desc"	"Ένα τοπικό παιχνίδι διεξάγεται στον υπολογιστή σας. Οι απαιτήσεις συστήματος είναι υψηλότερες για τη διεξαγωγή τοπικών παιχνιδιών."
"DOTA_ConfirmLANLobbyDisconnect_title"	"Έξοδος από το τοπικό λόμπι;"
"DOTA_ConfirmLANLobbyDisconnect_ok"	"Ναι, αποσύνδεση"
"DOTA_Lobby_Settings_General"	"ΓΕΝΙΚΕΣ ΡΥΘΜΙΣΕΙΣ ΛΟΜΠΙ"
"DOTA_Lobby_Settings_Required"	"ΑΠΑΙΤΕΙΤΑΙ"
"DOTA_Lobby_Settings_Confirm"	"{s:lobby_confirm_label}"
"DOTA_Lobby_Settings_Game_Mode"	"ΤΥΠΟΣ ΠΑΙΧΝΙΔΙΟΥ"
"DOTA_Lobby_Settings_Region"	"ΤΟΠΟΘΕΣΙΑ ΔΙΑΚΟΜΙΣΤΗ"
"DOTA_Lobby_Settings_Password"	"ΚΩΔΙΚΟΣ ΛΟΜΠΙ"
"DOTA_Lobby_Settings_Game_Name"	"ΟΝΟΜΑ ΠΑΙΧΝΙΔΙΟΥ"
"DOTA_Lobby_Settings_Advanced"	"ΠΡΟΧΩΡΗΜΕΝΕΣ ΡΥΘΜΙΣΕΙΣ ΛΟΜΠΙ"
"DOTA_Lobby_Settings_Competitive"	"COMPETITIVE"
"DOTA_Lobby_Settings_Starting_Team_Random"	"ΤΥΧΑΙΑ"
"DOTA_Lobby_Settings_Starting_Team_Radiant"	"RADIANT"
"DOTA_Lobby_Settings_Starting_Team_Dire"	"DIRE"
"DOTA_Lobby_Settings_Penalty_Radiant"	"ΠΟΙΝΗ - RADIANT"
"DOTA_Lobby_Settings_Penalty_Dire"	"ΠΟΙΝΗ - DIRE"
"DOTA_Lobby_Settings_Penalty_Level_0"	"ΧΩΡΙΣ ΠΟΙΝΗ"
"DOTA_Lobby_Settings_Series_Type"	"ΟΡΙΟ ΝΙΚΩΝ"
"DOTA_Lobby_Settings_No_Series"	"ΧΩΡΙΣ ΟΡΙΟ"
"DOTA_Lobby_Settings_Series_Best_of_3"	"2 ΝΙΚΕΣ"
"DOTA_Lobby_Settings_Series_Best_of_5"	"3 ΝΙΚΕΣ"
"DOTA_Lobby_Settings_Gameplay_Rules"	"ΚΑΝΟΝΕΣ ΠΑΙΧΝΙΔΙΟΥ"
"DOTA_Lobby_Settings_Enable_Cheats"	"ΚΩΔΙΚΟΙ ΕΝΕΡΓΟΙ"
"DOTA_Lobby_Settings_Fill_Bots"	"ΓΕΜΙΣΜΑ ΚΕΝΩΝ ΘΕΣΕΩΝ ΜΕ BOT"
"DOTA_Lobby_Settings_Bot_Difficulty"	"ΔΥΣΚΟΛΙΑ BOT"
"DOTA_Lobby_Settings_Bot_Difficulty_Passive"	"ΕΛΑΧΙΣΤΗ"
"DOTA_Lobby_Settings_Bot_Difficulty_Easy"	"ΧΑΜΗΛΗ"
"DOTA_Lobby_Settings_Bot_Difficulty_Medium"	"ΜΕΣΑΙΑ"
"DOTA_Lobby_Settings_Bot_Difficulty_Hard"	"ΥΨΗΛΗ"
"DOTA_Lobby_Settings_Bot_Difficulty_Unfair"	"ΜΕΓΙΣΤΗ"
"DOTA_Lobby_Settings_Version"	"ΕΚΔΟΣΗ"
"DOTA_Lobby_Settings_Version_Latest"	"ΝΕΟΤΕΡΗ"
"DOTA_Lobby_Settings_Version_Tournament"	"ΔΙΟΡΓΑΝΩΣΗΣ"
"DOTA_Lobby_Settings_Spectator_Section"	"ΘΕΑΤΗΣ"
"DOTA_Lobby_Settings_Dota_TV_Delay"	"ΚΑΘΥΣΤΕΡΗΣΗ DOTA TV"
"DOTA_Lobby_Settings_Dota_TV_Delay_2_Minutes"	"2 ΛΕΠΤΑ"
"DOTA_Lobby_Settings_Dota_TV_Delay_5_Minutes"	"5 ΛΕΠΤΑ"
"DOTA_Lobby_Settings_Dota_TV_Delay_10_Seconds"	"10 ΔΕΥΤΕΡΟΛΕΠΤΑ"
"DOTA_Lobby_Settings_Spectators"	"ΘΕΑΤΕΣ"
"DOTA_Lobby_Settings_Spectators_Enabled"	"ΕΝΕΡΓΟΙ"
"DOTA_Lobby_Settings_Spectators_Disabled"	"ΑΝΕΝΕΡΓΟΙ"
"dota_lobby_settings_hide_password"	"Απόκρυψη κωδικού"
"dota_lobby_settings_local_host"	"Τοπικός εξυπηρετητής"
"DOTA_Lobby_Settings_Visibility"	"ΟΡΑΤΟΤΗΤΑ ΛΟΜΠΙ"
"DOTA_Lobby_Settings_Visibility_Public"	"ΔΗΜΟΣΙΑ"
"DOTA_Lobby_Settings_Visibility_Friends"	"ΦΙΛΟΙ"
"DOTA_Lobby_Settings_Visibility_Unlisted"	"ΑΠΟΡΡΗΤΟ"
"DOTA_Lobby_Settings_Visibility_Tooltip"	"Ελέγχει το πού θα είναι ορατό το λόμπι. Τα δημόσια λόμπι είναι ορατά στον περιηγητή λόμπι και στη λίστα φίλων. Τα λόμπι φίλων είναι μόνο ορατά σε φίλους, ωστόσο μπορούν να προσκληθούν και άλλοι παίκτες. Τα ακαταχώριστα λόμπι δεν είναι ορατά στον περιηγητή ή στη λίστα φίλων."
"DOTA_TeamUnsetHeader"	"Μη επιλεγμένη ομάδα"
"DOTA_TeamUnsetMessage"	"Κάποια ομάδα δεν έχει ορίσει όνομα/εικόνα. Να ξεκινήσει το παιχνίδι;"
"DOTA_LeagueUnsetHeader"	"Μη επιλεγμένο πρωτάθλημα"
"DOTA_LeagueUnsetMessage"	"Κανένα πρωτάθλημα δεν έχει οριστεί για αυτό το λόμπι, αλλά μπορείτε να ορίσετε ένα. Θέλετε σίγουρα να εκκινήσετε τον αγώνα;"
"DOTA_LobbyAllowSpectatingHeader"	"Αδυναμία εκκίνησης λόμπι παιχνιδιού"
"dota_radiant"	"Οι Radiant"
"dota_dire"	"Οι Dire"
"dota_lobby_team_name_radiant"	"{s:team_name_good_guys}"
"dota_lobby_team_name_dire"	"{s:team_name_bad_guys}"
"dota_lobby_no_team"	"Καμία ομάδα"
"dota_lobby_broadcast_default_channel_name"	"Όνομα καναλιού"
"dota_lobby_broadcast_join"	"Σύνδεση"
"dota_lobby_broadcast_leave"	"Αποχώρηση"
"dota_lobby_broadcast_create"	"Δημιουργία νέου καναλιού"
"dota_lobby_broadcast_no_channels"	"Δεν έχουν δημιουργηθεί κανάλια μετάδοσης"
"dota_popup_broadcast_channel_edit_title"	"Προσαρμογή καναλιού μετάδοσης"
"dota_lobby_broadcast_default_channel_name_custom"	"{s:custom_title}"
"dota_popup_broadcast_channel_edit_channel_name"	"Τίτλος καναλιού"
"dota_popup_broadcast_channel_edit_country"	"Χώρα"
"dota_popup_broadcast_channel_edit_language"	"Γλώσσα"
"dota_popup_broadcast_channel_edit_save"	"Αποθήκευση ως προεπιλογές και εφαρμογή στα άδεια κανάλια κατά τη σύνδεση"
"DOTA_Lobby_Broadcaster_Channel_Other_Language"	"Άλλη γλώσσα"
"lobby_slot_error_header"	"Αποτυχία αλλαγής θέσης"
"generic_gc_timeout"	"Λήξη χρόνου μηνύματος."
"lobby_slot_success_header"	"Επιτυχία"
"lobby_slot_denied"	"Δεν έχετε άδεια να συνδεθείτε σε αυτή τη θέση."
"lobby_slot_cameramanalready"	"Τα κανάλια εκφωνητή μπορούν να έχουν μόνο έναν εικονολήπτη"
"lobby_slot_cameramanon"	"Έχετε επισημανθεί ως εικονολήπτης"
"lobby_slot_cameramanoff"	"Δεν είστε πια εικονολήπτης"
"lobby_slot_error"	"Αποτυχία αλλαγής θέσης παιχνιδιού."
"lobby_create_timeout"	"Αποτυχία δημιουργίας λόμπι."
"DOTA_DialogVariableTest1"	"Απλό: {s:var}"
"DOTA_DialogVariableTest2"	"Τιμή χρημάτων: {m:money}"
"DOTA_DialogVariableTest3"	"Σύνδεσμος αντικειμένου: {g:dota_item_link:item_def}"
"DOTA_DialogVariableTest4"	"Τιμή αντικειμένου: {g:dota_item_price:item_def}"
"LobbySetting_GameMode"	"ΤΥΠΟΣ"
"LobbySetting_GameMode_Value"	"{s:lobbysetting_gamemode}"
"LobbySetting_Bots"	"ΒΟΤ"
"LobbySetting_Bots_Value"	"{s:lobbysetting_bots}"
"LobbySetting_Password"	"ΚΩΔΙΚΟΣ"
"LobbySetting_Password_Value"	"{s:lobbysetting_password}"
"LobbySetting_Server"	"ΔΙΑΚΟΜΙΣΤΗΣ"
"LobbySetting_Server_Value"	"{s:lobbysetting_server}"
"LobbySetting_Cheats"	"ΚΩΔΙΚΟΙ"
"LobbySetting_Cheats_Value"	"{s:lobbysetting_cheats}"
"LobbySetting_Spectators"	"ΘΕΑΤΕΣ"
"LobbySetting_Spectators_Value"	"{s:lobbysetting_spectators}"
"LobbySetting_Visibility"	"ΟΡΑΤΟΤΗΤΑ"
"LobbySetting_Visibility_Value"	"{s:lobbysetting_visibility}"
"dota_lobby_lan_title"	"ΤΟΠΙΚΟ ΠΑΙΧΝΙΔΙ"
"dota_lobby_coaches_none"	"Καθοδηγητές: Κανένας"
"dota_lobby_coaches"	"Καθοδηγητές:"
"DOTA_Custom_Game"	"Προσαρμοσμένο παιχνίδι"
"DOTA_Custom_Game_Info"	"Πληροφορίες"
"DOTA_Custom_Game_View_Details"	"Προβολή λεπτομερειών παιχνιδιού"
"DOTA_Custom_Game_Author"	"από {g:dota_persona:author}"
"DOTA_Custom_Game_Lobby_Count"	"{d:lobby_count} λόμπι"
"DOTA_Custom_Game_Lobby_Count_Plural"	"{d:lobby_count} λόμπι"
"DOTA_Custom_Game_Friend_Lobbies_Alert"	"Έχετε {d:friend_count} φίλο με ανοιχτό λόμπι παιχνιδιού."
"DOTA_Custom_Game_Friend_Lobbies_Alert_Plural"	"Έχετε {d:friend_count} φίλους με ανοιχτά λόμπι παιχνιδιών."
"DOTA_Custom_Game_Quick_Join"	"Γρήγορη σύνδεση"
"DOTA_Custom_Game_View_Lobbies"	"Προβολή λόμπι"
"DOTA_Custom_Game_Find_Lobby"	"Εύρεση λόμπι"
"DOTA_Custom_Game_Create_Lobby"	"Δημιουργία λόμπι"
"DOTA_Custom_Game_Game_Page"	"Σελίδα παιχνιδιού"
"DOTA_Custom_Game_Workshop_Page"	"Σελίδα Εργαστηρίου"
"DOTA_Custom_Game_Download_Queued"	"Λήψη σε αναμονή"
"DOTA_Custom_Game_Downloading"	"Λήψη..."
"DOTA_Custom_Game_Downloading_Percent"	"Λήψη - {d:lobby_download_percent}%"
"DOTA_Custom_Game_Needs_Update"	"Χρειάζεται ενημέρωση"
"DOTA_Custom_Game_Play"	"Εκκίνηση {s:game_mode_name}"
"DOTA_Custom_Game_Uninstall"	"Απεγκατάσταση"
"DOTA_Custom_Game_Install"	"Εγκατάσταση"
"DOTA_Custom_Game_Installed"	"Εγκαταστάθηκε"
"DOTA_Custom_Game_Not_Installed"	"Δεν εγκαταστάθηκε"
"DOTA_Custom_Game_Connect"	"Σύνδεση σε λόμπι"
"DOTA_Custom_Game_FileSize"	"{d:file_size} MB"
"DOTA_Custom_Game_Name"	"{s:game_mode_name}"
"DOTA_Custom_Game_Released_By"	"Κυκλοφόρησε {s:release_date}</b> Από <b>{g:dota_persona:author}</b>"
"DOTA_Custom_Game_Subscription"	"{s:subscriptions_count} Συνδρομή"
"DOTA_Custom_Game_Subscriptions"	"{s:subscriptions_count} Συνδρομές"
"DOTA_Custom_Game_Rating"	"Βαθμολογία"
"DOTA_Custom_Game_Release_Date"	"Κυκλοφόρησε"
"DOTA_Custom_Game_Playing_Now"	"{s:player_count} Σε παιχνίδι"
"DOTA_Custom_Game_Ratings_Count"	"({d:ratings_count})"
"DOTA_Custom_Game_Description"	"{s:game_description}"
"DOTA_Custom_Game_Last_Updated"	"Τελευταία ενημέρωση: {s:last_updated_date}"
"DOTA_Custom_Game_Update_Note_Title"	"{s:timestamp}"
"DOTA_Custom_Game_Screenshots"	"Φωτογραφίες"
"DOTA_Custom_Game_Map_Label"	"Χάρτης"
"DOTA_Custom_Game_Map_Any"	"Οποιοσδήποτε"
"DOTA_Custom_Game_Update"	"Ενημέρωση"
"DOTA_Custom_Game_Spectate"	"Παρακολούθηση"
"DOTA_Custom_Game_Already_In_Lobby"	"Ολοκληρώστε το τρέχον παιχνίδι σας για να ξεκινήσετε αυτή τη λειτουργία παιχνιδιού."
"DOTA_Custom_Game_Friends_Playing"	"Φίλοι σε προσαρμοσμένα παιχνίδια"
"DOTA_Custom_Game_Friends_In_Lobbies"	"{d:friends_in_open_lobbies} σε ανοικτά λόμπι"
"DOTA_Custom_Game_Invite_Friend"	"Πρόσκληση φίλου"
"DOTA_Custom_Game_Tooltip_Subscribers"	"{d:subscriber_count} συνδρομές"
"DOTA_Custom_Game_Tooltip_Subscriber"	"{d:subscriber_count} συνδρομή"
"DOTA_Custom_Game_Most_Popular"	"Πιο δημοφιλή"
"DOTA_Custom_Game_Installed_Games"	"Εγκατεστημένα παιχνίδια"
"DOTA_Custom_Game_Favorite_Games"	"Εμφάνιση μόνο αγαπημένων"
"DOTA_Custom_Game_Add_Favorite"	"ΑΓΑΠΗΜΕΝΟ"
"DOTA_Custom_Game_VotePrompt"	"Να βοηθήσουμε περισσότερα άτομα να μάθουν για αυτό το παιχνίδι;"
"DOTA_Custom_Game_DetailsPrompt"	"Επισκεφθείτε τη σελίδα λεπτομερειών του παιχνιδιού για να μάθετε περισσότερα, να το εγκαταστήσετε, και να παίξετε."
"DOTA_Custom_Game_Vote_Box_Title"	"Ψήφος εργαστηρίου"
"DOTA_Custom_Game_Vote_PrevLabel"	"Προηγ παιχνίδι"
"DOTA_Custom_Game_Vote_NextLabel"	"Επόμενο παιχνίδι"
"DOTA_Custom_Game_Vote_ControlsLabel"	"Ψήφος εργαστηρίου"
"DOTA_Custom_Game_Vote_YesLabel"	"Ναι, προωθήστε το!"
"DOTA_Custom_Game_Vote_NoLabel"	"Όχι, χρειάζεται δουλειά."
"DOTA_Custom_Game_Vote_SkipLabel"	"Παράλειψη παιχνιδιού, δεν έχω κάτι."
"DOTA_Custom_Game_Vote_Up"	"Καλό παιχνίδι"
"DOTA_Custom_Game_Vote_Down"	"Χρειάζεται δουλειά"
"Video_Support_Coming_Soon"	"Προσεχώς υποστήριξη βίντεο"
"DOTA_Custom_Game_Leave_Lobby"	"Αποχώρηση από το λόμπι"
"DOTA_Custom_Game_Suggested_Title"	"Προτεινόμενα παιχνίδια"
"DOTA_Custom_Game_Search"	"Αναζήτηση προσαρμοσμένων παιχνιδιών"
"DOTA_Custom_Lobby_Create_Button"	"ΔΗΜΙΟΥΡΓΙΑ ΛΟΜΠΙ"
"DOTA_Custom_Lobby_Settings_Title"	"ΔΗΜΙΟΥΡΓΙΑ ΛΟΜΠΙ"
"DOTA_Custom_Lobby_Settings_Mode"	"ΤΥΠΟΣ ΠΑΙΧΝΙΔΙΟΥ"
"DOTA_Custom_Lobby_Settings_Map"	"Χάρτης"
"DOTA_Custom_Lobby_LobbyName"	"Προαιρετική περιγραφή"
"DOTA_Custom_Lobby_List_Desc"	"Μια λίστα ιδιωτικών λόμπι (προστατευμένα με κωδικό) και αφιλτράριστων ενεργών προσαρμοσμένων παιχνιδιών"
"DOTA_Custom_Lobby_Public"	"Δημόσιο"
"DOTA_Custom_Lobby_Passworded"	"Οι παίκτες μπορούν να συνδεθούν στο λόμπι μόνο μέσω προσκλήσεων ή φιλτράροντας τη λίστα λόμπι βάσει κωδικού."
"DOTA_Custom_Lobby_Join_Failed_Title"	"Αποτυχία σύνδεσης"
"DOTA_Custom_Lobby_Join_Failed_Reason"	"{s:join_error}"
"DOTA_Custom_Lobby_Create_Private_Button"	"Δημιουργία ιδιωτικού λόμπι"
"DOTA_Custom_Lobby_Find_Private_Button"	"Εύρεση ιδιωτικού λόμπι"
"DOTA_Custom_Lobby_Find_Private_Title"	"Εύρεση ιδιωτικού λόμπι"
"DOTA_Custom_Lobby_Find_Private_Desc"	"Εισάγετε έναν κωδικό για να βρείτε ένα ιδιωτικό λόμπι:"
"DOTA_Custom_Lobby_List_Game_Header"	"ΠΑΙΧΝΙΔΙ"
"DOTA_Custom_Lobby_List_Name_Header"	"ΠΕΡΙΓΡΑΦΗ"
"DOTA_Custom_Lobby_List_Players_Header"	"ΠΑΙΚΤΕΣ"
"DOTA_Custom_Lobby_List_Map_Header"	"ΧΑΡΤΗΣ"
"DOTA_Custom_Lobby_List_Region_Header"	"ΠΕΡΙΟΧΗ"
"DOTA_Custom_Lobby_List_Connection_Header"	"ΣΥΝΔΕΣΗ"
"DOTA_Custom_Lobby_List_Status_Header"	"ΤΟΠΙΚΗ ΚΑΤΑΣΤΑΣΗ"
"DOTA_Custom_Lobby_List_Game"	"{s:lobby_game}"
"DOTA_Custom_Lobby_List_Lobby_Name"	"{s:lobby_name}"
"DOTA_Custom_Lobby_List_Players"	"{s:lobby_players} / {s:lobby_max_players}"
"DOTA_Custom_Lobby_List_Map"	"{s:lobby_map}"
"DOTA_Custom_Lobby_List_Region"	"{s:lobby_region}"
"DOTA_Custom_Lobby_List_Connection"	"..."
"DOTA_Custom_Lobby_List_Status"	"{s:lobby_status}"
"DOTA_Custom_Lobby_List_Connect"	"{s:connect_button_text}"
"DOTA_Custom_Lobby_Game_Name"	"{s:game_name}"
"DOTA_Custom_Lobby_Map_Name"	"ΧΑΡΤΗΣ: {s:map_name}"
"DOTA_Custom_Lobby_Player_Count"	"ΠΑΙΚΤΕΣ: {d:player_count} / {d:max_player_count}"
"DOTA_Custom_Lobby_Player_Count_Short"	"{d:player_count} / {d:max_player_count}"
"DOTA_Custom_Lobby_Visibility"	"ΟΡΑΤΟΤΗΤΑ ΛΟΜΠΙ"
"DOTA_Custom_Join_Chat"	"Σύνδεση σε συνομιλία"
"DOTA_Custom_Join_Chat_Member_Count"	"({d:ChatMemberCount})"
"DOTA_Custom_Leave_Chat"	"Αποχώρηση από συνομιλία"
"DOTA_Page_Number"	"Σελίδα: {d:current_page} / {d:num_pages}"
"DOTA_TabName_ModsOverview"	"Επισκόπηση"
"DOTA_TabName_ModsSubscribed"	"Συλλογή"
"DOTA_TabName_ModsWorkshop"	"Εργαστήρι"
"DOTA_TabName_ModsBrowse"	"Περιήγηση"
"DOTA_WatchTabName_Featured"	"Προβαλλόμενα"
"DOTA_WatchTabName_Replays"	"Επαναλήψεις"
"DOTA_WatchTabName_Tournaments"	"Διοργανώσεις"
"DOTA_WatchTabName_Downloads"	"Λήψεις"
"DOTA_WatchLive_DataError"	"Σφάλμα φόρτωσης παιχνιδιών ζωντανά"
"DOTA_WatchLive_Connecting"	"Αναμονή για δεδομένα παιχνιδιού..."
"DOTA_WatchLive_HeroFilter"	"Φίλτρο: {s:hero_filter_name}"
"DOTA_WatchLive_CountSpec"	"{i:num_spectating} θεατές"
"DOTA_WatchLive_CountSpecFriend"	"{i:num_friends_spectating} φίλος και {i:num_spectating} θεατές"
"DOTA_WatchLive_CountSpecFriends"	"{i:num_friends_spectating} φίλοι και {i:num_spectating} θεατές"
"DOTA_WatchLive_CountFriends"	"{i:num_friends_playing} φίλοι σε παιχνίδι"
"DOTA_WatchLive_ParticipantsVs"	"{s:team_1} εναντίον {s:team_2}"
"DOTA_WatchLive_ParticipantsMMR"	"{i:mmr} μέσο MMR"
"DOTA_WatchLive_Participants1"	"{s:friend_1}"
"DOTA_WatchLive_Participants2"	"{s:friend_1} και {s:friend_2}"
"DOTA_WatchLive_Participants3"	"{s:friend_1}, {s:friend_2}, και {s:friend_3}"
"DOTA_WatchLive_Participants4Plus"	"{s:friend_1}, {s:friend_2}, {s:friend_3}, και {i:friend_count_over_3} περισσότεροι..."
"DOTA_WatchLive_MatchType_MM_Kills"	"{s:game_mode}"
"DOTA_WatchLive_MatchType_MM"	"{s:game_mode}"
"DOTA_WatchLiveDotaTV"	"Παρακολούθηση στο DotaTV"
"DOTA_WatchLiveSpectatorCount"	"{i:spectator_count} θεατές"
"DOTA_WatchReplays_TournamentsHeader"	"ΔΗΜΟΦΙΛΕΙΣ ΑΓΩΝΕΣ ΤΟΥΡΝΟΥΑ"
"DOTA_WatchReplays_FriendsHeader"	"ΑΓΩΝΕΣ ΦΙΛΩΝ"
"DOTA_WatchReplays_Popular"	"ΔΗΜΟΦΙΛΕΙΣ ΑΓΩΝΕΣ"
"DOTA_WatchReplays_ParticipantsVs"	"{s:team_1} εναντίον {s:team_2}"
"DOTA_WatchReplays_MatchType_League"	"{s:league_name}"
"DOTA_WatchReplays_MatchType_Public"	"Αγώνας {s:match_id} - {s:game_mode}"
"DOTA_WatchReplays_Recommendations"	"{i:recommendations}"
"DOTA_WatchReplays_Recommendations1"	"{g:dota_persona:friend_1} + {i:recommendations}"
"DOTA_WatchReplays_Recommendations2"	"{g:dota_persona:friend_1}, {g:dota_persona:friend_2} + {i:recommendations}"
"DOTA_WatchReplays_Recommendations3Plus"	"{g:dota_persona:friend_1} + {i:friend_count_over_1} περισσότεροι φίλοι + {i:recommendations}"
"DOTA_WatchReplays_Friends1"	"Ο {g:dota_persona:b:friend_1} έπαιξε"
"DOTA_WatchReplays_Friends2"	"Οι {g:dota_persona:b:friend_1} και {g:dota_persona:friend_2} έπαιξαν"
"DOTA_WatchReplays_Friends3Plus"	"{g:dota_persona:b:friend_1}, {g:dota_persona:b:friend_2} και {i:friend_count_over_2} περισσότεροι φίλοι"
"DOTA_WatchReplays_Views"	"{i:views} προβολές"
"DOTA_WatchReplays_Price"	"{g:dota_item_price:ticket_itemdef}"
"DOTA_WatchReplays_Duration"	"{s:minutes}:{s:seconds}"
"DOTA_WatchReplays_Tag"	"«{s:recommendation_text}»"
"DOTA_WatchTournaments_FeaturedTitle"	"{s:tournament_featured_title}"
"DOTA_WatchTournaments_FeaturedDates"	"{s:tournament_featured_start} - {s:tournament_featured_end}"
"DOTA_WatchTournaments_FeaturedDescription"	"{s:tournament_featured_description}"
"DOTA_WatchTournaments_FeaturedTeams"	"Ομάδες"
"DOTA_WatchTournaments_PrizePoolAmt"	"{s:tournament_featured_prize_pool}"
"DOTA_WatchTournaments_Purchase"	"Πάσο διοργάνωσης - {s:tournament_featured_price}"
"DOTA_WatchTournament_TournamentName"	"{s:tournament_name}"
"DOTA_WatchTournament_Price"	"{s:price}"
"DOTA_Replays_Search"	"Αναζήτηση MatchID"
"DOTA_Watch_Pending"	"Αναμονή παρακολούθησης παιχνιδιού..."
"DOTA_Watch_GameServerNotFound"	"Δε βρέθηκε ο διακομιστής που διοργανώνει αυτό το παιχνίδι."
"DOTA_Watch_Unavailable"	"Αδυναμία παρακολούθησης αυτού του παιχνιδιού τώρα."
"DOTA_Watch_LobbyNotFound"	"Αποτυχία εύρεσης παιχνιδιού."
"DOTA_Watch_MissingLeagueSubscription"	"Αυτό το παιχνίδι είναι παιχνίδι πρωταθλήματος το οποίο απαιτεί συνδρομή για παρακολούθηση."
"vs"	"VS"
"dota_matchmaking_language_title"	"ΕΠΙΛΟΓΗ ΓΛΩΣΣΑΣ MATCHMAKING"
"dota_matchmaking_language_primary_label"	"Η κύρια γλώσσα matchmaking σας είναι:"
"dota_matchmaking_language_primary"	"{s:environment_language}"
"dota_matchmaking_language_primary_invalid"	"Η γλώσσα σας, τα {s:environment_language}, δεν είναι διαθέσιμη ως γλώσσα matchmaking στο Dota 2."
"dota_matchmaking_language_select_secondary"	"Αν επιθυμείτε, μπορείτε να επιλέξετε μια δευτερεύουσα γλώσσα:"
"dota_matchmaking_language_select_primary"	"Παρακαλούμε επιλέξτε μια γλώσσα παιχνιδιού:"
"dota_matchmaking_language_no_selection"	"Χωρίς επιλογή"
"dota_matchmaking_language_english"	"Αγγλικά"
"dota_matchmaking_language_russian"	"Ρώσικα"
"dota_matchmaking_language_chinese"	"Κινέζικα"
"dota_matchmaking_language_schinese"	"Κινέζικα"
"dota_matchmaking_language_korean"	"Κορεάτικα"
"dota_matchmaking_language_koreana"	"Κορεάτικα"
"dota_matchmaking_language_spanish"	"Ισπανικά"
"dota_matchmaking_language_portuguese"	"Πορτογαλικά"
"GameUI_Language_English"	"Αγγλικά"
"GameUI_Language_German"	"Γερμανικά"
"GameUI_Language_French"	"Γαλλικά"
"GameUI_Language_Italian"	"Ιταλικά"
"GameUI_Language_Korean"	"Κορεάτικα"
"GameUI_Language_Spanish"	"Ισπανικά"
"GameUI_Language_Simplified_Chinese"	"Απλοποιημένα Κινέζικα"
"GameUI_Language_Traditional_Chinese"	"Παραδοσιακά Κινέζικα"
"GameUI_Language_Russian"	"Ρώσικα"
"GameUI_Language_Thai"	"Ταϊλανδέζικα"
"GameUI_Language_Japanese"	"Ιαπωνικά"
"GameUI_Language_Portuguese"	"Πορτογαλικά"
"GameUI_Language_Polish"	"Πολωνικά"
"GameUI_Language_Danish"	"Δανικά"
"GameUI_Language_Dutch"	"Ολλανδικά"
"GameUI_Language_Finnish"	"Φινλανδικά"
"GameUI_Language_Norwegian"	"Νορβηγικά"
"GameUI_Language_Swedish"	"Σουηδικά"
"GameUI_Language_Hungarian"	"Ουγγρικά"
"GameUI_Language_Czech"	"Τσέχικα"
"GameUI_Language_Romanian"	"Ρουμανικά"
"GameUI_Language_Turkish"	"Τούρκικα"
"GameUI_Language_Brazilian"	"Πορτογαλικά-Βραζιλία"
"GameUI_Language_Bulgarian"	"Βουλγάρικα"
"GameUI_Language_Greek"	"Ελληνικά"
"GameUI_Language_Ukrainian"	"Ουκρανικά"
"client_version_out_of_date_title"	"Απαιτείται ενημέρωση"
"client_version_out_of_date"	"Το παιχνίδι δεν είναι ενημερωμένο. Τερματίστε και εκκινήστε ξανά το Dota 2 για να αποκτήσετε την τελευταία έκδοση."
"dota_matchmaking_region_title"	"ΕΠΙΛΟΓΗ ΠΕΡΙΟΧΩΝ ΠΑΙΧΝΙΔΙΟΥ"
"dota_matchmaking_region_auto"	"Αυτόματη επιλογή της καλύτερης περιοχής με βάση την τοποθεσία μου."
"dota_matchmaking_region_select"	"Επιλέξτε μέχρι και τρεις περιοχές matchmaking. Επιλέξτε μόνο τις περιοχές που είναι πιο κοντά σε εσάς για την καλύτερη εμπειρία."
"limited_heroes_abandon_header"	"Limited Heroes"
"limited_heroes_abandon_explanation"	"Δεν υπάρχει ποινή για αποχώρηση από παιχνίδι Limited Heroes, επειδή ο ήρωάς σας αντικαθίσταται με ένα bot. Η αποχώρηση από άλλο τύπο παιχνιδιού μπορεί να έχει ως αποτέλεσμα την τοποθέτησή σας σε χαμηλή προτεραιότητα."
"dota_abandon_dialog_title"	"ΕΓΚΑΤΑΛΕΙΨΗ"
"dota_abandon_dialog_confirm"	"Θέλετε σίγουρα να εγκαταλείψετε το παιχνίδι;"
"dota_abandon_dialog_yes"	"Ναι, εγκατάλειψη."
"dota_leave_dialog_title"	"ΑΠΟΧΩΡΗΣΗ"
"dota_leave_dialog_confirm"	"Θέλετε σίγουρα να αποχωρήσετε από το παιχνίδι;"
"dota_leave_dialog_yes"	"Ναι, αποχώρηση."
"dota_accept_match_title"	"Το παιχνίδι σας είναι έτοιμο"
"dota_accept_match_readyup_title"	"Αναμονή για παίκτες"
"dota_accept_match_accept"	"Αποδοχή"
"dota_accept_match_accept_low_pri"	"Αποδοχή αγώνα χαμηλής προτεραιότητας"
"dota_accept_match_accept_button"	"{s:accept}"
"dota_accept_match_decline"	"Απόρριψη"
"dota_accept_match_subtitle"	"{s:subtitle}"
"dota_finding_match_players"	"( {s:searching_player_count} σε αναζήτηση )"
"dota_finding_match_generic"	"Κανονικός αγώνας"
"dota_finding_match_ranked"	"Αγώνας κατάταξης"
"dota_finding_match_bot"	"Αγώνας Bot"
"dota_finding_match_team"	"Ομαδικός αγώνας κατάταξης"
"dota_finding_1v1_match_casual"	"Αγώνας 1v1"
"dota_finding_match_practice_lobby"	"Λόμπι παιχνιδιού"
"dota_safe_to_abandon_inline"	"Το παιχνίδι είναι ασφαλές για αποχώρηση"
"dota_match_connected"	"Σε παιχνίδι"
"dota_match_local_game"	"Σε τοπικό παιχνίδι"
"dota_match_connecting"	"Σύνδεση στο παιχνίδι..."
"dota_match_in_progress"	"Παιχνίδι σε εξέλιξη"
"dota_match_finished"	"Το παιχνίδι ολοκληρώθηκε"
"matchmaking_waiting_for_players"	"Αναμονή για υπόλοιπους παίκτες"
"matchmaking_player_declined"	"Ένας παίκτης απέρριψε το παιχνίδι"
"dota_match_wait_for_host"	"Αναμονή για εξυπηρετητή"
"dota_match_find_server"	"Εύρεση διακομιστή"
"ranked_mmr_solo_label"	"Solo"
"ranked_mmr_solo_value"	"{i:solo_mmr}"
"ranked_mmr_solo_no_data"	"Απαιτούνται {i:solo_calibrating_required_games} παιχνίδια για υπολογισμό"
"ranked_mmr_party_label"	"Παρέα"
"ranked_mmr_party_value"	"{i:party_mmr}"
"matchmaking_account_disabled"	"Λόγω υπερβολικά απρεπούς συμπεριφοράς δεν είστε σε θέση να συνομιλείτε ή να προσχωρείτε σε Matchmaking για %s1"
"matchmaking_match_disabled_party"	"Ο %s1 αποκλείστηκε από το matchmaking για %s2 επειδή δεν ήταν έτοιμος ή επειδή εγκατέλειψε το προηγούμενο παιχνίδι του."
"matchmaking_low_priority_party"	"Ο %s1 επιτρέπει μόνο εύρεση παιχνιδιού χαμηλής προτεραιότητας για %s2 εξαιτίας αποχωρήσεων από παιχνίδια ή λήψης υπερβολικών αναφορών."
"matchmaking_match_disabled_local"	"Αποκλειστήκατε από το matchmaking για %s1 επειδή δεν ήσασταν έτοιμοι ή επειδή εγκαταλείψατε το προηγούμενο παιχνίδι σας."
"matchmaking_low_priority_local"	"Θα παραμείνετε στην εύρεση παιχνιδιού χαμηλής προτεραιότητας για %s1 εξαιτίας αποχωρήσεων από παιχνίδια ή λήψης υπερβολικών αναφορών."
"dota_ready_up_count"	"{s:ready_up_ready} / {s:ready_up_lobby_members}"
"dota_play_ranked_match"	"Αγώνας κατάταξης"
"dota_play_1v1_desc"	"Εξασκηθείτε εναντίον ενός αντιπάλου στο κεντρικό μέτωπο. Το παιχνίδι τελειώνει όταν ένας παίκτης πεθάνει δύο φορές ή χάσει ένα πύργο."
"dota_play_button_label"	"{s:play_button_label}"
"dota_play"	"Εκκίνηση Dota"
"dota_play_lobby_find_server"	"Εύρεση διακομιστή"
"dota_play_find_match_label"	"{s:find_match_label}"
"dota_reconnect"	"Επανασύνδεση"
"dota_abandon_game"	"Εγκατάλειψη"
"dota_safe_leave_game"	"Αποχώρηση από παιχνίδι"
"dota_disconnect"	"Αποσύνδεση"
"dota_play_unavailable"	"Μη διαθέσιμο"
"dota_leaver_consequence_tooltip_header"	"Συνέπειες"
"dota_leaver_consequences"	"{s:leaver_consequences}"
"dota_leaver_consequences_details"	"{s:leaver_consequences_details}"
"dota_leaver_view_tooltip"	"Προβολή λεπτομερειών"
"dota_leaver_consequence_header_failure_to_reconnect"	"Η αποτυχία επανασύνδεσης επιφέρει τις ακόλουθες συνέπειες:"
"dota_leaver_consequence_header_leave_match"	"Η αποχώρηση από αυτό το παιχνίδι επιφέρει τις ακόλουθες συνέπειες:"
"dota_leaver_consequence_LetDownTeammates"	"Οι συμπαίκτες σας θα παίζουν με αριθμητικό μειονέκτημα."
"dota_leaver_consequence_SmallMatchmakingCooldown"	"Δε θα μπορείτε να συμμετέχετε σε matchmaking για κάποιο χρονικό διάστημα."
"dota_leaver_consequence_CreditWithAbandon"	"Θα λάβετε μια εγκατάλειψη."
"dota_leaver_consequence_ForcedLossForLeaver"	"Θα λάβετε μια ήττα."
"dota_leaver_consequence_ForcedLossForLeaversParty"	"Όλοι στην παρέα σας θα λάβουν μια ήττα."
"dota_leaver_consequence_ForcedLossForLeaversTeam"	"Η ομάδα σας, %s1, θα λάβει μία ήττα."
"dota_leaver_consequence_MMRLossForLeaver"	"Η κατάταξή σας θα μειωθεί."
"dota_leaver_consequence_MMRLossForLeaversParty"	"Η κατάταξη όλων στην παρέα σας θα μειωθεί."
"dota_leaver_consequence_MMRLossForLeaversTeam"	"Η κατάταξη της ομάδας σας, %s1, θα μειωθεί."
"dota_leaver_consequence_MatchDiscardedForOtherPlayers"	"Αυτό το παιχνίδι δε θα καταγραφεί για τους άλλους παίκτες."
"dota_leaver_consequence_NotDecrementLowPriGamesRemaining"	"Δεν θα καταγραφεί ότι ολοκληρώσατε τον αγώνα."
"dota_reconnect_popup_title"	"Επανασύνδεση;"
"dota_matchmaking_region_ping"	"{s:region_ping}"
"dota_matchmaking_region_offline"	"Εκτός σύνδεσης για συντήρηση"
"dota_matchmaking_region_unknown_ping"	"Ping: Άγνωστο"
"dota_matchmaking_region_ping_time"	"Ping: {i:ping_ms}ms"
"DOTA_VAC_Verification_Header"	"Valve Anti-Cheat (VAC)"
"DOTA_VAC_Verification_Header_Solo"	"Αδυναμία εύρεσης παιχνιδιού επειδή ένα θέμα με τον υπολογιστή σας εμποδίζει το σύστημα VAC. Σιγουρευτείτε ότι δε χρησιμοποιείτε κάποιο πρόγραμμα που επηρεάζει το VAC και επιβεβαιώστε ότι το Steam είναι σωστά εγκατεστημένο."
"DOTA_VAC_Verification_Header_Party"	"Αδυναμία εύρεσης παιχνιδιού επειδή ένα θέμα με τον υπολογιστή σας εμποδίζει το σύστημα VAC. Σιγουρευτείτε ότι τα μέλη της παρέας σας δε χρησιμοποιούν κάποιο πρόγραμμα που επηρεάζει το VAC και επιβεβαιώστε ότι έχουν το Steam σωστά εγκατεστημένο."
"DOTA_VAC_Verification_Button1"	"Περισσότερες πληροφορίες"
"DOTA_VAC_Verification_Button2"	"Κλείσιμο"
"dota_matchmaking_regions_button"	"{s:regions_selected}"
"dota_region_automatic"	"Περιοχή: Αυτόματη"
"dota_regions_selected"	"Περιοχές: "
"dota_lobby_region_invalid"	"Καμία"
"dota_play_no_language_selected"	"ΕΠΙΛΟΓΗ ΓΛΩΣΣΑΣ"
"dota_play_language"	"{s:match_language}"
"dota_play_language_many"	"ΓΛΩΣΣΕΣ: {i:match_language_count}"
"dota_ready_fail"	"ΑΠΟΤΥΧΙΑ ΑΠΟΔΟΧΗΣ ΠΑΙΧΝΙΔΙΟΥ"
"dota_ready_fail_desc"	"Το παιχνίδι σας ήταν έτοιμο, αλλά δεν απαντήσατε και αφαιρεθήκατε από την εύρεση παιχνιδιού."
"dota_chatwheel_label_Ok"	"Εντάξει"
"dota_chatwheel_label_Care"	"Προσοχή"
"dota_chatwheel_label_GetBack"	"Υποχώρηση"
"dota_chatwheel_label_NeedWards"	"Χρειαζόμαστε Ward"
"dota_chatwheel_label_Stun"	"Σάστισμα"
"dota_chatwheel_label_Help"	"Βοήθεια"
"dota_chatwheel_label_Push"	"Πιέστε"
"dota_chatwheel_label_GoodJob"	"Καλή δουλειά"
"dota_chatwheel_label_Missing"	"Λείπει"
"dota_chatwheel_label_Missing_Top"	"Λείπει από πάνω"
"dota_chatwheel_label_Missing_Mid"	"Λείπει από κέντρο"
"dota_chatwheel_label_Missing_Bottom"	"Λείπει από κάτω"
"dota_chatwheel_label_Go"	"Πάμε!"
"dota_chatwheel_label_Initiate"	"Ξεκινήστε τη μάχη!"
"dota_chatwheel_label_Follow"	"Ακολουθήστε με"
"dota_chatwheel_label_Group_Up"	"Πάμε μαζί"
"dota_chatwheel_label_Spread_Out"	"Απλωθείτε"
"dota_chatwheel_label_Split_Farm"	"Χωριστείτε και αποκτήστε χρυσό"
"dota_chatwheel_label_Attack"	"Επίθεση τώρα!"
"dota_chatwheel_label_BRB"	"Επιστρέφω αμέσως"
"dota_chatwheel_label_Dive"	"Χωθείτε στη μάχη!"
"dota_chatwheel_label_OMW"	"Καταφθάνω"
"dota_chatwheel_label_Get_Ready"	"Ετοιμαστείτε"
"dota_chatwheel_label_Bait"	"Δόλωμα"
"dota_chatwheel_label_Heal"	"Θεραπεία"
"dota_chatwheel_label_Mana"	"Ενέργεια"
"dota_chatwheel_label_OOM"	"Μη επαρκής ενέργεια"
"dota_chatwheel_label_Skill_Cooldown"	"Σε επαναφόρτιση"
"dota_chatwheel_label_Ulti_Ready"	"Έτοιμη απόλυτη ικανότητα"
"dota_chatwheel_label_Enemy_Returned"	"Ο εχθρός επέστρεψε"
"dota_chatwheel_label_All_Missing"	"Όλοι οι εχθροί λείπουν"
"dota_chatwheel_label_Enemy_Incoming"	"Ο εχθρός καταφθάνει"
"dota_chatwheel_label_Invis_Enemy"	"Αόρατος εχθρός"
"dota_chatwheel_label_Enemy_Had_Rune"	"Ο εχθρός έχει Rune"
"dota_chatwheel_label_Split_Push"	"Επίθεση από πολλαπλά μέτωπα"
"dota_chatwheel_label_Coming_To_Gank"	"Έρχομαι για επίθεση"
"dota_chatwheel_label_Request_Gank"	"Ελάτε να τους επιτεθούμε"
"dota_chatwheel_label_Fight_Under_Tower"	"Μάχη κάτω από τον πύργο"
"dota_chatwheel_label_Deny_Tower"	"Αρνηθείτε τον πύργο"
"dota_chatwheel_label_Buy_Courier"	"Αγοράστε μεταφορέα"
"dota_chatwheel_label_Upgrade_Courier"	"Αναβάθμιση μεταφορέα"
"dota_chatwheel_label_Need_Detection"	"Χρειαζόμαστε ανίχνευση αορατότητας"
"dota_chatwheel_label_They_Have_Detection"	"Μπορούν να ανιχνεύσουν αορατότητα"
"dota_chatwheel_label_Buy_TP"	"Αγοράστε Town Portal Scroll"
"dota_chatwheel_label_Reuse_Courier"	"Επαναχρησιμοποίηση μεταφορέα"
"dota_chatwheel_label_Deward"	"Ξεφορτωθείτε τα εχθρικά Ward"
"dota_chatwheel_label_Building_Mek"	"Φτιάχνω Mekansm"
"dota_chatwheel_label_Building_Pipe"	"Φτιάχνω Pipe of Insight"
"dota_chatwheel_label_Stack_And_Pull"	"Στοιβάξτε και τραβήξτε ουδέτερες μονάδες"
"dota_chatwheel_label_Pull"	"Τραβήξτε ουδέτερες μονάδες"
"dota_chatwheel_label_Pulling"	"Τραβάω ουδέτερες μονάδες"
"dota_chatwheel_label_Stack"	"Στοιβάξτε ουδέτερες μονάδες"
"dota_chatwheel_label_Jungling"	"Επιτίθεμαι σε ουδέτερες μονάδες"
"dota_chatwheel_label_Roshan"	"Roshan"
"dota_chatwheel_label_Affirmative"	"Σύμφωνοι"
"dota_chatwheel_label_Wait"	"Περιμένετε"
"dota_chatwheel_label_Pause"	"Παύση"
"dota_chatwheel_label_Current_Time"	"Τρέχων χρόνος"
"dota_chatwheel_label_Check_Runes"	"Ελέγξτε τα rune"
"dota_chatwheel_label_Smoke_Gank"	"Επίθεση με Smoke of Deceit!"
"dota_chatwheel_label_GLHF"	"Καλή τύχη"
"dota_chatwheel_label_Nice"	"Ωραία"
"dota_chatwheel_label_Thanks"	"Ευχαριστώ"
"dota_chatwheel_label_Sorry"	"Συγγνώμη"
"dota_chatwheel_label_No_Give_Up"	"Μην τα παρατάτε"
"dota_chatwheel_label_Just_Happened"	"Το είδαμε κι αυτό"
"dota_chatwheel_label_Game_Is_Hard"	"Δύσκολο παιχνίδι"
"dota_chatwheel_label_New_Meta"	"Νέα διάσταση"
"dota_chatwheel_label_My_Bad"	"Λάθος μου"
"dota_chatwheel_label_Regret"	"Μετανόηση"
"dota_chatwheel_label_Relax"	"Ηρεμία"
"dota_chatwheel_label_GG"	"GG"
"dota_chatwheel_label_GGWP"	"GGWP"
"dota_chatwheel_label_All_GG"	"(Όλοι) GG"
"dota_chatwheel_label_All_GGWP"	"(Όλοι) GGWP"
"dota_chatwheel_label_What_To_Buy"	"Τι να αγοράσω;"
"dota_chatwheel_label_Im_Retreating"	"Υποχωρώ"
"dota_chatwheel_label_Space_Created"	"Δημιουργήθηκε χώρος"
"dota_chatwheel_label_Whoops"	"Ουπς"
"dota_chatwheel_label_Tower_then_Back"	"Πύργος και πίσω"
"dota_chatwheel_label_Barracks_then_Back"	"Στρατώνες και πίσω"
"dota_chatwheel_label_Ward_Bottom_Rune"	"Ward στο κάτω rune"
"dota_chatwheel_label_Ward_Top_Rune"	"Ward στο πάνω rune"
"dota_chatwheel_label_Zeus_Ult"	"Zeus Ulti"
"dota_chatwheel_header_positioning"	"Κινήσεις"
"dota_chatwheel_header_status"	"Καταστάσεις"
"dota_chatwheel_header_enemy"	"Εχθρός"
"dota_chatwheel_header_lane"	"Μέτωπο επίθεσης"
"dota_chatwheel_header_items"	"Αντικείμενα"
"dota_chatwheel_header_neutrals"	"Ουδέτερες μονάδες"
"dota_chatwheel_header_misc"	"Διάφορα"
"dota_chatwheel_header_flavor"	"Κουβέντα"
"dota_chatwheel_message_Ok"	"Εντάξει."
"dota_chatwheel_message_Care"	"Προσοχή!"
"dota_chatwheel_message_GetBack"	"Υποχώρηση!"
"dota_chatwheel_message_NeedWards"	"Χρειαζόμαστε Ward."
"dota_chatwheel_message_Stun"	"Σάστισμα τώρα!"
"dota_chatwheel_message_Help"	"Βοήθεια!"
"dota_chatwheel_message_Push"	"Πιέστε τώρα"
"dota_chatwheel_message_GoodJob"	"Καλή δουλειά!"
"dota_chatwheel_message_Missing"	"Λείπει!"
"dota_chatwheel_message_Missing_Top"	"Λείπει από πάνω!"
"dota_chatwheel_message_Missing_Mid"	"Λείπει από κέντρο!"
"dota_chatwheel_message_Missing_Bottom"	"Λείπει από κάτω!"
"dota_chatwheel_message_Go"	"Πάμε!"
"dota_chatwheel_message_Initiate"	"Ξεκινήστε τη μάχη!"
"dota_chatwheel_message_Follow"	"Ακολουθήστε με"
"dota_chatwheel_message_Group_Up"	"Πάμε μαζί"
"dota_chatwheel_message_Spread_Out"	"Απλωθείτε"
"dota_chatwheel_message_Split_Farm"	"Χωριστείτε και αποκτήστε χρυσό"
"dota_chatwheel_message_Attack"	"Επίθεση τώρα!"
"dota_chatwheel_message_BRB"	"Επιστρέφω αμέσως"
"dota_chatwheel_message_Dive"	"Χωθείτε στη μάχη!"
"dota_chatwheel_message_OMW"	"Καταφθάνω"
"dota_chatwheel_message_Get_Ready"	"Ετοιμαστείτε"
"dota_chatwheel_message_Bait"	"Δόλωμα"
"dota_chatwheel_message_Heal"	"Θεραπεία"
"dota_chatwheel_message_Mana"	"Ενέργεια"
"dota_chatwheel_message_OOM"	"Δεν έχω ενέργεια"
"dota_chatwheel_message_Skill_Cooldown"	"Οι ικανότητες είναι σε επαναφόρτιση"
"dota_chatwheel_message_Ulti_Ready"	"Η απόλυτη ικανότητα είναι έτοιμη"
"dota_chatwheel_message_Enemy_Returned"	"Ο εχθρός επέστρεψε"
"dota_chatwheel_message_All_Missing"	"Όλοι οι εχθροί λείπουν!"
"dota_chatwheel_message_Enemy_Incoming"	"Ο εχθρός καταφθάνει!"
"dota_chatwheel_message_Invis_Enemy"	"Αόρατος εχθρός κοντά!"
"dota_chatwheel_message_Enemy_Had_Rune"	"Ο εχθρός έχει Rune"
"dota_chatwheel_message_Split_Push"	"Χωριστείτε και πιέστε"
"dota_chatwheel_message_Coming_To_Gank"	"Έρχομαι για επίθεση"
"dota_chatwheel_message_Request_Gank"	"Χρειάζομαι βοήθεια για επίθεση"
"dota_chatwheel_message_Fight_Under_Tower"	"Πολεμήστε κάτω από τον πύργο"
"dota_chatwheel_message_Deny_Tower"	"Αρνηθείτε τον πύργο!"
"dota_chatwheel_message_Buy_Courier"	"Αγοράστε ένα μεταφορέα"
"dota_chatwheel_message_Upgrade_Courier"	"Μπορεί κανείς να αναβαθμίσει τον μεταφορέα;"
"dota_chatwheel_message_Need_Detection"	"Χρειαζόμαστε ανίχνευση αορατότητας"
"dota_chatwheel_message_They_Have_Detection"	"Έχουν ανίχνευση αορατότητας"
"dota_chatwheel_message_Buy_TP"	"Αγοράστε Town Portal Scroll"
"dota_chatwheel_message_Reuse_Courier"	"Χρησιμοποιήστε το μεταφορέα ξανά"
"dota_chatwheel_message_Deward"	"Ξεφορτωθείτε τα εχθρικά Ward"
"dota_chatwheel_message_Building_Mek"	"Φτιάχνω Mekansm"
"dota_chatwheel_message_Building_Pipe"	"Φτιάχνω Pipe of Insight"
"dota_chatwheel_message_Stack_And_Pull"	"Στοιβάξτε και τραβήξτε ουδέτερες μονάδες"
"dota_chatwheel_message_Pull"	"Τραβήξτε ουδέτερες μονάδες"
"dota_chatwheel_message_Pulling"	"Τραβάω ουδέτερες μονάδες"
"dota_chatwheel_message_Stack"	"Στοιβάξτε ουδέτερες μονάδες"
"dota_chatwheel_message_Jungling"	"Επιτίθεμαι σε ουδέτερες μονάδες"
"dota_chatwheel_message_Roshan"	"Roshan"
"dota_chatwheel_message_Affirmative"	"Σύμφωνοι"
"dota_chatwheel_message_Wait"	"Περιμένετε"
"dota_chatwheel_message_Pause"	"Παύση παρακαλώ!"
"dota_chatwheel_message_Current_Time"	"Τρέχων χρόνος παιχνιδιού"
"dota_chatwheel_message_Check_Runes"	"Ελέγξτε τα rune"
"dota_chatwheel_message_Smoke_Gank"	"Ελάτε για Smoke of Deceit!"
"dota_chatwheel_message_GLHF"	"Καλή τύχη, καλή διασκέδαση"
"dota_chatwheel_message_Nice"	"Ωραία"
"dota_chatwheel_message_Thanks"	"Ευχαριστώ!"
"dota_chatwheel_message_Sorry"	"Συγγνώμη"
"dota_chatwheel_message_No_Give_Up"	"Μην τα παρατάτε!"
"dota_chatwheel_message_Just_Happened"	"Το είδαμε κι αυτό"
"dota_chatwheel_message_Game_Is_Hard"	"Δύσκολο παιχνίδι"
"dota_chatwheel_message_New_Meta"	"Νέα διάσταση"
"dota_chatwheel_message_My_Bad"	"Λάθος μου"
"dota_chatwheel_message_Regret"	"Μετάνιωσα ήδη την απόφασή μου"
"dota_chatwheel_message_Relax"	"Χαλάρωσε, τα πας μια χαρά"
"dota_chatwheel_message_MissingHero"	"Αγνοείται %s1!"
"dota_chatwheel_message_ReturnedHero"	"Επέστρεψε %s1!"
"dota_chatwheel_message_GG"	"Καλό παιχνίδι"
"dota_chatwheel_message_GGWP"	"Ωραίο παιχνίδι, καλή δουλειά"
"dota_chatwheel_message_All_GG"	"Καλό παιχνίδι"
"dota_chatwheel_message_All_GGWP"	"Ωραίο παιχνίδι, καλή δουλειά"
"dota_chatwheel_message_What_To_Buy"	"Τι να αγοράσω;"
"dota_chatwheel_message_Im_Retreating"	"Υποχωρώ"
"dota_chatwheel_message_Space_Created"	"Δημιουργήθηκε χώρος"
"dota_chatwheel_message_Whoops"	"Ουπς"
"dota_chatwheel_message_Tower_then_Back"	"Καταστρέψτε τον πύργο και γυρίστε πίσω"
"dota_chatwheel_message_Barracks_then_Back"	"Καταστρέψτε στρατώνες και γυρίστε πίσω"
"dota_chatwheel_message_Ward_Bottom_Rune"	"Τοποθετήστε Ward στο κάτω rune"
"dota_chatwheel_message_Ward_Top_Rune"	"Τοποθετήστε Ward στο πάνω rune"
"dota_chatwheel_message_Zeus_Ult"	"Zeus Ulti τώρα!"
"dota_settings_options"	"Επιλογές"
"dota_settings_audio"	"ΗΧΟΣ"
"dota_settings_voice"	"Ομιλία"
"dota_settings_voice_level"	"Τρέχον επίπεδο καταγραφής"
"dota_settings_volume"	"Ένταση"
"dota_settings_video"	"Γραφικά"
"dota_settings_legacykeys"	"Χρήση παραδοσιακών πλήκτρων"
"dota_settings_abilities"	"Ικανότητες"
"dota_settings_abilities_hero"	"Ήρωας"
"dota_settings_abilities_courier"	"Μεταφορέας"
"dota_settings_abilities_primary1"	"1"
"dota_settings_abilities_primary2"	"2"
"dota_settings_abilities_primary3"	"3"
"dota_settings_abilities_secondary1"	"4"
"dota_settings_abilities_secondary2"	"5"
"dota_settings_abilities_neutral1"	"1"
"dota_settings_abilities_neutral2"	"2"
"dota_settings_abilities_neutral3"	"3"
"dota_settings_abilities_neutral4"	"4"
"dota_settings_abilities_courier1"	"1"
"dota_settings_abilities_courier2"	"2"
"dota_settings_abilities_courier3"	"3"
"dota_settings_abilities_courier4"	"4"
"dota_settings_abilities_courier5"	"5"
"dota_settings_abilities_courier6"	"6"
"dota_settings_cast"	"Εκτέλεση"
"dota_settings_abilitylearn"	"Εκμάθηση ικανότητας"
"dota_settings_upgradestats"	"Αναβάθμιση στατιστικών"
"dota_settings_unitactions"	"Ενέργειες μονάδων"
"dota_settings_move"	"Κίνηση"
"dota_settings_stop"	"Διακοπή"
"dota_settings_selecthero"	"Επιλογή ήρωα"
"dota_settings_selectcourier"	"Επιλογή μεταφορέα"
"dota_settings_courierdeliver"	"Παράδοση αντικειμένων μεταφορέα"
"dota_settings_items"	"Αντικείμενα"
"dota_settings_openshop"	"Άνοιγμα μαγαζιού"
"dota_settings_camera"	"Κάμερα"
"dota_settings_cameraactions"	"Ενέργειες κάμερας"
"dota_settings_cameraup"	"Κάμερα μπροστά"
"dota_settings_cameradown"	"Κάμερα πίσω"
"dota_settings_cameraleft"	"Κάμερα αριστερά"
"dota_settings_cameraright"	"Κάμερα δεξιά"
"dota_settings_recentevent"	"Εμφάνιση πρόσφατου συμβάντος"
"dota_settings_inspectheroinworld"	"Προβολή προθήκης"
"dota_settings_chat"	"Συνομιλία"
"dota_settings_phrases"	"Φράσεις"
"dota_settings_chatwheel_page"	"Ροδέλα μηνυμάτων"
"dota_settings_chatvoice_party"	"Ομιλία (παρέα)"
"dota_settings_chatvoice_team"	"Ομιλία (ομάδα)"
"dota_settings_playeractions"	"Ενέργειες παίκτη"
"dota_settings_activateglyph"	"Ενεργοποίηση οχύρωσης"
"dota_settings_scoreboardtoggle"	"Βαθμολογία"
"dota_settings_pause"	"Παύση"
"dota_settings_screenshot"	"Φωτογραφία"
"dota_settings_console"	"Κονσόλα"
"dota_settings_spectatordropdown_kda"	"Σκοτωμοί/Θάνατοι/Βοήθειες"
"dota_settings_spectatordropdown_lasthits_denies"	"Τελικές επιθέσεις/Αρνήσεις"
"dota_settings_spectatordropdown_level"	"Επίπεδο ήρωα"
"dota_settings_spectatordropdown_xp_per_min"	"Εμπειρία ανά λεπτό"
"dota_settings_spectatordropdown_gold"	"Τρέχων χρυσός"
"dota_settings_spectatordropdown_totalgold"	"Συνολική αξία"
"dota_settings_spectatordropdown_gold_per_min"	"Χρυσός ανά λεπτό"
"dota_settings_spectatordropdown_buyback"	"Κατάσταση εξαγοράς"
"dota_settings_coaching"	"Καθοδήγηση"
"dota_settings_keyboardtemplate"	"Επιλογή προτύπου πληκτρολογίου"
"dota_settings_or"	"Ή"
"dota_settings_cancel"	"Άκυρο"
"dota_settings_apply"	"Εφαρμογή"
"dota_settings_game"	"Παιχνίδι"
"dota_settings_autoattack"	"Αυτόματη επίθεση"
"dota_settings_attackafterspell"	"Αυτόματη επίθεση μετά από ικανότητα"
"dota_settings_autopurchase"	"Αυτόματη αγορά αντικειμένων"
"dota_settings_colorblind"	"Λειτουργία αχρωματοψίας"
"dota_settings_minimap"	"Χάρτης"
"dota_settings_profile"	"Προφίλ"
"dota_settings_allowtradeinvitesheader"	"Προσκλήσεις ανταλλαγής από:"
"dota_settings_trade_friends"	"Φίλους μόνο"
"dota_settings_trade_anyone"	"Οποιονδήποτε"
"dota_settings_network"	"Δίκτυο"
"dota_settings_networkquality"	"Ποιότητα δικτύου"
"dota_settings_networkquality_low"	"Χαμηλή"
"dota_settings_networkquality_high"	"Υψηλή"
"dota_settings_usenativeresolution"	"Χρήση τρέχουσας ανάλυσης της οθόνης μου"
"dota_settings_customresolution"	"Χρήση προχωρημένων ρυθμίσεων"
"dota_settings_resolution"	"Ανάλυση"
"dota_settings_aspectratio"	"Αναλογία"
"dota_settings_aspectratio43"	"4:3"
"dota_settings_aspectratio169"	"16:9"
"dota_settings_aspectratio1610"	"16:10"
"dota_settings_resolution_size"	"Μέγεθος"
"dota_settings_fullscreen"	"Αποκλειστική πλήρης οθόνη"
"dota_settings_window"	"Σε παράθυρο"
"dota_settings_borderless"	"Χωρίς περίγραμμα"
"dota_settings_videodefaults"	"Επαναφορά προεπιλογών"
"dota_settings_basicvideosettings"	"Χρήση βασικών ρυθμίσεων"
"dota_settings_advancedvideosettings"	"Χρήση προχωρημένων ρυθμίσεων"
"dota_settings_antialiasing"	"Anti-Aliasing"
"dota_settings_specular"	"Κατοπτρισμός"
"dota_settings_waterquality"	"Νερό υψηλής ποιότητας"
"dota_settings_fog"	"Ατμοσφαιρική ομίχλη"
"dota_settings_animateportrait"	"Κίνηση πορτραίτων"
"dota_settings_worldlight"	"Φωτισμός κόσμου"
"dota_settings_ambientocclusion"	"Σκίαση περιβάλλοντος"
"dota_settings_normal_maps"	"Κανονικοποιημένη χαρτογράφηση"
"dota_settings_vsync"	"Κάθετος συγχρονισμός"
"dota_settings_shadowquality"	"Ποιότητα σκιών"
"dota_settings_shadowquality_low"	"Χαμηλή"
"dota_settings_shadowquality_med"	"Μεσαία"
"dota_settings_shadowquality_high"	"Υψηλή"
"dota_settings_texturequality"	"Ποιότητα δομών"
"dota_settings_texturequality_low"	"Χαμηλή"
"dota_settings_texturequality_med"	"Μεσαία"
"dota_settings_texturequality_high"	"Υψηλή"
"dota_settings_mastervolume"	"Κύρια ένταση"
"dota_settings_gamevolume"	"Ήχοι παιχνιδιού"
"dota_settings_musicvolume"	"Μουσική"
"dota_settings_voicevolume"	"Φωνή"
"dota_settings_gamevoicevolume"	"Ομιλία μονάδων"
"dota_settings_openmic"	"Ενεργοποιήστε το «Άνοιγμα μικροφώνου» για να επικοινωνήσετε με τα μέλη της παρέας"
"dota_settings_audiodefaults"	"Προεπιλογές ήχου"
"dota_settings_defaultaudio"	"Προεπιλογή"
"dota_settings_sounddevice"	"Συσκευή ήχου:"
"dota_settings_speakerconfig"	"Διάταξη ηχείων:"
"dota_settings_headphones"	"Ακουστικά"
"dota_settings_2speakers"	"2 ηχεία"
"dota_settings_4speakers"	"4 ηχεία"
"dota_settings_5speakers"	"5.1 ηχεία"
"dota_settings_7speakers"	"7.1 ηχεία"
"dota_settings_captions"	"Χρήση υποτίτλων"
"dota_settings_chatsounds"	"Ήχος μηνυμάτων συνομιλίας"
"dota_settings_highqualityaudio"	"Ήχος υψηλής ποιότητας"
"dota_settings_unitspeeh"	"Ομιλία μονάδων"
"dota_settings_unitspeech_off"	"Κλειστό"
"dota_settings_unitspeech_events"	"Συμβάντα"
"dota_settings_unitspeech_all"	"Όλες"
"OS_Default_Device"	"Προεπιλεγμένη συσκευή"
"DOTA_Keybind_ARROW"	"Βέλος (Προεπιλογή)"
"DOTA_Keybind_WASD"	"WASD"
"DOTA_Keybind_MMO"	"MMO"
"DOTA_Keybind_LEGACY"	"Παραδοσιακά πλήκτρα"
"DOTA_Keybind_LOL"	"League of Legends"
"DOTA_Keybind_HON"	"Heroes of Newerth"
"DOTA_Keybind_SMITE"	"Smite"
"DOTA_Hotkeys_Tooltip_LearnAbility"	"Αναβάθμιση μιας ικανότητας όταν είναι διαθέσιμη."
"DOTA_Hotkeys_Tooltip_LearnStats"	"Αναβάθμιση δύο πόντων στα στατιστικά αντί για αναβάθμιση ικανοτήτων."
"DOTA_Hotkeys_Tooltip_HeroAttack"	"Κίνηση σε μια τοποθεσία αλλά επίθεση εχθρών στην πορεία / Επίθεση σε συμμαχικές μονάδες αν είναι δυνατόν."
"DOTA_Hotkeys_Tooltip_HeroMove"	"Μετακίνηση σε μια τοποθεσία ή ακολούθηση μιας μονάδας χωρίς επίθεση."
"DOTA_Hotkeys_Tooltip_HeroStop"	"Διακοπή τρέχουσας ενέργειας."
"DOTA_Hotkeys_Tooltip_HeroHold"	"Διακοπή τρέχουσας ενέργειας και διατήρηση θέσης."
"DOTA_Hotkeys_Tooltip_HeroSelect"	"Επιλογή του ήρωά σας."
"DOTA_Hotkeys_Tooltip_SelectAll"	"Επιλογή όλων των μονάδων υπό τον έλεγχό σας."
"DOTA_Hotkeys_Tooltip_SelectAllOthers"	"Επιλογή όλων των άλλων μονάδων που ελέγχετε. (Ο ήρωάς σας δε θα επιλεχθεί)"
"DOTA_Hotkeys_Tooltip_CourierSelect"	"Επιλογή του μεταφορέα."
"DOTA_Hotkeys_Tooltip_CourierDeliver"	"Ο μεταφορέας παίρνει τα αντικείμενα από τη φύλαξη και τα παραδίδει."
"DOTA_Hotkeys_Tooltip_CourierHaste"	"Αυξάνει την ταχύτητα του μεταφορέα όταν είναι διαθέσιμο."
"DOTA_Hotkeys_Tooltip_UseActionItem"	"Χρήση δραστικού αντικειμένου."
"DOTA_Hotkeys_Tooltip_HeroTaunt"	"Χρήση χλευασμού ήρωα. Διαθέσιμο ως διακοσμητικό αντικείμενο."
"DOTA_Hotkeys_Tooltip_ShopToggle"	"Άνοιγμα καρτέλας αγοράς."
"DOTA_Hotkeys_Tooltip_PurchaseQuickbuy"	"Αγορά του επόμενου αντικειμένου στη λίστα άμεσης αγοράς αν σας φτάνουν τα χρήματα."
"DOTA_Hotkeys_Tooltip_PurchaseSticky"	"Αγορά μόνιμου αντικειμένου αν σας φτάνουν τα χρήματα."
"DOTA_Hotkeys_Tooltip_GrabStashItems"	"Μεταφορά όλων των αντικειμένων από τη φύλαξη στον ήρωά σας."
"DOTA_Hotkeys_Tooltip_RecentEvent"	"Μεταφορά της κάμερας στο πιο πρόσφατο συμβάν στον κόσμο."
"DOTA_Hotkeys_Tooltip_InspectHeroInWorld"	"Προβολή μιας μονάδας από κοντά."
"DOTA_Hotkeys_Tooltip_ChatTeam"	"Αποστολή μηνύματος σε όλους τους συμμάχους."
"DOTA_Hotkeys_Tooltip_ChatGlobal"	"Αποστολή μηνύματος σε όλους στο τρέχον παιχνίδι. (SHIFT + το πλήκτρο για συνομιλία συμμάχων)"
"DOTA_Hotkeys_Tooltip_ChatWheel"	"Εμφάνιση της ροδέλας μηνυμάτων για εύκολη αποστολή συχνών φράσεων."
"DOTA_Hotkeys_Tooltip_CameraGrip"	"Κρατήστε πατημένο και σύρετε τον κόσμο για κίνηση της κάμερας. Γίνεται και με το μεσαίο κουμπί του ποντικιού."
"DOTA_Hotkeys_Tooltip_ActivateGlyph"	"Ενεργοποιεί το Glyph of Fortification για να κάνει τα κτήρια της ομάδας σας άτρωτα για 5 δευτερόλεπτα."
"DOTA_Hotkeys_Tooltip_ScoreboardToggle"	"Άνοιγμα της βαθμολογίας του παιχνιδιού."
"DOTA_Hotkeys_Tooltip_Pause"	"Παύση και επαναφορά του παιχνιδιού σε εξέλιξη."
"DOTA_Hotkeys_Tooltip_ScreenshotSettings"	"Λήψη φωτογραφίας της τρέχουσας εικόνας του παιχνιδιού."
"DOTA_Hotkeys_Tooltip_Console"	"Άνοιγμα κονσόλας. (Για προχωρημένους χρήστες μόνο)"
"DOTA_Hotkeys_Tooltip_ControlGroupCycle"	"Εναλλαγή μεταξύ κάθε μονάδας μιας επιλεγμένης ομάδας ελέγχου."
"DOTA_Hotkeys_Tooltip_Group"	"Επιλέξτε μια ομάδα μονάδων. Για να ορίσετε μια ομάδα ελέγχου, επιλέξτε τις επιθυμητές μονάδες και πατήστε CTRL + ένα από τα παρακάτω πλήκτρα ομάδων ελέγχου."
"DOTA_Hotkeys_Tooltip_Legacy"	"Χρήση πλήκτρων από το αρχικό Dota. Τα πλήκτρα ικανοτήτων διαφέρουν ανά ήρωα."
"DOTA_Hotkeys_Tooltip_Quickcast"	"Μια ικανότητα με άμεση εκτέλεση ενεργοποιείται μόλις πατηθεί το πλήκτρο στην τρέχουσα κατεύθυνση του κέρσορα."
"DOTA_Hotkeys_Tooltip_Autocast"	"Με την εναλλαγή προκαλεί μια ικανότητα να εκτελείται αυτόματα όταν είναι έτοιμη. Εφαρμόζεται σε λίγες ικανότητες."
"DOTA_Hotkeys_Tooltip_Cast"	"Συντομεύσεις για εκτέλεση ικανότητας Ήρωα."
"DOTA_Hotkeys_Tooltip_ItemCast"	"Πλήκτρα χρήσης αντικειμένων."
"DOTA_Hotkeys_Tooltip_ItemQuickcast"	"Ένα αντικείμενο με άμεση εκτέλεση ενεργοποιείται μόλις πατηθεί το πλήκτρο στην τρέχουσα κατεύθυνση του κέρσορα."
"DOTA_Settings_Tooltip_Autoattack"	"Κινείται αυτόματα για να επιτεθεί σε κοντινούς εχθρούς."
"DOTA_Settings_Tooltip_AutoattackAfterSpell"	"Αν αποεπιλεγεί, ο Ήρωας θα μείνει ακίνητος αφού χρησιμοποιήσει ένα ξόρκι, αναμένοντας την επόμενη εντολή."
"DOTA_Settings_Tooltip_AutoPurchase"	"Αγορά του επόμενου αντικειμένου στη λίστα προτεινόμενων αντικειμένων όταν μπορείτε να το αγοράσετε."
"DOTA_Settings_Tooltip_AutoSelectSummons"	"Όταν καλούνται νέες μονάδες από τον Ήρωα, προσθέτονται στην ομάδα ελέγχου μονάδων."
"DOTA_Settings_Tooltip_DoubleTap"	"Με διπλό πάτημα σε ικανότητα ή αντικείμενο, το εκτελεί στον εαυτό σας όταν είναι δυνατό."
"DOTA_Settings_Tooltip_UnifiedOrders"	"Κρατώντας πατημένο το CTRL όταν δίνετε μια εντολή, θα εκτελεσθεί από όλες τις μονάδες που ελέγχετε."
"DOTA_Settings_Tooltip_TeleportStop"	"Η κίνηση ή η εκτέλεση ικανότητας δε θα σταματήσει μια τηλεμεταφορά σε εξέλιξη. Εφαρμόζεται μόνο σε Town Portal Scroll ή Boots of Travel."
"DOTA_Settings_Tooltip_BroadcasterStats"	"Όταν παρακολουθείτε ένα παιχνίδι, θα εμφανίζονται τα στατιστικά που χρησιμοποιεί ο εκφωνητής."
"DOTA_Settings_Tooltip_Deceleration"	"Η ταχύτητα με την οποία ηρεμεί η κάμερα αφού σταματήσει να κουνιέται. Μεγαλύτερη τιμή σημαίνει ταχύτερο σταμάτημα."
"DOTA_Settings_Tooltip_Screenshake"	"Μερικές ικανότητες και σαστίσματα μπορούν να ταρακουνήσουν την κάμερα."
"DOTA_Settings_Tooltip_CameraRespawn"	"Επανεστιάζει την κάμερα στον ήρωά σας μόλις αναβιώνει."
"DOTA_Settings_Tooltip_HideProfile"	"Το προφίλ Dota 2 σας δεν θα είναι προσβάσιμο από κανέναν. Το προφίλ Steam σας δεν θα είναι προσβάσιμο από το Dota 2."
"DOTA_Settings_Tooltip_ShareMatchData"	"Επιτρέπει να εμφανίζονται τα στοιχεία από τα δημόσια παιχνίδια σας σε τρίτους."
"DOTA_Settings_Tooltip_NetworkQuality"	"Αν έχετε ασθενή σύνδεση στο δίκτυο, η ρύθμιση σε «ΧΑΜΗΛΗ» μπορεί να βοηθεί την απόδοση του δικτύου σας."
"DOTA_Settings_Tooltip_MinimapSimple"	"Τα χρώματα στο χάρτη καθορίζονται από την ομάδα και όχι από κάθε παίκτη ατομικά."
"DOTA_Settings_Tooltip_MinimapDrawHeroes"	"Κρατώντας πατημένο το ALT, θα εμφανίζεται το εικονίδιο του Ήρωα στο χάρτη, αντί για το όνομα του Ήρωα."
"DOTA_Settings_Tooltip_MinimapNamesIcon"	"Πάντα εμφάνιση εικονιδίου ή ονόματος Ήρωα στο χάρτη, με κρατημένο ALT θα εμφανίζονται προσωρινά X και O."
"DOTA_Settings_Tooltip_ShopHotkeys"	"Τα πλήκτρα συντόμευσης της αγοράς θα παρακάμπτουν άλλες λειτουργίες που τους έχουν ανατεθεί όταν είναι ανοικτή η καρτέλα αγοράς."
"DOTA_create_bot_practice_desc"	"Ξεκινήστε ένα παιχνίδι με bot. Μπορείτε να βρείτε κι άλλους συμπαίκτες μέσω matchmaking ή να γεμίσετε τις άδειες θέσεις της ομάδας σας με bot."
"DOTA_Lobby_BotDifficulty"	"Δυσκολία Bot"
"DOTA_Lobby_BotDifficulty_no_bot"	"Χωρίς Bot"
"DOTA_Lobby_BotDifficulty_passive"	"Ελάχιστη"
"DOTA_Lobby_BotDifficulty_easy"	"Χαμηλή"
"DOTA_Lobby_BotDifficulty_medium"	"Μέτρια"
"DOTA_Lobby_BotDifficulty_hard"	"Υψηλή"
"DOTA_Lobby_BotDifficulty_unfair"	"Μέγιστη"
"DOTA_Lobby_BotTeam"	"Επιλογή ομάδας"
"DOTA_create_bot_practice_solo"	"Solo"
"DOTA_create_bot_practice_coop"	"Co-Op"
"dota_lobby_title"	"{s:lobby_name}"
"dota_lobby_title_local_game"	"Τοπικό λόμπι"
"dota_lobby_title_default"	"Λόμπι"
"lobby_row_player_name"	"{s:player_name}"
"dota_lobby_row_game_name"	"{s:game_name}"
"dota_lobby_row_slots"	"{s:slots}"
"dota_lobby_row_game_mode"	"{s:game_mode}"
"dota_lobby_row_join"	"Σύνδεση"
"dota_lobby_row_leave"	"Αποχώρηση"
"dota_lobby_coaches_title"	"ΚΑΘΟΔΗΓΗΤΕΣ"
"dota_lobby_browser_title"	"ΠΕΡΙΗΓΗΣΗ ΣΤΑ DOTA ΛΟΜΠΙ"
"dota_lobby_browser_num_available"	"( {d:lobbies_available} διαθέσιμα )"
"dota_lobby_browser_search_placeholder"	"Αναζήτηση λόμπι"
"dota_lobby_browser_game_mode"	"Τύπος παιχνιδιού"
"dota_lobby_browser_refresh"	"Ανανέωση"
"dota_lobby_submit_filter"	"ΥΠΟΒΟΛΗ"
"DOTA_Item_OnMarket"	"Αγορά"
"DOTA_Items_DefaultSet"	"Προεπιλεγμένο σετ"
"DOTA_Items_SetEquipped_Label"	"Εξοπλισμένο"
"DOTA_EquippedItem_Label"	"Εξοπλισμένο"
"DOTA_EquippedItem_Rarity"	"{s:equipped_econ_set_rarity}"
"DOTA_EquippedItem_SetName"	"{s:equipped_econ_set_name}"
"DOTA_EquippedItem_DefaultSet"	"Προεπιλεγμένο σετ"
"DOTA_EquippedItem_PartialSet"	"Μερικό σετ"
"DOTA_EquippedItem_Style"	"{i:equipped_econ_set_style_count} στυλ"
"DOTA_EquippedItem_Button_Details"	"{s:equipped_details_button_text}"
"DOTA_EquippedItem_Customize"	"Προσαρμογή"
"DOTA_EquippedItem_CustomSet"	"Προσαρμοσμένο πακέτο"
"DOTA_EquippedItem_Equip"	"Εξόπλιση"
"DOTA_EquippedItem_Unpack_And_Equip"	"Άνοιγμα και εξόπλιση"
"DOTA_EquippedItem_Details"	"{s:equipped_econ_set_type_name} Λεπτομέρειες"
"DOTA_EquippedItem_Purchase_Button"	"Αγορά"
"DOTA_EquippedItem_Marketplace_Button"	"Αγορά"
"DOTA_EquippedItem_BundleName"	"Στο πακέτο «{s:equipped_econ_set_bundle}»"
"DOTA_EquippedItem_SaleAmount"	"-{i:equipped_econ_set_sale_amount}%"
"DOTA_EquippedItem_RegularSetPrice"	"{s:equipped_econ_regular_set_price}"
"DOTA_EquippedItem_SetPrice"	"{s:equipped_econ_set_price}"
"DOTA_EquippedItem_TreasurePrice"	"{s:equipped_econ_treasure_price}"
"DOTA_HeroDemo_Button_DBQuit"	"Έξοδος Demo"
"DOTA_EquippedItem_Bundle"	"Πακέτο"
"DOTA_EquippedItem_ItemSet"	"Σετ"
"DOTA_EquippedItem_Item"	"Αντικείμενο"
"DOTA_EconItemSet_Name"	"{s:econ_set_name}"
"DOTA_EconItemSet_Rarity"	"{s:econ_set_rarity}"
"DOTA_EconItemSet_Status"	"{s:econ_set_status}"
"DOTA_EconItemSet_Price"	"{s:econ_set_price}"
"DOTA_EconItemSet_SaleAmount"	"-{i:econ_sale_amount}%"
"DOTA_EconItemSet_DeveloperOnly"	"Όχι δημόσιο"
"DOTA_EconItemSet_Tooltip_InBundle"	"Αυτό το σετ περιλαμβάνεται σε ένα πακέτο"
"DOTA_EconItemSet_Tooltip_PartialSet"	"Αυτό περιέχει μόνο ένα μέρος του πλήρους σετ αντικειμένων"
"DOTA_HeroRole_Carry"	"Carry"
"DOTA_HeroRole_Support"	"Support"
"DOTA_HeroRole_Nuker"	"Nuker"
"DOTA_HeroRole_Disabler"	"Disabler"
"DOTA_HeroRole_Jungler"	"Jungler"
"DOTA_HeroRole_Durable"	"Durable"
"DOTA_HeroRole_Escape"	"Escape"
"DOTA_HeroRole_LaneSupport"	"Lane Support"
"DOTA_HeroRole_Pusher"	"Pusher"
"DOTA_HeroRole_Initiator"	"Initiator"
"DOTA_HeroRole_Description_Carry"	"Θα γίνει πιο χρήσιμος αργότερα στο παιχνίδι αν κερδίσει ένα σημαντικό προβάδισμα χρυσού."
"DOTA_HeroRole_Description_Support"	"Μπορεί να εστιάσει λιγότερο στη συλλογή χρυσού και αντικειμένων και περισσότερο στη χρήση των ικανοτήτων του για να κερδίσει προβάδισμα η ομάδα του."
"DOTA_HeroRole_Description_Nuker"	"Μπορεί να σκοτώσει γρήγορα εχθρικούς ήρωες χρησιμοποιώντας ξόρκια υψηλής ζημιάς με μικρή επαναφόρτιση."
"DOTA_HeroRole_Description_Disabler"	"Έχει μια σίγουρη καταστολή για ένα ή παραπάνω ξόρκια του."
"DOTA_HeroRole_Description_Durable"	"Έχει την ικανότητα να διαρκεί περισσότερο στις ομαδικές μάχες."
"DOTA_HeroRole_Description_Escape"	"Έχει την ικανότητα να αποφεύγει γρήγορα τον θάνατο."
"DOTA_HeroRole_Description_Pusher"	"Μπορεί να πολιορκήσει και να καταστρέψει πύργους και στρατώνες γρήγορα σε κάθε στιγμή του παιχνιδιού."
"DOTA_HeroRole_Description_Initiator"	"Καλός στο να ξεκινάει μια ομαδική μάχη."
"DOTA_HeroGrid_OptionCategory_Role"	"Ρόλοι:"
"DOTA_HeroGrid_OptionCategory_Attributes"	"Χαρακτηριστικά:"
"DOTA_HeroGrid_OptionCategory_AttackType"	"Είδος επίθεσης:"
"DOTA_HeroLoadout_PreviousHeroName"	"{s:previous_hero_name}"
"DOTA_HeroLoadout_NextHeroName"	"{s:next_hero_name}"
"DOTA_HeroLoadout_CurrentHeroName"	"{s:hero_name}"
"DOTA_HeroLoadout_AttackType"	"{s:hero_attack_type}"
"DOTA_HeroLoadout_HeroFilterName"	"Ήρωας"
"DOTA_HeroLoadout_Search"	"Αναζήτηση για αντικείμενα του {s:hero_name}"
"DOTA_HeroCustomize_Title"	"Προσαρμογή ήρωα"
"DOTA_HeroCustomize_Slot"	"Θέση"
"DOTA_HeroCustomize_SlotName"	"{s:slot_name}"
"DOTA_HeroCustomize_SlotEquippedItemName"	"{s:equipped_item_name}"
"DOTA_HeroCustomize_DefaultItemName"	"Προεπιλεγμένο αντικείμενο"
"DOTA_HeroCustomize_PreviewItemName"	"{s:preview_item_name}"
"DOTA_HeroCustomize_PreviewStyle"	"{s:preview_style_name}"
"DOTA_HeroCustomize_PreviewItemSlot"	"{s:preview_item_slot}"
"DOTA_HeroCustomize_Rarity"	"{s:preview_item_rarity}"
"DOTA_UIEconItem_StyleIndex"	"{i:style_index}"
"dota_ready_up_num_accepted"	"{i:num_accepted} / {i:total_players} αποδέχθηκαν"
"returning_top_of_queue"	"Επιστροφή στην εύρεση παιχνιδιού με υψηλή προτεραιότητα"
"GC_reconnecting"	"ΕΠΑΝΑΣΥΝΔΕΣΗ ΣΤΟ ΔΙΚΤΥΟ DOTA 2..."
"GC_nosteam"	"Χωρίς σύνδεση στο Steam"
"GC_searching"	"ΑΝΑΖΗΤΗΣΗ ΓΙΑ ΔΙΚΤΥΟ DOTA 2..."
"GC_noconnection"	"Χωρίς σύνδεση στο δίκτυο Dota 2."
"GC_connecting"	"Σύνδεση στο δίκτυο του Dota 2..."
"GC_connected"	"Επιτυχής σύνδεση στο δίκτυο Dota 2."
"GC_down"	"Δίκτυο Dota 2 προσωρινά ανενεργό."
"GC_Network_Full"	"Το δίκτυο του Dota 2 είναι προσωρινά γεμάτο."
"GC_Wait_Time"	"Προβλεπόμενος χρόνος αναμονής: %s1"
"GC_Wait_Time_Unknown"	"Άγνωστος"
"dota_practice_vs_bots_difficulty"	"Δυσκολία bot"
"DOTA_practice_vs_bots_team_radiant"	"Radiant"
"DOTA_practice_vs_bots_team_dire"	"Dire"
"DOTA_practice_vs_bots_team_random"	"Τυχαία"
"DOTA_CurrentTime"	"{t:t:current_time}"
"DOTA_MonthlyPlayers"	"{s:users_last_month}"
"DOTA_MonthlyPlayersLabel"	"ΜΟΝΑΔΙΚΟΙ ΠΑΙΚΤΕΣ ΤΟΝ ΠΡΟΗΓΟΥΜΕΝΟ ΜΗΝΑ"
"DOTA_CurrentPlayers"	"{s:current_users}"
"DOTA_CurrentPlayersLabel"	"ΠΑΙΚΤΕΣ ΣΤΟ ΠΑΙΧΝΙΔΙ ΤΩΡΑ"
"DOTA_Search_ItemShortDescription"	"<span class=\"ItemRarityColor\">{s:item_rarity}</span> {s:item_slot}"
"join_error_already_in_game"	"Αδυναμία σύνδεσης στο παιχνίδι, καθώς είστε ήδη σε ένα άλλο παιχνίδι."
"join_error_invalid_lobby"	"Αδυναμία σύνδεσης στο παιχνίδι. Το συγκεκριμένο παιχνίδι δεν υπάρχει πλέον."
"join_error_incorrect_password"	"Λανθασμένος κωδικός."
"join_error_access_denied"	"Πρόσβαση απορρίφθηκε."
"join_error_generic"	" "
"join_error_in_team_party"	"Αδύνατη η είσοδος στο παιχνίδι εξάσκησης. Πρέπει να καταργήσετε την παρέα ομάδας πριν εισέλθετε σε παιχνίδια εξάσκησης."
"join_error_lobby_full"	"Το λόμπι είναι γεμάτο."
"DOTA_Friends_Ready_To_Play"	"Ανοικτά παιχνίδια"
"DOTA_Friend_Finding_Match"	"Εύρεση αγώνα..."
"DOTA_Friend_In_Match"	"Σε αγώνα"
"DOTA_Friend_Solo_Open_Party"	"Ο {s:player_name} αναζητεί παιχνίδι"
"DOTA_Friend_In_Party_Open"	"Ο {s:player_name} είναι σε ανοικτή παρέα"
"DOTA_Friend_Solo_Open_Party_Self"	"Αναζητείτε μέλη παρέας"
"DOTA_Friend_In_Open_Party_Self"	"Είστε σε μια ανοικτή παρέα"
"DOTA_Friends_In_Party_Open"	"{d:num_friends} φίλοι σε ανοικτή παρέα"
"DOTA_Friend_Lobby_Mode_Self"	"Είστε σε λόμπι {s:game_mode}"
"DOTA_Friend_Lobby_Mode_1_Friend"	"{s:player_name} σε λόμπι {s:game_mode}"
"DOTA_Friend_Lobby_Mode_N_Friends"	"{d:num_friends} φίλοι σε λόμπι {s:game_mode}"
"DOTA_Friend_Lobby_Mode_Small"	"Λόμπι {s:game_mode}"
"DOTA_Friend_Lobby_Players"	"{d:player_count} / {d:max_player_count}"
"DOTA_Friend_Lobby_Join_Button"	"{s:join_button_text}"
"DOTA_Friend_Lobby_Friend_Count"	"+{d:extra_friend_count}"
"DOTA_Friend_Invite_To_Party"	"Πρόσκληση σε παρέα"
"DOTA_Friend_SuggestInviteToParty"	"Πρόταση πρόσκλησης σε παρέα"
"DOTA_Request_Join_Party"	"Αίτημα σύνδεσης σε παρέα"
"DOTA_Request_Merge_Parties"	"Αίτημα συγχώνευσης παρεών"
"DOTA_Friend_PartyInvitePending"	"Εκκρεμής πρόσκληση παρέας"
"DOTA_Friend_PartyInvitePending_Leader"	"Εκκρεμής πρόσκληση παρέας<br/>Πατήστε για να την ακυρώσετε"
"DOTA_Friend_PartyMergeRequestPending"	"Εκκρεμές αίτημα συμμετοχής σε παρέα"
"DOTA_Friend_PartyMergeRequestPending_Leader"	"Εκκρεμές αίτημα συμμετοχής σε παρέα<br/>Πατήστε για να το ακυρώσετε"
"DOTA_Friend_JoinParty"	"Συμμετοχή σε παρέα"
"DOTA_Friend_Watch"	"Παρακολούθηση"
"DOTA_PartyVisTooltip_SoloTitleOpen"	"Αναζητεί παιχνίδι"
"DOTA_PartyMerge_Error_TOO_MANY_PLAYERS"	"Οι παρέες δεν μπορούν να ενωθούν επειδή υπάρχουν πάρα πολλοί παίκτες."
"DOTA_PartyMerge_Error_NO_SUCH_GROUP"	"Η παρέα δεν υπάρχει πλέον."
"DOTA_Feed_Timestamp_Recently"	"Μόλις τώρα"
"DOTA_Feed_Timestamp_MinutesAgo"	"{i:value} λεπτά πριν"
"DOTA_Feed_Timestamp_HourAgo"	"{i:value} ώρα πριν"
"DOTA_Feed_Timestamp_HoursAgo"	"{i:value} ώρες πριν"
"DOTA_Feed_Timestamp_Yesterday"	"Χθες"
"DOTA_Feed_Timestamp_Date"	"{s:day} {s:month}"
"dota_lobby_type_practice"	"Εξάσκηση"
"dota_lobby_type_practice_game_mode_custom"	"Προσαρμοσμένο παιχνίδι"
"dota_lobby_type_tournament"	"Παιχνίδι διοργάνωσης"
"dota_lobby_type_coop_bot"	"Παιχνίδι με Bot"
"dota_lobby_type_competitive"	"Παιχνίδι κατάταξης"
"dota_lobby_type_casual_1v1"	"Αγώνας 1v1"
"dota_lobby_unknown"	"Άγνωστο"
"DOTA_Lobby_No_Players_Title"	"ΔΕΝ ΥΠΑΡΧΟΥΝ ΠΑΙΚΤΕΣ ΣΕ ΜΙΑ ΟΜΑΔΑ."
"DOTA_Lobby_No_Players_Desc"	"Πρέπει να έχετε τουλάχιστον έναν παίκτη είτε στην ομάδα Radiant είτε στην ομάδα Dire."
"dota_match_result_won"	"Νίκη"
"dota_match_result_lost"	"Ήττα"
"dota_match_result_none"	";;;"
"dota_social_feed_loading"	"Φόρτωση..."
"DOTA_LoadingPlayerUnknown"	"-"
"DOTA_LoadingPlayerLoading"	"Φόρτωση..."
"DOTA_LoadingPlayerFullyConnected"	"Έτοιμος"
"DOTA_LoadingPlayerFailed"	"Αποτυχία"
"LoadingScreenTimer"	"{t:d:countdown_timer_seconds}"
"HeroSelectionTimer"	"{i:timer_seconds}"
"LoadingScreenMapInfo"	"Χάρτης: {s:map_name}"
"LoadingScreenPlayersInfo"	"Παίκτες: {i:players_loaded}/{i:players_total}"
"LoadingScreenSpectatorsInfo"	"Θεατές: {i:spectators_loaded}/{i:spectators_total}"
"custom_end_screen_victory_message"	"{s:winning_team_name} Νίκη!"
"custom_end_screen_legend_player"	"Παίκτης"
"custom_end_screen_legend_level"	"Επίπεδο"
"custom_end_screen_legend_hero"	"Ήρωας"
"custom_end_screen_legend_kills"	"Σ"
"custom_end_screen_legend_deaths"	"Θ"
"custom_end_screen_legend_assists"	"Β"
"custom_end_screen_legend_items"	"Αντικείμενα"
"custom_end_screen_legend_gold"	"Χρυσός"
"custom_end_screen_legend_team_score"	"Βαθμολογία"
"custom_scoreboard_hero_name_and_desc"	"{s:hero_name} Επίπεδο {i:hero_level}"
"CustomEndScreenClose"	"Κλείσιμο"
"DOTA_Armory_Category_Heroes"	"Ήρωες"
"DOTA_Armory_Category_Couriers"	"Μεταφορείς"
"DOTA_Armory_Category_World"	"Κόσμος"
"DOTA_Armory_Category_Wards"	"Ward"
"DOTA_Armory_Category_Interface"	"Διεπαφή"
"DOTA_Armory_Category_Emoticons"	"Emoticon"
"DOTA_Armory_Category_LoadingScreens"	"Εικόνες φόρτωσης"
"DOTA_Armory_Category_HUDs"	"HUD"
"DOTA_Armory_Category_CursorPacks"	"Πακέτα κερσόρων"
"DOTA_Armory_Category_Audio"	"Ήχος"
"DOTA_Armory_Category_AnnouncerPacks"	"Πακέτα εκφωνητή"
"DOTA_Armory_Category_Music"	"Μουσική"
"DOTA_Armory_Category_All"	"Όλα"
"DOTA_Armory_Category_Other"	"Άλλο"
"DOTA_Armory_Filter"	"Ρύθμιση φίλτρου"
"DOTA_Armory_SortBy"	"Ταξινόμηση ανά:"
"DOTA_Armory_SortBy_Rarity"	"Σπανιότητα"
"DOTA_Armory_SortBy_Quality"	"Ποιότητα"
"DOTA_Armory_SortBy_Name"	"Όνομα"
"DOTA_Armory_SortBy_Recent"	"Ημερομηνία απόκτησης"
"DOTA_Armory_SortBy_Sockets"	"Αριθμός υποδοχών"
"DOTA_Armory_Search"	"Αναζήτηση για αντικείμενα οπλοστασίου"
"DOTA_Armory_ContextMenu_Preview"	"Προεπισκόπηση αντικειμένου"
"DOTA_Armory_ContextMenu_PreviewSet"	"Προεπισκόπηση σετ"
"DOTA_Armory_ContextMenu_Equip"	"Εξόπλιση"
"DOTA_Armory_ContextMenu_Unequip"	"Αφαίρεση"
"DOTA_Armory_ContextMenu_Socketing"	"Υποδοχές"
"DOTA_Armory_ContextMenu_Delete"	"Διαγραφή"
"dota_page_match_details_loading"	"Φόρτωση παιχνιδιού..."
"dota_page_match_details_victory"	"Νικητής: {s:winner}"
"dota_page_match_details_legend_player"	"Παίκτης"
"dota_page_match_details_legend_level"	"Επίπεδο"
"dota_page_match_details_legend_hero"	"Ήρωας"
"dota_page_match_details_legend_kills"	"Σ"
"dota_page_match_details_legend_deaths"	"Θ"
"dota_page_match_details_legend_assists"	"Β"
"dota_page_match_details_legend_items"	"Αντικείμενα"
"dota_page_match_details_legend_gold"	"Χρυσός"
"dota_page_match_details_legend_gold_per_min"	"Χ/Λ"
"dota_page_match_details_legend_xp_per_min"	"Ε/Λ"
"dota_page_match_details_legend_winner_tooltip"	"Νικητήρια ομάδα"
"dota_page_match_details_legend_kills_tooltip"	"Σκοτωμοί"
"dota_page_match_details_legend_deaths_tooltip"	"Θάνατοι"
"dota_page_match_details_legend_assists_tooltip"	"Βοήθειες"
"dota_page_match_details_legend_last_hits_tooltip"	"Τελικές επιθέσεις μονάδων"
"dota_page_match_details_legend_denies_tooltip"	"Αρνήσεις μονάδων"
"dota_page_match_details_legend_gold_per_min_tooltip"	"Χρυσός ανά λεπτό"
"dota_page_match_details_legend_xp_per_min_tooltip"	"Εμπειρία ανά λεπτό"
"dota_page_match_details_header_league_name"	"Όνομα πρωταθλήματος"
"dota_page_match_details_header_custom_game_map_name"	"Όνομα χάρτη"
"dota_page_match_details_header_match_id"	"ID ΑΓΩΝΑ"
"dota_page_match_details_header_game_mode"	"ΤΥΠΟΣ"
"dota_page_match_details_header_duration"	"ΔΙΑΡΚΕΙΑ"
"dota_page_match_details_header_timestamp"	"ΗΜΕΡΟΜΗΝΙΑ / ΩΡΑ ΑΓΩΝΑ"
"dota_page_match_details_voting_votes"	"{i:num_votes} ψήφοι"
"dota_page_match_details_match_discussion"	"Συζήτηση αγώνα"
"dota_page_match_details_comment_placeholder"	"Γράψτε ένα σχόλιο..."
"dota_page_match_details_comment_loading_comments"	"Φόρτωση σχολίων..."
"dota_page_match_details_comment_no_comments"	"Δεν έχουν αναρτηθεί σχόλια για αυτόν τον αγώνα"
"dota_page_match_details_replay_existence_unknown"	"Αναζήτηση για επανάληψη..."
"dota_page_match_details_replay_existence_cdn_found"	"Λήψη επανάληψης"
"dota_page_match_details_replay_existence_not_found"	"Επανάληψη μη διαθέσιμη"
"dota_page_match_details_replay_existence_downloading"	"Γίνεται λήψη..."
"dota_page_match_details_replay_existence_disk_found_replay"	"Παρακολούθηση επανάληψης"
"dota_page_match_details_replay_existence_disk_found_highlights"	"Παρακολούθηση στιγμιοτύπων"
"dota_profile_content_tab_activity_feed"	"Δραστηριότητα"
"dota_profile_content_tab_recent_games"	"Πρόσφατα παιχνίδια"
"dota_profile_recent_games_option_show_practice_matches"	"Προβολή αγώνων εξάσκησής μου"
"dota_profile_recent_game_header_timestamp"	"ΗΜΕΡΟΜΗΝΙΑ / ΩΡΑ"
"dota_profile_recent_game_header_hero_name"	"ΗΡΩΑΣ"
"dota_profile_recent_game_header_result"	"ΑΠΟΤΕΛΕΣΜΑ"
"dota_profile_recent_game_header_duration"	"Διάρκεια"
"dota_profile_recent_game_header_type"	"ΤΥΠΟΣ"
"dota_profile_recent_game_result_win"	"Νίκη"
"dota_profile_recent_game_result_loss"	"Ήττα"
"dota_profile_recent_game_result_abandon"	"Εγκατάλειψη"
"dota_profile_recent_game_icon_source1"	"S1"
"dota_profile_hero_with_index"	"{d:hero_index} {s:hero_name}"
"dota_profile_hero"	"{s:hero_name}"
"dota_replay_manager_error_not_found"	"Δεν ήταν δυνατή η εύρεση της επανάληψης στο CDN."
"dota_replay_manager_error_disk_full"	"Αδυναμία δέσμευσης χώρου για το αρχείο επανάληψης."
"dota_replay_manager_error_chunk_failed"	"Αδυναμία λήψης αρχείου επανάληψης."
"dota_replay_manager_error_partial_compressed_open_failure"	"Αδυναμία ανοίγματος συμπιεσμένου αρχείου επανάληψης."
"dota_replay_manager_error_partial_decompressed_open_failure"	"Αδυναμία ανοίγματος αποσυμπιεσμένου αρχείου επανάληψης."
"dota_page_match_details_replay_error_not_found"	"Η επανάληψη δε βρέθηκε στο δίσκο."
"DOTA_tooltip_econ_item_name"	"{s:item_name}"
"DOTA_tooltip_econ_item_description"	"{s:item_description}"
"DOTA_tooltip_econ_item_set"	"Μέρος του: <font color='#dddddd'>{s:item_set}</font>"
"DOTA_tooltip_econ_item_rarity_label"	"Σπανιότητα: "
"DOTA_tooltip_econ_item_rarity"	"{s:item_rarity}"
"DOTA_tooltip_econ_item_slot"	"Υποδοχή: {s:item_slot}"
"DOTA_tooltip_econ_item_gifter"	"{g:dota_persona:gifter_name}"
"DOTA_tooltip_econ_item_trade_restriction_permanent"	"Μη ανταλλάξιμο"
"DOTA_tooltip_econ_item_trade_restriction_date"	"Μη ανταλλάξιμο μέχρι: {t:T:tradable_after_date_time} {t:s:tradable_after_date_time}"
"DOTA_tooltip_econ_item_market_restriction_permanent"	"Μη εμπορεύσιμο"
"DOTA_tooltip_econ_item_gem_type"	"{s:gem_type}"
"DOTA_tooltip_econ_item_gem_strange_count"	"{d:strange_count}"
"DOTA_tooltip_econ_item_gem_description"	"{s:gem_description}"
"DOTA_tooltip_econ_item_partner"	"{s:partner}"
"DOTA_econ_item_details_item_name"	"{s:item_name}"
"DOTA_econ_item_details_item_creation_date"	"ΗΜΕΡΟΜΗΝΙΑ ΔΗΜΙΟΥΡΓΙΑΣ: {t:l:creation_date}"
"DOTA_econ_item_details_set_includes"	"Περιλαμβάνει τα ακόλουθα:"
"DOTA_econ_item_details_item_set"	"Μέρος του: <font color='#dddddd'>{s:item_set}</font>"
"DOTA_econ_item_details_rarity_label"	"Σπανιότητα: "
"DOTA_econ_item_details_item_rarity"	"{s:item_rarity}"
"DOTA_econ_item_details_item_slot"	"Υποδοχή: {s:item_slot}"
"DOTA_econ_item_details_item_description"	"{s:item_description}"
"DOTA_econ_item_details_gem_type"	"{s:gem_type}"
"DOTA_econ_item_details_gem_strange_count"	"{d:strange_count}"
"DOTA_econ_item_details_gem_description"	"{s:gem_description}"
"DOTA_Treasure_Name"	"{s:treasure_name}"
"DOTA_Treasure_Rarity"	"<span class=\"ItemRarityColor\">{s:treasure_rarity}</span> Θησαυρός"
"custom_game_team_select"	"Επιλογή ομάδας"
"custom_game_team_select_timer"	"{i:countdown_timer_seconds}"
"custom_game_team_select_shuffle"	"Ανακάτεμα"
"custom_game_team_select_auto_start"	"Αυτόματη εκκίνηση"
"custom_game_team_select_starting"	"Εκκίνηση"
"custom_game_team_select_unassigned_players"	"Παίκτες χωρίς ομάδα"
"custom_game_team_select_lock_start"	"Κλείδωμα + Εκκίνηση"
"custom_game_team_select_cancel_unlock"	"Ακύρωση + Ξεκλείδωμα"
"custom_game_team_select_join"	"Σύνδεση"
"custom_game_team_select_empty_slot"	"Κενή θέση"
"custom_game_team_select_auto_assign"	"Αυτόματη ανάθεση"
"CouldntFindCompendium"	"Αδύνατη η φόρτωση του δοκιμαστικού αρχείου του compendium: %s1"
"CompendiumPageError_Pages"	"Αδύνατη η εύρεση ενός πεδίου «pages» στο αρχείο δεδομένων του compendium."
"CompendiumPageError_Template"	"Αδυναμία εύρεσης καταχώρησης «template» για τη σελίδα «%s1» του compendium (αριθμός σελίδας %s2)"
"CompendiumPageError_Template2"	"Αδυναμία εύρεσης της καταχώρησης «%s1» στη σελίδα «%s2» του compendium"
"CompendiumPageError_Image"	"Αδυναμία εύρεσης της εικόνας «%s1» στη σελίδα «%s2» του compendium"
"CompendiumPageError_Text"	"Αδυναμία εύρεσης πεδίου κειμένου «%s1» στη σελίδα «%s2» του compendium"
"CompendiumPageError_Video"	"Αδυναμία εύρεσης του βίντεο «%s1» στη σελίδα «%s2» του compendium"
"CompendiumPageError_Scrollbar"	"Αδυναμία εύρεσης γραμμής κύλισης «%s1» στη σελίδα «%s2» του compendium"
"CompendiumPageError_Selection"	"Αδυναμία εύρεσης της επιλογής «%s1» στη σελίδα «%s2» του compendium"
"CompendiumPageError_PageNames"	"Η ενσωματωμένη σελίδα «%s1» χρησιμοποιεί το ίδιο όνομα όπως μια άλλη σελίδα. Τα ονόματα των σελίδων πρέπει να είναι μοναδικά."
"CompendiumPageError_CustomText"	"Σφάλμα στο προσαρμοσμένο πεδίο κειμένου «%s1» στη σελίδα «%s2» του Compendium"
"CompendiumPageError_CustomImg"	"Σφάλμα στο πεδίο προσαρμοσμένης εικόνας «%s1»"
"CompendiumPageError_CustomBar"	"Σφάλμα στο πεδίο προσαρμοσμένης μπάρας προόδου «%s1» στη σελίδα «%s2» του Compendium"
"CompendiumPageError_CustomEle"	"Αποτυχία δημιουργίας στιγμιότυπου προσαρμοσμένου στοιχείου «%s1» στη σελίδα «%s2» του Compendium"
"CompendiumPageError_CTFont"	"Μη έγκυρη γραμματοσειρά «%s1» καθορίστηκε στη σελίδα «%s2» του Compendium. Έγκυρες γραμματοσειρές:\\\ntext, textbold, title"
"CompendiumPageError_CTAlign"	"Μη έγκυρη στοίχιση «%s1» στη σελίδα «%s2» του Compendium. Έγκυρες στοιχίσεις:\\\n left, right, center"
"CompendiumPageError_CTDepth"	"Μη έγκυρο βάθος «%s1». Έγκυρα βάθη:\\\n front, back"
"CompendiumPageError_LinePos"	"Η γραμμή «%s1» δεν έχει και τις δύο θέσεις «start» και «end»."
"CompendiumPageError_CTPoints"	"Μη έγκυρη ένδειξη επιλογής «%s1» στο τμήμα «points» του προσαρμοσμένου κειμένου «%s2»."
"CompendiumPageError_CTPoints2"	"Μη έγκυρη ένδειξη επιλογής «%s1» στο τμήμα «points» του προσαρμοσμένου κειμένου «%s2». Δε βρέθηκε επιλογή με αυτή την ένδειξη."
"CompendiumPageError_SelDesc"	"Αδυναμία εύρεσης κλειδιού «description» για την επιλογή «%s1» στη σελίδα «%s2» του compendium"
"CompendiumPageError_Points"	"Ελλιπή (ή κανένα) «points» ορίστηκαν για την επιλογή «%s1» στη σελίδα «%s2» του Compendium"
"CompendiumPageError_SelType"	"Έλλειψη «choice_type» για την επιλογή  «%s1» στη σελίδα «%s2» του compendium"
"CompendiumPageError_BarType"	"Έλλειψη «data» για την μπάρα προόδου «%s1» στη σελίδα «%s2» του Compendium"
"CompendiumPageError_NoTime"	"Ελλιπές ή μη έγκυρο «time» καθορίστηκε για την επιλογή «%s1» στο «%s2»"
"CompendiumPageError_ElementType"	"Ελλιπές ή μη έγκυρο «elementtype» για το στοιχείο «%s1» στη σελίδα «%s2» του compendium"
"CompendiumPageError_SelTimer"	"Άγνωστο χρονόμετρο με όνομα «%s1» στη σελίδα «%s2» του compendium"
"CompendiumPageError_BadElement"	"Άγνωστο στοιχείο SF με όνομα «%s1» στη σελίδα «%s2» του compendium"
"CompendiumPageError_SelNoTimer"	"Δε βρέθηκαν χρονόμετρα στη σελίδα του compendium «%s1» (έχει επιλογές, οι οποίες απαιτούν ένα χρονόμετρο)"
"CompendiumPageError_SelUnknown"	"Μη έγκυρο «choice_type» του «%s1» για την επιλογή «%s2»"
"CompendiumPageError_BarUnknown"	"Μη έγκυρο «data» της «%s1» για την επιλογή «%s2»"
"CompendiumPageError_InvalidEquation"	"Καθορίστηκε μια μη έγκυρη εξίσωση: «%s1» για «%s2»"
"CompendiumPageError_SelChoices"	"Ελλιπές πεδίο «choices» για την επιλογή «%s1» στη σελίδα «%s2» του Compendium"
"CompendiumPageError_NoHero"	"Αδυναμία εύρεσης ήρωα με ID «%s1» για την επιλογή «%s2»"
"CompendiumPageError_Unknown"	"Εσωτερικό λογικό σφάλμα compendium. Επικοινωνήστε με την Valve για επίλυση."
"CompendiumPageError_ImageDL"	"Αποτυχία εκκίνησης λήψης εικόνας compendium «%s1» (%s2)"
"CompendiumPageError_ImageDLErr"	"Αποτυχία λήψης εικόνας compendium «%s» (%s2)"
"CompendiumPageError_BtnNoElem"	"Δε βρέθηκε πεδίο «selection_elements» για το κουμπί «%s1» στη σελίδα «%s2» του Compendium"
"CompendiumPageError_BtnBadVal"	"Η τιμή της επιλογής «%s1» στο κουμπί «%s2» δεν είναι στη λίστα επιλογών για εκείνη την ένδειξη επιλογής"
"CompendiumPageError_BtnBadSel"	"Η ρύθμιση «selection_force_to» στο στοιχείο «%s1» δεν είναι στη λίστα επιλογών για την επιλογή «%s2»"
"CompendiumPageError_BtnSelIdx"	"Το κουμπί «%s1» στη σελίδα του Compendium «%s2» λείπει ή μη έγκυρη «selection_index»"
"CompendiumPageError_CmdSelIdx"	"Το στοιχείο «%s1» στη σελίδα %s2 του Compendium έχει ελλιπή ή μη έγκυρη εντολή «selection_index» ή «force_selection_index»"
"CompendiumPageError_ImgSelIdx"	"Μη έγκυρο «selection_index» του «%s1» στην εικόνα «%s2»."
"CompendiumPageError_ImgShowSelIdx"	"Μη έγκυρο «show_selection_index» του «%s1» στην εικόνα «%s2»."
"CompendiumPageError_ImgSelVal"	"Μη έγκυρη επιλογή «%s1» στο τμήμα «show_selection_images» της εικόνας «%s2»."
"CompendiumPageError_ImgBadStyle"	"Λάθος μορφή εικόνας «%s1» για την εικόνα «%s2»."
"CompendiumPageError_DynTxtSel"	"Το κείμενο «%s1» στη σελίδα «%s2» περιέχει μη έγκυρη % selection_X %. Καμία προκαταγεγραμμένη επιλογή με αυτή την ένδειξη."
"CompendiumPageError_NoTxtList"	"Αδυναμία εύρεσης λίστας κειμένου «%s1» στη σελίδα «%s2» του compendium"
"CompendiumPageError_TOCPage"	"Η σελίδα table_of_contents_page «%s1» δεν υπάρχει."
"CompendiumPageError_SelIndex"	"Η επιλογή «%s1» στη σελίδα «%s2» του compendium έχει ελλιπές ή μη έγκυρο «selection_index»"
"CompendiumPageError_SelUsed"	"Η επιλογή «%s1» στη σελίδα «%s2» του Compendium δεν έχει μοναδικό «selection_index»"
"CompendiumPageError_SelVal"	"Η επιλογή «%s1» στη σελίδα «%s2» του Compendium έχει επιλογές με τις ίδιες τιμές"
"CompendiumPageError_SelValInv"	"Η επιλογή «%s1» στη σελίδα «%s2» του Compendium έχει μια επιλογή με τιμή <= 0. Οι τιμές των επιλογών πρέπει να είναι μεγαλύτερες του 0."
"CompendiumPageError_SelTTVal"	"Η επιλογή «%s1» στη σελίδα «%s2» του Compendium έχει μια εγγραφή tooltip_data με μία τιμή που δεν υπάρχει στη λίστα επιλογών της."
"CompendiumPageError_NoAnswer"	"Η επιλογή «%s1» στη σελίδα «%s2» του Compendium δεν έχει κανένα κλειδί «απάντησης» ή «απαντήσεων» στο πεδίο «αποτέλεσμα»"
"CompendiumPageError_MissAnswer"	"Η επιλογή «%s1» στη σελίδα «%s2» του Compendium έχει ένα κλειδί «απάντησης» ή «απαντήσεων» που δεν ταιριάζει με οποιαδήποτε από τις επιλογές του"
"CompendiumPageError_Timer"	"Το χρονόμετρο «%s1» έχει μη έγκυρο χρόνο συστήματος"
"CompendiumPageError_UnknownAction"	"Το αντικείμενο «%s1» αναφέρεται στην άγνωστη δράση «%s2»"
"CompendiumPageError_SameElement"	"Το σύστημα ορατότητας εντόπισε πολλαπλά στοιχεία με όνομα «%s1» στη σελίδα «%s2»"
"CompendiumPageError_DupeKey"	"Η σειρά με τις τιμές-κλειδιά «%s1» περιέχει πολλαπλά κλειδιά του ίδιου ονόματος «%s2»."
"CompendiumError_Template"	"Αδυναμία εύρεσης προτύπου με όνομα «%s1»"
"CompendiumError_DupeTemplate"	"Βρέθηκαν πολλαπλά πρότυπα με όνομα «%s1»"
"CompendiumError_NoDefines"	"Πρότυπο «%s1» απαιτεί ορισμούς, αλλά η ένδειξη «%s2» από αυτό δεν έχει μια σειρά «ορισμών»."
"CompendiumError_MissingDef"	"Το παραγόμενο στιγμιότυπο «%s1» δεν περιέχει ορισμό «%s2», αλλά το πρότυπο από το οποίο παράγεται τον απαιτεί."
"CompendiumError_BadDef"	"Η προερχόμενη ένδειξη «%s1» περιέχει έναν απαιτούμενο ορισμό ονόματι «%s2» που δεν ξεκινάει με «%def» που απαιτείται."
"CompendiumError_FailedXMLWrite"	"Αδυναμία εγγραφής XML για τη σελίδα «{s:s1}» στο αρχείο «{s:s2}»."
"CompendiumError_FailedCSSWrite"	"Αδυναμία εγγραφής CSS για τη σελίδα «{s:s1}» στο αρχείο «{s:s2}»."
"DOTA_GlobalItems_Companions"	"Σύντροφοι"
"DOTA_GlobalItems_Couriers"	"Μεταφορείς"
"DOTA_GlobalItems_Pets"	"Κατοικίδια"
"DOTA_GlobalItems_World"	"Κόσμος"
"DOTA_GlobalItems_Wards"	"Ward"
"DOTA_GlobalItems_Effigies"	"Αγάλματα"
"DOTA_GlobalItems_Weather"	"Εφέ καιρού"
"DOTA_GlobalItems_Interface"	"Διεπαφή"
"DOTA_GlobalItems_Emoticons"	"Emoticon"
"DOTA_GlobalItems_LoadingScreens"	"Εικόνες φόρτωσης"
"DOTA_GlobalItems_HUDs"	"HUD"
"DOTA_GlobalItems_Audio"	"Ήχος"
"DOTA_GlobalItems_Announcers"	"Πακέτα εκφωνητή"
"DOTA_GlobalItems_Music"	"Μουσική"
"DOTA_Search"	"Αναζήτηση"
"DOTA_Start"	"Εκκίνηση"
"DOTA_PleaseWait"	"Περιμένετε..."
"dota_lobby_swap_teams"	"Εναλλαγή ομάδων"
"dota_lobby_settings_edit"	"Επεξεργασία"
"DOTA_Custom_Game_Browse_All"	"Περιήγηση σε όλα τα παιχνίδια"
"DOTA_Custom_Game_Friends_Ready"	"Φίλοι έτοιμοι για παιχνίδι"
"DOTA_Custom_Game_Friends_Who_Play"	"Φίλοι που παίζουν"
"DOTA_Custom_Game_Friends_Playing_Now"	"Φίλοι σε παιχνίδι τώρα"
"DOTA_Custom_Game_Browse_Sort"	"Ταξινόμηση:"
"DOTA_Custom_Game_Sort_Popular_Today"	"Κορυφαία βαθμολογία (σήμερα)"
"DOTA_Custom_Game_Sort_Popular_Week"	"Κορυφαία βαθμολογία (αυτή την εβδομάδα)"
"DOTA_Custom_Game_Sort_Top_Rated"	"Κορυφαία βαθμολογία (όλων των εποχών)"
"DOTA_Custom_Game_Sort_Date"	"Ημερομηνία κυκλοφορίας"
"DOTA_WatchLive_WatchLabel"	"ΠΑΡΑΚΟΛΟΥΘΗΣΗ:"
"DOTA_WatchLive_Steam"	"STEAM"
"DOTA_WatchLive_InGame"	"ΣΕ ΠΑΙΧΝΙΔΙ"
"DOTA_WatchLive_Broadcaster0"	"Παρακολούθηση {g:dota_persona:b:broadcaster_account_id_0}"
"DOTA_WatchLive_Broadcaster1"	"Παρακολούθηση {g:dota_persona:b:broadcaster_account_id_1}"
"DOTA_WatchLive_Broadcaster2"	"Παρακολούθηση {g:dota_persona:b:broadcaster_account_id_2}"
"DOTA_WatchLive_Broadcaster3"	"Παρακολούθηση {g:dota_persona:b:broadcaster_account_id_3}"
"DOTA_WatchLive_Broadcaster4"	"Παρακολούθηση {g:dota_persona:b:broadcaster_account_id_4}"
"DOTA_WatchLive_Broadcaster5"	"Παρακολούθηση {g:dota_persona:b:broadcaster_account_id_5}"
"DOTA_WatchLive_Broadcaster6"	"Παρακολούθηση {g:dota_persona:b:broadcaster_account_id_6}"
"DOTA_WatchLive_Broadcaster7"	"Παρακολούθηση {g:dota_persona:b:broadcaster_account_id_7}"
"DOTA_WatchLive_Broadcaster8"	"Παρακολούθηση {g:dota_persona:b:broadcaster_account_id_8}"
"DOTA_WatchLive_Broadcaster9"	"Παρακολούθηση {g:dota_persona:b:broadcaster_account_id_9}"
"dota_play_lobby_games"	"Λόμπι παιχνιδιών"
"dota_play_connecting_to_server"	"Σύνδεση..."
"dota_reconnecting"	"Επανασύνδεση..."
"dota_matchmaking_regions_retry"	"Επανάληψη"
"dota_matchmaking_region_ping_calculating"	"Ping: Υπολογισμός..."
"dota_matchmaking_region_ping_failed"	"Ping: ΑΠΟΤΥΧΙΑ"
"dota_matchmaking_region_or"	"Ή"
"dota_matchmaking_region_check_internet"	"Ελέγξτε τη σύνδεσή σας στο διαδίκτυο."
"dota_settings_fullscreenbrightness"	"Φωτεινότητα"
"dota_lobby_browser_header_name"	"ΟΝΟΜΑ ΛΟΜΠΙ"
"dota_lobby_browser_header_game_mode"	"ΤΥΠΟΣ ΠΑΙΧΝΙΔΙΟΥ"
"dota_lobby_browser_region"	"Περιοχή"
"dota_lobby_browser_lobby_name"	"Όνομα λόμπι"
"DOTA_Friend_Game_Mode_Self"	"Είστε σε ένα παιχνίδι {s:game_mode}"
"DOTA_Friend_Game_Mode_1_Friend"	"Ο {s:player_name} παίζει {s:game_mode}"
"DOTA_Friend_Game_Mode_N_Friends"	"{d:num_friends} φίλοι παίζουν {s:game_mode}"
"CompendiumError_XMLLoadFail"	"Αποτυχία φόρτωσης XML για τη σελίδα «{s:s1}» στο αρχείο «{s:s2}»."
"CompendiumError_XMLParseFail"	"Αποτυχία μεταγλώττισης XML για τη σελίδα «{s:s1}» στο αρχείο «{s:s2}»."
"Compendium_DefaultText_TimerTitle_Active"	"ΟΙ ΕΠΙΛΟΓΕΣ ΛΗΓΟΥΝ ΣΕ"
"Compendium_DefaultText_TimerTitle_Expired"	"ΟΙ ΕΠΙΛΟΓΕΣ ΕΛΗΞΑΝ"
"Compendium_DefaultText_CD_Days"	"Ημέρες"
"Compendium_DefaultText_CD_Hours"	"Ώρες"
"Compendium_DefaultText_CD_Minutes"	"Λεπτά"
"Compendium_DefaultText_CD_Seconds"	"Δευτερόλεπτα"
"NetGraph_FPS"	"fps: {d:fps}"
"NetGraph_Ping"	"ping: {d:ping}ms"
"NetGraph_Loss"	"ήττες: {d:loss}%"
"DOTA_Credits"	"Ευχαριστίες"
"DOTA_ActorCredits_1_Name"	"Dee Bradley Baker"
"DOTA_ActorCredits_1_Heroes"	"Τechies"
"DOTA_ActorCredits_2_Name"	"Dennis Bateman"
"DOTA_ActorCredits_2_Heroes"	"Ιnvoker"
"DOTA_ActorCredits_3_Name"	"Tom Chantler"
"DOTA_ActorCredits_3_Heroes"	"Centaur, Lion, Obsidian Destroyer, Riki, Slark, Tusk, Witch Doctor"
"DOTA_ActorCredits_4_Name"	"Merle Dandridge"
"DOTA_ActorCredits_4_Heroes"	"Legion Commander, Winter Wyvern"
"DOTA_ActorCredits_5_Name"	"Barry Dennen"
"DOTA_ActorCredits_5_Heroes"	"Chaos Knight, Phantom Lancer, Rubick"
"DOTA_ActorCredits_6_Name"	"Dave Fennoy"
"DOTA_ActorCredits_6_Heroes"	"Batrider, Ember Spirit, Faceless Void, Jakiro, Venomancer, Wraith King"
"DOTA_ActorCredits_7_Name"	"Jim French"
"DOTA_ActorCredits_7_Heroes"	"Elder Titan"
"DOTA_ActorCredits_8_Name"	"Michael Gregory"
"DOTA_ActorCredits_8_Heroes"	"Bounty Hunter, Clinkz, Silencer"
"DOTA_ActorCredits_9_Name"	"Gin Hammond"
"DOTA_ActorCredits_9_Heroes"	"Crystal Maiden, Drow Ranger, Enchantress, Mirana, Phantom Assassin, Spectre, Vengeful Spirit"
"DOTA_ActorCredits_10_Name"	"John Patrick Lowrie"
"DOTA_ActorCredits_10_Heroes"	"Ancient Apparition, Dark Seer, Doom, Earthshaker, Pudge, Shadow Fiend, Storm Spirit"
"DOTA_ActorCredits_11_Name"	"Ellen McLain"
"DOTA_ActorCredits_11_Heroes"	"Broodmother, Death Prophet"
"DOTA_ActorCredits_12_Name"	"Bruce Miles"
"DOTA_ActorCredits_12_Heroes"	"Alchemist, Lifestealer, Omniknight"
"DOTA_ActorCredits_13_Name"	"Linda K. Morris"
"DOTA_ActorCredits_13_Heroes"	"Luna, Naga Siren, Queen of Pain, Templar Assassin"
"DOTA_ActorCredits_13_Extra"	"Εκφωνητής"
"DOTA_ActorCredits_14_Name"	"Sam A. Mowry"
"DOTA_ActorCredits_14_Heroes"	"Anti-Mage, Beastmaster, Clockwerk, Necrophos, Slardar, Warlock"
"DOTA_ActorCredits_15_Name"	"Eric Newsome"
"DOTA_ActorCredits_15_Heroes"	"Chen, Leshrac, Nature's Prophet, Razor, Tidehunter, Tiny, Zeus"
"DOTA_ActorCredits_16_Name"	"Nolan North"
"DOTA_ActorCredits_16_Heroes"	"Brewmaster, Earth Spirit, Gyrocopter, Keeper of the Light, Lone Druid, Lycan, Meepo, Ogre Magi, Shadow Demon, Troll Warlord"
"DOTA_ActorCredits_17_Name"	"Dempsey Pappion"
"DOTA_ActorCredits_17_Heroes"	"Magnus, Nyx Assassin, Visage"
"DOTA_ActorCredits_18_Name"	"TJ Ramini"
"DOTA_ActorCredits_18_Heroes"	"Abaddon, Bristleback, Skywrath Mage, Timbersaw"
"DOTA_ActorCredits_19_Name"	"Harry S. Robins"
"DOTA_ActorCredits_19_Heroes"	"Tinker"
"DOTA_ActorCredits_20_Name"	"Gary Schwartz"
"DOTA_ActorCredits_20_Heroes"	"Lich, Pugna"
"DOTA_ActorCredits_21_Name"	"David Scully"
"DOTA_ActorCredits_21_Heroes"	"Bane, Dazzle, Juggernaut, Morphling, Sand King, Sven, Weaver"
"DOTA_ActorCredits_22_Name"	"Mike Shapiro"
"DOTA_ActorCredits_22_Heroes"	"Oracle"
"DOTA_ActorCredits_23_Name"	"David Sobolov"
"DOTA_ActorCredits_23_Heroes"	"Terrorblade"
"DOTA_ActorCredits_24_Name"	"Jon St. John"
"DOTA_ActorCredits_24_Heroes"	"Axe, Bloodseeker, Enigma, Kunkka"
"DOTA_ActorCredits_25_Name"	"Fred Tatasciore"
"DOTA_ActorCredits_25_Heroes"	"Disruptor, Spirit Breaker, Treant Protector, Undying, Ursa"
"DOTA_ActorCredits_25_Extra"	"Warlock's Golem"
"DOTA_ActorCredits_26_Name"	"Jen Taylor"
"DOTA_ActorCredits_26_Heroes"	"Lina, Medusa, Puck, Windranger"
"DOTA_ActorCredits_27_Name"	"Tony Todd"
"DOTA_ActorCredits_27_Heroes"	"Dragon Knight, Night Stalker, Viper"
"DOTA_ActorCredits_28_Name"	" "
"DOTA_ActorCredits_28_Heroes"	" "
"DOTA_PlayerContextMenu_Trade"	"Πρόσκληση σε ανταλλαγή"
"DOTA_Custom_Game_Finished_Vote_Title"	"Ψήφος προσαρμοσμένου παιχνιδιού"
"DOTA_Custom_Game_Finished_Vote_Question"	"Τι πιστεύετε για αυτό το προσαρμοσμένο παιχνίδι;"
"DOTA_Custom_Game_Finished_Vote_Skip"	"Παράλειψη"
"DOTA_TabName_ModsLobbyList"	"Λίστα λόμπι"
"DOTA_WatchLive_Fullscreen"	"ΠΛΗΡΗΣ ΟΘΟΝΗ"
"DOTA_JoinChatChannel_ChannelName"	"Όνομα καναλιού"
"DOTA_JoinChatChannel_ChannelMemberCount"	"Μέλη"
"DOTA_Chat_ChannelMemberCount"	"{d:channel_member_count}"
"DOTA_Trading_UI_Body_Outgoing"	"Αναμονή για απάντηση του {s:player_name} στην πρόσκλησή σας..."
"DOTA_GiftWrap_Item"	"Περιτύλιγμα δώρου {g:dota_item_name:gift_item_def}."
"DOTA_GiftWrap_ConfirmDedication_Title"	"Επιβεβαίωση αφιέρωσης"
"DOTA_GiftWrap_ConfirmDedication_Message"	"Σίγουρα επιθυμείτε να αφιερώσετε το δώρο ως «{s:gift_dedication}»;"
"DOTA_GiftWrap_Success_Header"	"Επιτυχία"
"DOTA_GiftWrap_Success"	"Το δώρο σας παραδόθηκε."
"dota_settings_about"	"Σχετικά"
"DOTA_EquippedItem_AddToShuffle"	"Προσθήκη στο ανακάτεμα"
"DOTA_EquippedItem_RemoveFromShuffle"	"Αφαίρεση από ανακάτεμα"
"DOTA_EquippedItem_Unpack_And_AddToShuffle"	"Άνοιγμα και προσθήκη στο ανακάτεμα"
"DOTA_ClientVersion"	"Έκδοση: <span class=\"VersionNumber\">{d:client_version_number}</span>"
"DOTA_GameplayVersion"	"Έκδοση παιχνιδιού: <span class=\"VersionNumber\">{s:gameplay_version_number}</span>"
"DOTA_CurrentGameplayVersion"	"6.84c"
"DOTA_Credits_LindaKMorris_Extra"	"Εκφωνητής"
"DOTA_Recycling"	"ΑΝΑΚΥΚΛΩΣΗ"
"DOTA_Recycling_Action"	"ΑΝΑΚΥΚΛΩΣΗ"
"DOTA_Recycling_DragItems"	"Σύρετε ανεπιθύμητα αντικείμενα εδώ"
"DOTA_Recycling_Outputs"	"Θα λάβετε"
"DOTA_Recycling_Confirm"	"Σίγουρα επιθυμείτε να ανακυκλώσετε αυτά τα αντικείμενα;"
"DOTA_RecyclingCharm_Name"	"Charm of the Crucible Jewel II"
"DOTA_RecyclingCharm_Bonus"	"+25 νομίσματα Compendium"
"DOTA_Previous"	"Προηγούμενο"
"DOTA_PreviousShort"	"Προηγ"
"DOTA_Next"	"Επόμενο"
"DOTA_Friends_Add_Friend_Tooltip"	"Προσθήκη φίλου"
"DOTA_Friends_Add_Friend_Your_ID"	"Το ID φίλου σας είναι:"
"DOTA_Armory_ActiveFilter"	"{s:filter_field} {s:filter_op} {s:filter_value}"
"DOTA_Treasure_Purchase"	"Αγορά θησαυρού"
"DOTA_Treasure_SearchPlaceholder"	"Αναζήτηση για θησαυρούς"
"DOTA_Treasure_ViewAll"	"Προβολή όλων των θησαυρών"
"DOTA_Treasure_QuantityOption"	"Ποσότητα: {d:quantity}"
"DOTA_Treasure_Gift"	"Δώρο"
"DOTA_Treasure_OpenQuantity"	"{d:owned_quantity}"
"DOTA_Treasure_Autographed"	"Αυτόγραφο:"
"DOTA_Treasure_AutographName"	"{s:treasure_autograph_name}"
"DOTA_OpenTreasureTooltip_NormalTitle"	"Περιέχει τα ακόλουθα αντικείμενα:"
"DOTA_OpenTreasureTooltip_RareTitle"	"Με μια πιθανότητα να λάβετε επιπλέον αντικείμενα"
"DOTA_OpenTreasureTooltip_UnitName"	"{g:dota_item_unit_name:item_def}"
"DOTA_OpenTreasureTooltip_ItemName"	" - {g:dota_item_name:item_def}"
"dota_profile_oi_player_name"	"ΠΡΟΒΟΛΗ ΟΝΟΜΑΤΟΣ"
"dota_profile_oi_team"	"ΟΜΑΔΑ"
"dota_profile_oi_sponsor"	"ΧΟΡΗΓΟΣ"
"dota_profile_oi_country"	"ΧΩΡΑ"
"dota_profile_oi_role"	"ΡΟΛΟΣ"
"dota_profile_oi_submit_info"	"Υποβολή πληροφοριών"
"dota_profile_oi_submit_pending"	"Γίνεται υποβολή..."
"dota_profile_oi_submit_success"	"Επιτυχία!"
"dota_profile_oi_submit_failure"	"Σφάλμα - Παρακαλούμε προσπαθήστε ξανά."
"dota_role_core"	"Core"
"dota_role_support"	"Υποστήριξη"
"DOTA_Treasure"	"Θησαυρός"
"DOTA_Blog"	"Νέο στο Dota 2"
"DOTA_BadgeLevel"	"{d:badge_level}"
"DOTA_AHC_CurrentHero"	"Τρέχων ήρωας"
"DOTA_AHC_CurrentHeroName"	"{s:current_hero_name}"
"DOTA_AHC_InProgress"	"Σε πρόοδο"
"DOTA_AHC_CurrentHeroAttempts"	"{s:current_hero_attempts} προσπάθειες"
"DOTA_AHC_CurrentHeroAverage"	"Παγκόσμιος μέσος"
"DOTA_AHC_CurrentHeroAverageAttempts"	"{s:current_hero_average_attempts} προσπάθειες"
"DOTA_AHC_NextHero"	"Επόμενος ήρωας"
"DOTA_AHC_NextHeroName"	"{s:next_hero_name}"
"DOTA_AHC_ChallengeProgress"	"Πρόοδος πρόκλησης ({d:challenge_progress_percent}%)"
"DOTA_AHC_HeroesCompleted"	"Ολοκληρωμένοι ήρωες"
"DOTA_AHC_HeroesCompletedValue"	"{d:heroes_completed} / {d:heroes_total}"
"DOTA_AHC_TotalAttempts"	"Συνολικές προσπάθειες"
"DOTA_AHC_TotalAttemptsValue"	"{d:challenge_total_attempts} παιχνίδια"
"DOTA_AHC_EquivalentWorldAverage"	"Ισοδύναμος παγκόσμιος μέσος"
"DOTA_AHC_EquivalentWorldAverageValue"	"{d:challenge_average_total_attempts} παιχνίδια"
"DOTA_AHC_LifetimeStats"	"Συνολικά στατιστικά προκλήσεων"
"DOTA_AHC_FullChallengesCompleted"	"Ολοκληρωμένες προκλήσεις"
"DOTA_AHC_FullChallengesCompletedValue"	"{d:full_challenges_completed}"
"DOTA_AHC_BestFullChallenge"	"Καλύτερη πρόκληση"
"DOTA_AHC_BestFullChallengeValueNone"	"Μ/Δ"
"DOTA_AHC_BestFullChallengeValue"	"{d:best_full_challenge} παιχνίδια"
"DOTA_AHC_FullChallengeAverageValue"	"{s:full_challenge_average} παιχνίδια"
"DOTA_AHC_ChallengeReward"	"Ανταμοιβή πρόκλησης"
"DOTA_AHC_ChallengeTrophyName"	"{s:challenge_trophy_name}"
"DOTA_AHC_ChallengeTrophyLevel"	"Επίπεδο {d:challenge_trophy_level}"
"DOTA_Trophies_ViewEarned"	"Ξεκλειδωμένο"
"DOTA_Party_Add_Friends"	"Προσθέστε φίλους για δημιουργία παρέας"
"DOTA_ItemSet_Count_text"	"{d:item_current_group} / {d:item_group_count}"
"DOTA_Custom_Game_Map_AnyNumbered"	"Οποιοδήποτε ({d:map_choices})"
"dota_settings_enable_console"	"Ενεργοποίηση κονσόλας"
"DOTA_HeroLoadout_Loadout"	"Εξοπλισμός"
"DOTA_HeroLoadout_About"	"Σχετικά"
"DOTA_HeroLoadout_Guides"	"Οδηγοί"
"DOTA_HeroLoadout_Roles"	"Ρόλοι"
"DOTA_HeroLoadout_Biography"	"Βιογραφία"
"DOTA_Feed_Say_Something"	"Πείτε κάτι στη ροή σας..."
"DOTA_Armory_ClearFilter"	"Εκκαθάριση φίλτρου"
"DOTA_Armory_ContextMenu_Tags"	"Ετικέτες..."
"DOTA_Armory_ContextMenu_EffigyPose"	"Πόζα..."
"DOTA_EffigyEditor_CreateEffigy"	"Δημιουργία ομοιώματος"
"DOTA_EffigyEditor_PoseEffigy"	"Πόζα ομοιώματος"
"DOTA_EffigyEditor_Model"	"Ήρωας"
"DOTA_EffigyEditor_Inscription"	"Επιγραφή:"
"DOTA_EffigyEditor_Animation"	"Κίνηση:"
"DOTA_EffigyEditor_Frame"	"Επιλογή καρέ:"
"DOTA_EffigyEditor"	"Επεξεργαστής ομοιωμάτων"
"DOTA_tooltip_econ_item_modifiers"	"Τροποποιητές"
"DOTA_tooltip_econ_item_modifier_animation"	"Κίνηση"
"DOTA_tooltip_econ_item_modifier_announcer"	"Εκφωνητής"
"DOTA_tooltip_econ_item_modifier_HUD"	"HUD"
"DOTA_tooltip_econ_item_modifier_health_bar"	"Μπάρα ζωής"
"DOTA_tooltip_econ_item_modifier_ability_name"	"Όνομα ικανότητας"
"DOTA_tooltip_econ_item_modifier_loading_screen"	"Οθόνη φόρτωσης"
"DOTA_tooltip_econ_item_modifier_portrait"	"Πορτραίτο"
"DOTA_tooltip_econ_item_modifier_ambient_effects"	"Εφέ περιβάλλοντος"
"DOTA_tooltip_econ_item_modifier_kill_effects"	"Εφέ σκοτωμών"
"DOTA_tooltip_econ_item_modifier_spell_effects"	"Εφέ ικανοτήτων"
"DOTA_tooltip_econ_item_modifier_model"	"Μοντέλο"
"DOTA_tooltip_econ_item_modifier_scale"	"Κλίμακα"
"DOTA_tooltip_econ_item_modifier_wearable"	"Εξοπλισμός"
"DOTA_tooltip_econ_item_modifier_courier"	"Μεταφορέας"
"DOTA_tooltip_econ_item_modifier_icon"	"Εικονίδιο"
"DOTA_econ_item_details_style_label"	"Στυλ:"
"DOTA_econ_item_details_gift_label"	"Δώρο από:"
"Compendium_Downloading"	"Λήψη Compendium..."
"Compendium_DLFailed"	"Αποτυχία λήψης"
"Compendium_Error"	"Σφάλμα Compendium"
"Compendium_Retry"	"Επανάληψη"
"Compendium_preview_click"	"Πατήστε εδώ για ενεργοποίηση!"
"Compendium_level"	"ΕΠΙΠΕΔΟ"
"Compendium_LevelupPts_Singular"	"1 πόντος"
"Compendium_LevelupPts_Plural"	"{d:next_comp_level} πόντοι"
"DOTA_AntiAddiction_CompleteInfoNotNow"	"Όχι τώρα"
"DOTA_Workshop_Model"	"Μοντέλο"
"DOTA_Workshop_Animations"	"Κινήσεις"
"DOTA_Workshop_Misc"	"Λοιπά"
"DOTA_Workshop_SubmissionType_Ward"	"Ward"
"DOTA_Workshop_ImportP4"	"Εισαγωγή (P4)"
"DOTA_Workshop_ImportNoP4"	"Εισαγωγή (όχι P4)"
"DOTA_Workshop_SaveSettings"	"Ρυθμίσεις αποθήκευσης"
"DOTA_Workshop_LoadSettings"	"Ρυθμίσεις φόρτωσης"
"DOTA_Workshop_Ready"	"Έτοιμο"
"DOTA_Workshop_Optional"	"Προαιρετικό"
"DOTA_Workshop_Required"	"Υποχρεωτικό"
"DOTA_Workshop_Required_Texture"	"Υποχρεωτικό (το μέγεθος των υφών θα αλλάξει σε: %s1)"
"DOTA_Workshop_Reimport"	"Ενημέρωση"
"DOTA_Workshop_Models_Title"	"Μοντέλα"
"DOTA_Workshop_Materials_Title"	"Υλικά"
"DOTA_Workshop_Attachments_Title"	"Συννημένα"
"DOTA_Workshop_Marketing_Title"	"Μάρκετινγκ"
"DOTA_Workshop_Images_Title"	"Εικόνες"
"DOTA_Workshop_AbilityIcons_Title"	"Εικονίδια ικανοτήτων"
"DOTA_Workshop_HudSkin_Help"	"Βοήθεια εμφανίσεων HUD"
"DOTA_Workshop_CursorPack_Help"	"Βοήθεια πακέτων κερσόρων"
"DOTA_Workshop_ImportLoadingScreen"	"ΕΙΣΑΓΩΓΗ ΕΙΚΟΝΑΣ ΦΟΡΤΩΣΗΣ"
"DOTA_UI_LoadScreen_16_9"	"Αναλογία 16:9"
"DOTA_UI_LoadScreen_16_10"	"Αναλογία 16:10"
"DOTA_UI_LoadScreen_4_3"	"Αναλογία 4:3"
"DOTA_Workshop_ImportChatEmoticon"	"ΕΙΣΑΓΩΓΗ EMOTICON ΣΥΝΟΜΙΛΙΑΣ"
"DOTA_Workshop_ImportChatEmoticon_Preview"	"Προεπισκόπηση"
"DOTA_Workshop_Attachments_UIBlock"	"Συνημμένα %s1"
"DOTA_Workshop_Animation_Title"	"Κινήσεις"
"DOTA_Workshop_Animation_Desc"	"Οι κινήσεις είναι αρχεία .DMX, .SMD, ή .FBX, όπου το καθένα περιέχει μια κίνηση χωριστά για το μοντέλο σας."
"DOTA_Workshop_Animation_UIBlock"	"Κινήσεις %s1"
"DOTA_Workshop_Preview_Anim"	"Κίνηση:"
"DOTA_Workshop_Preview_Model"	"Μοντέλο:"
"DOTA_Workshop_Preview_ToggleUI"	"Εναλλαγή UI"
"DOTA_Workshop_ImportError"	"Σφάλμα εισαγωγής"
"DOTA_Workshop_RequiredFileError"	"Το απαιτούμενο αρχείο δε βρέθηκε!"
"DOTA_Workshop_ZipError"	"Σφάλμα αρχείου!"
"DOTA_Workshop_Error"	"Σφάλμα εισαγωγής"
"DOTA_Workshop_Error_NoManifest"	"Το αρχείο Zip δεν περιέχει το manifest.txt."
"DOTA_Workshop_Quicksave_Fail"	"Αποτυχία αποθήκευσης"
"DOTA_Workshop_Quickload_Fail"	"Αποτυχία φόρτωσης"
"DOTA_Workshop_Import"	"Εισαγωγή"
"DOTA_Workshop_Importing"	"Γίνεται εισαγωγή"
"DOTA_Workshop_Import_Success"	"ΕΠΙΤΥΧΙΑ ΕΙΣΑΓΩΓΗΣ"
"DOTA_Workshop_Import_Failed"	"ΑΠΟΤΥΧΙΑ ΕΙΣΑΓΩΓΗΣ"
"DOTA_Workshop_OutOfBudget"	"%s1 εκτός ορίου τριγώνων:\n %s2 περιλαμβάνει %s3 τρίγωνα και το όριο είναι %s4."
"DOTA_Workshop_LOD0Title_Ward"	"Γεωμετρία πορτραίτου"
"DOTA_Workshop_Mat0Title_Ward"	"Αρχεία υφής Observer"
"DOTA_Workshop_Mat0Desc_Ward"	"Αυτό είναι το αρχείο .TGA _color που διαμορφώνει τα αρχεία γεωμετρίας του Observer Ward. Τα αρχεία .TGA _normal, _mask1, and _mask2 είναι προαιρετικά για Ward. Αν βρεθούν στον ίδιο φάκελο, θα χρησιμοποιηθούν."
"DOTA_Workshop_Mat1Title_Ward"	"Αρχεία υφής Sentry"
"DOTA_Workshop_Mat1Desc_Ward"	"Αυτό είναι το αρχείο .TGA _color που διαμορφώνει τα αρχεία γεωμετρίας του Sentry Ward. Τα αρχεία .TGA _normal, _mask1, and _mask2 είναι προαιρετικά για Ward. Αν βρεθούν στον ίδιο φάκελο, θα χρησιμοποιηθούν."
"DOTA_Workshop_Animation_Spawn"	"Aναβίωση"
"DOTA_Workshop_Animation_Idle"	"Αδράνεια"
"DOTA_Workshop_Animation_IdleAlt"	"Εναλλακτική αδράνεια"
"DOTA_Workshop_Animation_IdleRare"	"Σπάνια αδράνεια"
"DOTA_Workshop_Animation_Run"	"Τρέξιμο"
"DOTA_Workshop_Animation_RunAlt"	"Εναλλακτικό τρέξιμο"
"DOTA_Workshop_Animation_RunRare"	"Σπάνιο τρέξιμο"
"DOTA_Workshop_Animation_RunHaste"	"Τρέξιμο με Haste"
"DOTA_Workshop_Animation_RunInjured"	"Τρέξιμο με τραυματισμό"
"DOTA_Workshop_Animation_Die"	"Θάνατος"
"DOTA_Workshop_Animation_Die2"	"Εναλλακτικός θάνατος"
"DOTA_Workshop_Animation_Attack"	"Επίθεση"
"DOTA_Workshop_Animation_Victory"	"ΝΙΚΗ"
"DOTA_Workshop_Animation_Defeat"	"ΗΤΤΑ"
"DOTA_Workshop_GameDay"	"Ημέρα"
"DOTA_Workshop_GameNight"	"Νύχτα"
"DOTA_Workshop_Next"	"Επόμενο"
"DOTA_Workshop_PickType"	"Επιλογή τύπου"
"DOTA_Workshop_Portrait"	"Πορτραίτο"
"DOTA_Workshop_Prev"	"Προηγούμενο"
"DOTA_Workshop_Preview"	"Προεπισκόπηση"
"DOTA_Workshop_PreviewInGame"	"Προεπισκόπηση εντός παιχνιδιού"
"DOTA_Workshop_Submit"	"Υποβολή"
"DOTA_Workshop_Err_InvalidFile"	"Μη έγκυρο αρχείο: «%1»"
"DOTA_Workshop_BrowseForZipCaption"	"Επιλογή Zip"
"DOTA_Workshop_BrowseForZipFilter"	"Καταχωρήσεις εργαστηρίου (*.zip)"
"DOTA_Workshop_LoadSession"	"Φόρτωση συνεδρίας"
"DOTA_Workshop_SaveSession"	"Aποθήκευση συνεδρίας"
"DOTA_Filter_Field_Category"	"Ετικέτες"
"DOTA_Armory_Tags_Popup_Title"	"Ορισμός ετικετών"
"DOTA_Armory_Attributes"	"Χαρακτηριστικά"
"DOTA_Event_Level"	"Επίπεδο"
"DOTA_TryAgain"	"Προσπαθήστε ξανά"
"DOTA_Treasure_OpenAnother"	"Άνοιγμα άλλου"
"DOTA_Treasure_OpenTreasure"	"Άνοιγμα θησαυρού"
"DOTA_Treasure_OpenSuccess"	"Συγχαρητήρια! Λάβατε:"
"DOTA_Trophies_ViewAvailable"	"ΔΙΑΘΕΣΙΜΑ"
"DOTA_WatchTournaments_Region_EU"	"Ευρώπη"
"DOTA_WatchTournaments_Region_RU"	"Ρωσία"
"DOTA_WatchTournaments_Region_CN"	"Κίνα"
"DOTA_Popup_Item_Received_Button_Accept"	"Αποδοχή"
"DOTA_Treasure_MarketPurchase"	"Στην Αγορά"
"DOTA_Treasure_FilterAvailable"	"Διαθέσιμο"
"DOTA_Trophies_ViewMyCollection"	"Η συλλογή μου"
"DOTA_Custom_Game_About"	"Σχετικά"
"DOTA_Custom_Game_Updates"	"Ενημερώσεις"
}
