"dota"
{
"DOTA_Accept"	"ยอมรับ"
"DOTA_Cancel"	"ยกเลิก"
"DOTA_Console"	"คอนโซล"
"DOTA_Create"	"สร้าง"
"DOTA_Decline"	"ปฏิเสธ"
"DOTA_Error"	"ข้อผิดพลาด"
"DOTA_Join"	"เข้าร่วม"
"DOTA_Leave"	"ออก"
"DOTA_New"	"ใหม่"
"DOTA_Ok"	"ตกลง"
"DOTA_Sale"	"ลดราคา"
"DOTA_Close"	"ปิด"
"DOTA_Continue"	"ดำเนินการต่อ"
"DOTA_Add"	"เพิ่ม"
"DOTA_Edit"	"แก้ไข"
"DOTA_Enable"	"เปิดการใช้งาน"
"DOTA_Disable"	"ปิดการใช้งาน"
"DOTA_Refresh"	"รีเฟรช"
"DOTA_Loading"	"กำลังโหลด"
"DOTA_None"	"ไม่มี"
"DOTA_Customize"	"ปรับแต่ง"
"DOTA_AcceptChanges"	"ยอมรับการเปลี่ยนแปลง"
"dota_team_radiant"	"Radiant"
"dota_team_dire"	"Dire"
"Unknown"	"ไม่ทราบ"
"UI_Yes"	"ใช่"
"UI_No"	"ไม่"
"UI_File_Filter_Any"	"ไฟล์ทั้งหมด (*.*)"
"DOTA_MainMenu_Heroes"	"ฮีโร่"
"DOTA_MainMenu_Watch"	"เข้าชม"
"DOTA_MainMenu_Learn"	"เรียนรู้"
"DOTA_MainMenu_Mods"	"เกมแบบกำหนดเอง"
"DOTA_TabName_GlobalItems"	"ไอเท็มสภาพแวดล้อม"
"DOTA_TabName_Treasury"	"คลังสมบัติ"
"DOTA_TabName_Armory"	"คลังแสง"
"DOTA_ConfirmQuit"	"ยืนยันการออก"
"DOTA_ConfirmQuitDesc"	"คุณต้องการจะออกจาก Dota 2 หรือไม่?"
"DOTA_ConfirmQuitDescUnsafe"	"การออกจากเกมก่อนที่เกมจะจบอาจทำลายเกมของผู้เล่นคนอื่น คุณแน่ใจแล้วว่าต้องการออกจาก Dota 2?"
"DOTA_InvalidPersonaName"	"[ไม่ทราบ]"
"DOTA_Friends_WindowTitle"	"เพื่อน"
"DOTA_FriendsCategory_ReadyToPlay"	"อยู่ในเกมเปิด <font color='#63C290'><b></b>({d:friend_count})</font>"
"DOTA_FriendsCategory_PlayingDota"	"อยู่ใน Dota <font color='#ACEBA9'>({d:friend_count})</font>"
"DOTA_FriendsCategory_Online"	"ออนไลน์ <font color='#6a9dcc'>({d:friend_count})</font>"
"DOTA_FriendsCategory_Pending"	"อยู่ระหว่างดำเนินการ <font color='#eeee82'>({d:friend_count})</font>"
"DOTA_FriendsCategory_Offline"	"ออฟไลน์ <font color='#676666'>({d:friend_count})</font>"
"DOTA_Friends_Empty"	"ในขณะนี้รายชื่อเพื่อนของคุณว่างเปล่า"
"DOTA_FriendsMenu_Tooltip_NoneReady"	"เพื่อน"
"DOTA_UserName"	"{g:dota_persona:user_account_id}"
"DOTA_UserNamePro"	"{g:dota_persona_pro:user_account_id}"
"DOTA_UserNickname"	"{g:dota_persona_nickname:user_account_id}"
"DOTA_UserRichPresence"	"{s:user_rich_presence}"
"DOTA_ProfileCard_StatTitle_SoloRank"	"MMR เดี่ยว"
"DOTA_ProfileCard_StatTitle_PartyRank"	"MMR ปาร์ตี้"
"DOTA_ProfileCard_StatTitle_Wins"	"ชนะ"
"DOTA_ProfileCard_StatTitle_Commends"	"ชมเชย"
"DOTA_ProfileCard_StatTitle_GamesPlayed"	"แมตช์"
"DOTA_ProfileCard_StatTitle_FirstMatchDate"	"แมตช์แรก"
"DOTA_ProfileCard_StatValue_Int"	"{d:stat_value}"
"DOTA_ProfileCard_StatValue_Date"	"{t:s:stat_value}"
"DOTA_ProfileCard_StatValue_String"	"{s:stat_value}"
"DOTA_ProfileCard_SlotTab_Trophies"	"ถ้วยรางวัล"
"DOTA_ProfileCard_SlotTab_Items"	"คลังแสง"
"DOTA_ProfileCard_SlotTab_Heroes"	"ฮีโร่"
"DOTA_ProfileCard_SlotTab_Emoticons"	"อีโมติคอน"
"DOTA_ProfileCard_NoTrophies"	"ไม่มีถ้วยรางวัล"
"DOTA_ProfileCard_NoItems"	"ไม่มีไอเท็ม"
"DOTA_ProfileCard_HeroOnly"	"ฮีโร่เท่านั้น"
"DOTA_ProfileCard_HeroShowWins"	"แสดงชนะ"
"DOTA_ProfileCard_HeroShowWinsAndLosses"	"แสดงชนะ-แพ้"
"DOTA_ProfileCard_ItemSearchPrefix"	"ค้นหา:"
"DOTA_ProfileCard_ItemSearchPlaceholder"	"ไอเท็มตามชื่อ"
"DOTA_ProfileCard_ItemArmoryLink"	"ดูคลังแสงแบบเต็ม"
"DOTA_HeroTooltip_HeroName"	"{s:hero_name}"
"DOTA_HeroTooltip_HeroRecord"	"{s:hero_wins_string}, {s:hero_losses_string}"
"DOTA_ProfileCard_HeroSearchPlaceholder"	"ค้นหาตามชื่อฮีโร่"
"DOTA_Wins_Singular"	"ชนะ 1 ครั้ง"
"DOTA_Wins_Plural"	"ชนะ {d:hero_wins} ครั้ง"
"DOTA_Losses_Singular"	"แพ้ 1 ครั้ง"
"DOTA_Losses_Plural"	"แพ้ {d:hero_losses} ครั้ง"
"DOTA_Profile_TotalGames"	"เกมทั้งหมด"
"DOTA_Profile_Solo_MMR"	"MMR เดี่ยว"
"DOTA_Profile_Team_MMR"	"MMR ทีม"
"DOTA_Profile_Party_MMR"	"MMR ปาร์ตี้"
"DOTA_Profile_VictoryCount"	"ชนะ"
"DOTA_Profile_ProfilePage"	"โปรไฟล์"
"DOTA_Profile_TrophyPage"	"ถ้วยรางวัล"
"DOTA_Profile_RecentGamesPage"	"เกมที่ผ่านมา"
"DOTA_Profile_HeroPage"	"ฮีโร่"
"DOTA_Profile_PlayStyle"	"รูปแบบการเล่น"
"DOTA_Profile_MostRecent"	"{s:num_style_games} เกมล่าสุด"
"DOTA_Profile_RecentActivity"	"กิจกรรมล่าสุด"
"DOTA_Profile_Fighting"	"การต่อสู้"
"DOTA_Profile_Fighting_TooltipTitle"	"การต่อสู้"
"DOTA_Profile_Fighting_Tooltip"	"ผู้เล่นที่ช่วยต่อสู้กับฮีโร่ศัตรูหลายครั้ง"
"DOTA_Profile_Farming"	"การฟาร์ม"
"DOTA_Profile_Farming_TooltipTitle"	"การฟาร์ม"
"DOTA_Profile_Farming_Tooltip"	"ผู้เล่นที่ฟาร์มเงินจากการสังหารสิ่งมีชีวิต"
"DOTA_Profile_Supporting"	"การสนับสนุน"
"DOTA_Profile_Supporting_TooltipTitle"	"การสนับสนุน"
"DOTA_Profile_Supporting_Tooltip"	"ผู้เล่นที่ช่วยสนับสนุนทีมด้วยไอเท็ม การฟื้นฟู และการปัก Ward"
"DOTA_Profile_Pushing"	"การดัน"
"DOTA_Profile_Pushing_TooltipTitle"	"การดัน"
"DOTA_Profile_Pushing_Tooltip"	"ผู้เล่นที่ดันป้อม ช่วยสร้างพื้นที่ให้แก่ทีม"
"DOTA_Profile_Versatility"	"ความหลากหลาย"
"DOTA_Profile_Versatility_TooltipTitle"	"ความหลากหลาย"
"DOTA_Profile_Versatility_Tooltip"	"ผู้เล่นที่มีความหลากหลายและสามารถเล่นฮีโร่หลายตัว"
"DOTA_Profile_Tooltip_Value"	"{s:CurrentStatValue}"
"DOTA_Profile_Tooltip_Comparison"	"{s:CurrentComparisonValue}"
"DOTA_Profile_StatsCompare"	"เปรียบเทียบกับสถิติของฉัน"
"DOTA_Profile_Self"	"ฉัน"
"DOTA_Profile_GPM"	"GPM เฉลี่ย"
"DOTA_Profile_XPM"	"XPM เฉลี่ย"
"DOTA_Profile_LH"	"Last Hit เฉลี่ย"
"DOTA_Profile_Rampages"	"Rampage"
"DOTA_Profile_TripleKills"	"Triple Kill"
"DOTA_Profile_FirstBled"	"โดน First Blood"
"DOTA_Profile_CourierKills"	"สังหาร Courier"
"DOTA_Profile_CreepStack"	"ลากครีป"
"DOTA_Profile_GPMValue"	"{s:GPM}"
"DOTA_Profile_XPMValue"	"{s:XPM}"
"DOTA_Profile_LHValue"	"{s:LH}"
"DOTA_Profile_RampagesValue"	"{d:Rampages}"
"DOTA_Profile_TripleKillsValue"	"{d:TripleKills}"
"DOTA_Profile_FirstBloodValue"	"{d:FirstBlood}"
"DOTA_Profile_FirstBledValue"	"{d:FirstBled}"
"DOTA_Profile_CourierKillsValue"	"{d:CourierKills}"
"DOTA_Profile_AegisesValue"	"{d:Aegises}"
"DOTA_Profile_CheeseEatenValue"	"{d:CheeseEaten}"
"DOTA_Profile_CreepStackValue"	"{d:CreepStack}"
"DOTA_Profile_GPMLocalValue"	"{s:GPMLocal}"
"DOTA_Profile_XPMLocalValue"	"{s:XPMLocal}"
"DOTA_Profile_LHLocalValue"	"{s:LHLocal}"
"DOTA_Profile_RampagesLocalValue"	"{d:RampagesLocal}"
"DOTA_Profile_TripleKillsLocalValue"	"{d:TripleKillsLocal}"
"DOTA_Profile_FirstBloodLocalValue"	"{d:FirstBloodLocal}"
"DOTA_Profile_FirstBledLocalValue"	"{d:FirstBledLocal}"
"DOTA_Profile_CourierKillsLocalValue"	"{d:CourierKillsLocal}"
"DOTA_Profile_AegisesLocalValue"	"{d:AegisesLocal}"
"DOTA_Profile_CheeseEatenLocalValue"	"{d:CheeseEatenLocal}"
"DOTA_Profile_CreepStackLocalValue"	"{d:CreepStackLocal}"
"DOTA_RecentGames_Title"	"เกมที่ผ่านมา"
"DOTA_RecentGames_TimeStamp"	"วันที่/เวลา"
"DOTA_RecentGames_HeroSelection"	"ฮีโร่ที่เล่น"
"DOTA_RecentGames_GameResult"	"ผลการแข่ง"
"DOTA_RecentGames_GameLength"	"ระยะเวลา"
"DOTA_RecentGames_Team"	"ทีม"
"DOTA_RecentGames_GameType"	"ชนิด"
"DOTA_RecentGames_Items"	"ไอเท็ม"
"DOTA_RecentGame_Timestamp_Entry"	"{t:s:timestamp} {t:t:timestamp}"
"DOTA_RecentGame_Duration"	"{t:d:duration}"
"DOTA_RecentGame_Downloading"	"กำลังดาวน์โหลด {s:DownloadPercent}"
"DOTA_RecentGame_Watch"	"ดูรีเพลย์"
"DOTA_RecentGame_NoReplay"	"ไม่มีรีเพลย์"
"DOTA_RecentGame_Expired"	"รีเพลย์หมดอายุ"
"DOTA_RecentGame_Finding"	"กำลังค้นหา..."
"DOTA_RecentGame_Download"	"ดาวน์โหลดแมตช์"
"DOTA_RecentGame_Pending"	"รีเพลย์กำลังอยู่ระหว่างดำเนินการ"
"DOTA_RecentGame_Unavailable"	"ไม่พบรีเพลย์"
"DOTA_RecentGame_MatchID"	"ไอดีแมตช์: #{s:match_id}"
"DOTA_No_Team_Name"	"--"
"DOTA_TrophyCount"	"ถ้วยรางวัล {d:trophy_count} ชิ้น"
"DOTA_TrophiesCount"	"ถ้วยรางวัล {d:trophy_count} ชิ้น"
"DOTA_TrophyCount_Number"	"{d:trophy_count}"
"DOTA_TrophyCount_NoNum"	"ถ้วยรางวัล"
"DOTA_TrophiesCount_NoNum"	"ถ้วยรางวัล"
"DOTA_Trophies_ViewAll"	"ทั้งหมด"
"DOTA_TrophyName"	"{s:trophy_name}"
"DOTA_TrophyCategory"	"{s:trophy_category}"
"DOTA_TrophyDescription"	"{s:trophy_description}"
"DOTA_TrophyXP"	"{d:trophy_xp}<span class=\"TrophyPointTextSmall\">TP</span>"
"DOTA_NextTrophy"	"รางวัลถัดไป"
"DOTA_NewPlayerQuestion_Title"	"ยินดีต้อนรับสู่ DOTA 2"
"DOTA_PlayerOriginQuestion_Question"	"เพื่อเพิ่มประสบการณ์ในเกมของคุณ โปรดแบ่งปันความคุ้นเคยของคุณกับ Dota 2 หรือเกมที่คล้ายคลึง:"
"DOTA_PlayerOriginQuestion_BeginnerButton"	"ฉันเพิ่งเริ่มเล่น"
"DOTA_PlayerOriginQuestion_RTSButton"	"ฉันเล่นเกมแนว RTS อยู่"
"DOTA_PlayerOriginQuestion_MOBAButton"	"ฉันเล่นเกมที่คล้ายกับ Dota 2 อยู่"
"DOTA_PlayerOriginQuestion_Dota2Button"	"ฉันเล่นเกม Dota 2 อยู่"
"DOTA_PlayerOriginQuestion_MOBAExplanation"	"เลือกเกมที่คุณเล่นแล้วรู้สึกสบายมากที่สุด:"
"DOTA_OtherGames_LOL"	"League of Legends"
"DOTA_OtherGames_DOTA"	"DotA 1"
"DOTA_OtherGames_HON"	"Heroes of Newerth"
"DOTA_OtherGames_Smite"	"Smite"
"DOTA_OtherGames_Other"	"เกมอื่น ๆ"
"DOTA_PlayerOriginQuestion_ConfirmationButton"	"มาเล่นกันเถอะ"
"DOTA_PlayerOriginQuestion_ConfirmationTutorial"	"ในฐานะที่คุณเป็นผู้เล่นใหม่ของ Dota คุณอาจจะสนใจที่จะเรียนรู้ในส่วนการฝึกฝนภายในแท็บ เล่น มันเป็นขั้นแรกที่อาจจะทำให้คุณเล่นเก่งกว่าผู้เล่นคนอื่น ๆ ทั่วโลก"
"DOTA_PlayerOriginQuestion_ConfirmationSettings"	"การกำหนดปุ่มเองและการตั้งค่าของคุณ ถูกตั้งให้เป็นการตั้งค่าที่ใช้กันทั่วไปมากที่สุดสำหรับผู้เล่นที่มีประสบการณ์เช่นคุณ คุณสามารถแก้ไขกำหนดค่าเหล่านี้ได้เมื่อไหร่ก็ได้ โดยการคลิกที่ไอคอนตั้งค่า"
"DOTA_Tutorial_SkipButton"	"ข้ามบทฝึกสอน"
"DOTA_ConfirmSkip"	"ข้ามบทนำ Dota 2?"
"DOTA_ConfirmSkipDesc"	"คุณแน่ใจหรือไม่ว่าต้องการข้ามบทฝึกสอนของ Dota 2?"
"DOTA_Tutorial_Start_Quest"	"เริ่มภารกิจ"
"DOTA_Tutorial_Quest0_Title"	"ภารกิจที่ 1"
"DOTA_Tutorial_Quest0_TitleDesc"	"ฮีโร่โจมตีระยะไกล"
"DOTA_Tutorial_Quest0DetailsDesc"	"ภารกิจนี้จะใช้เวลาประมาณ\n 10 นาทีในการเล่นให้เสร็จสมบูรณ์"
"DOTA_Tutorial_QuestDetailsLearn"	"คุณจะได้รู้จัก:"
"DOTA_Tutorial_Quest0DetailsLesson"	"การเคลื่อนย้ายฮีโร่\nการเพิ่มเลเวลฮีโร่\nการใช้สกิล\nไอเท็ม\nการต่อสู้เบื้องต้น\nการ Last Hit"
"DOTA_Tutorial_Quest1_Title"	"ภารกิจที่ 2"
"DOTA_Tutorial_Quest1_TitleDesc"	"การต่อสู้ในเลน"
"DOTA_Tutorial_Quest1DetailsDesc"	"ภารกิจนี้จะใช้เวลาประมาณ\n 10 นาทีในการเล่นให้เสร็จสมบูรณ์"
"DOTA_Tutorial_Quest1DetailsLesson"	"การต่อสู้ระยะไกล \n สกิล AOE \n แผนที่ย่อ \n ป้อมปราการ \n Courier และคลังเก็บของ \n การเทเลพอร์ต"
"DOTA_Tutorial_Quest2_Title"	"ภารกิจที่ 3"
"DOTA_Tutorial_Quest2_TitleDesc"	"การต่อสู้ในเลน"
"DOTA_Tutorial_Quest2DetailsDesc"	"ภารกิจนี้จะใช้เวลาประมาณ\n 10 - 15 นาทีในการเล่นให้เสร็จสมบูรณ์"
"DOTA_Tutorial_Quest2DetailsLesson"	"การต่อสู้ในเลน \n การป้องกันและโจมตีป้อมปราการ \n ไอเท็มเริ่มต้น"
"DOTA_Challenges_Title"	"เรียนรู้"
"DOTA_ChallengeGroup_0_Title"	"กลศาสตร์"
"DOTA_ChallengeGroup_1_Title"	"แมตช์ฝึกสอนโดยบอท"
"DOTA_ChallengeGroup_1_Desc"	"เริ่มที่นี่!"
"DOTA_ChallengeGroup_2_Title"	"แมตช์สู้กับบอท"
"DOTA_ChallengeGroup_More"	"อีกมากมายที่กำลังจะมา"
"DOTA_ChallengeGroup_Locked"	"ถูกล็อคอยู่"
"DOTA_LearnMechanics_Title"	"กลศาสตร์"
"DOTA_LearnMechanics_SubTitle"	"เรียนรู้พื้นฐานของการเล่น Dota รวมถึงการควบคุมฮีโร่ของคุณ การใช้งานร้านค้าไอเท็ม การเก็บโกลด์และค่าประสบการณ์ และอีกมากมาย หากคุณไม่เคยเล่นเกมเหมือน Dota มาก่อน คุณควรเริ่มต้นที่นี่"
"DOTA_Mechanics_0_Title"	"กลศาสตร์ 1"
"DOTA_Mechanics_0_Desc"	"การเคลื่อนย้ายฮีโร่\nการเพิ่มเลเวลฮีโร่\nการใช้สกิล\nไอเท็ม\nการต่อสู้เบื้องต้น\nLast Hit"
"DOTA_Mechanics_1_Title"	"กลศาสตร์ 2"
"DOTA_Mechanics_1_Desc"	"การต่อสู้ระยะไกล\nสกิลแสดงผลบนพื้นที่\nแผนที่ย่อ\nป้อมปราการ\nCourier และคลังเก็บของ\nการเทเลพอร์ต"
"DOTA_LearnGuidedBotMatches_Title"	"แมตช์ฝึกสอนโดยบอท"
"DOTA_LearnGuidedBotMatches_SubTitle"	"เข้าเล่นและต่อสู้กับฮีโร่ที่ถูกควบคุมโดย AI เพื่อเรียนรู้วิธีการเล่น Dota เราจะแนะนำคุณทีละขั้นตอนผ่านแมตช์เต็มรูปแบบแต่ละแมตช์ เพื่อฝึกให้การเล่นฮีโร่ของคุณไม่สามารถมีใครหยุดได้"
"DOTA_GuidedBotMatches_0_Title"	"Luna"
"DOTA_GuidedBotMatches_0_Desc"	"โจมตีระยะสั้น\nการโจมตีสร้างความเสียหายสูง\nเคลื่อนที่เร็ว\nเปราะเล็กน้อย\nมีค่าสถานะเป็น Agility"
"DOTA_GuidedBotMatches_1_Title"	"Sven"
"DOTA_GuidedBotMatches_1_Desc"	"โจมตีระยะประชิด\nการโจมตีสร้างความเสียหายหนัก\nความอึดสูง\nแพ้การถูกลดความเร็ว\nมีค่าสถานะเป็น Strength"
"DOTA_GuidedBotMatches_2_Title"	"Lina"
"DOTA_GuidedBotMatches_2_Desc"	"โจมตีระยะไกล\nสกิลสร้างความเสียหายหนัก\nมีคูลดาวน์สั้น\nเปราะอย่างมาก\nมีค่าสถานะเป็น Intelligence"
"DOTA_LearnBotMatches_Title"	"แมตช์สู้กับบอท"
"DOTA_LearnBotMatches_SubTitle"	"ฝึกฝนกับฮีโร่ที่ถูกควบคุมโดย AI ในพื้นที่ฝึกที่ปราศจากความเครียด"
"DOTA_BotMatches_0_Title"	"บอทระดับง่าย"
"DOTA_BotMatches_0_Desc"	"เรียนรู้ฮีโร่ใหม่"
"DOTA_BotMatches_1_Title"	"บอทระดับปานกลาง"
"DOTA_BotMatches_1_Desc"	"เล่นสบาย ๆ"
"DOTA_BotMatches_2_Title"	"บอทระดับยาก"
"DOTA_BotMatches_2_Desc"	"เล่นแบบท้าทาย"
"DOTA_BotMatches_3_Title"	"บอทระดับขี้โกง"
"DOTA_BotMatches_3_Desc"	"เล่นทำร้ายตัวเอง"
"FileOpenDialog_Open"	"เปิด"
"FileOpenDialog_Save"	"บันทึก"
"FileOpenDialog_Select"	"เลือก"
"FileOpenDialog_FileType_Folder"	"โฟลเดอร์"
"DOTA_FindMatch"	"ค้นหาแมตช์"
"DOTA_FindingMatch"	"กำลังค้นหาแมตช์ ( {s:find_match_time} )"
"DOTA_FindMatchTime"	"{s:find_match_time}"
"DOTA_Searching"	"กำลังค้นหา"
"DOTA_StartSoloBotMatch"	"เริ่มแมตช์สู้กับบอท"
"DOTA_Create_Lobby"	"สร้างล็อบบี้"
"DOTA_Join_Lobby"	"เข้าร่วมล็อบบี้"
"DOTA_LobbyStartGame"	"เริ่มเกม"
"DOTA_ReturnToLobby"	"กลับไปที่ล็อบบี้"
"DOTA_FindMatchStatus"	"{s:searching_matchtype} / {s:searching_gamemodes} / {s:searching_region}"
"DOTA_FindGameModesMany"	"โหมดเกม: "
"DOTA_FindRegionsMany"	"ภูมิภาค: "
"DOTA_GameMode_AllPick"	"All Pick"
"DOTA_GameMode_SingleDraft"	"Single Draft"
"DOTA_GameMode_CaptainsMode"	"Captains Mode"
"DOTA_GameMode_RandomDraft"	"Random Draft"
"DOTA_GameMode_AbilityDraft"	"Ability Draft"
"DOTA_GameMode_LeastPlayed"	"Least Played"
"DOTA_GameMode_AllRandom"	"All Random"
"DOTA_GameMode_LimitedHeroes"	"Limited Heroes"
"DOTA_GameMode_CaptainsDraft"	"Captains Draft"
"DOTA_GameMode_AllRandomDeathMatch"	"All Random Death Match"
"DOTA_ImmediatePurchase_SendFailed"	"ล้มเหลวในการส่งคำสั่งซื้อ เซิร์ฟเวอร์ Dota อาจกำลังออฟไลน์ คุณควรสั่งซื้ออีกครั้งในภายหลัง"
"DOTA_ImmediatePurchase_Timeout"	"การรอการตอบสนองต่อคำสั่งซื้อหมดเวลา โปรดลองอีกครั้งในภายหลัง"
"DOTA_ImmediatePurchase_InitFailed"	"เราไม่สามารถเริ่มการสั่งซื้อด้วย Perfect World ได้ในขณะนี้ โปรดลองอีกครั้งในภายหลัง"
"DOTA_ImmediatePurchase_InsufficientFundsPW"	"เงินในบัญชี Perfect World ของคุณมีไม่เพียงพอที่จะทำการสั่งซื้อ โปรดเติมเงินในบัญชีของคุณแล้วลองอีกครั้ง"
"DOTA_ImmediatePurchase_Success_Title"	"สำเร็จ"
"DOTA_ImmediatePurchase_Success_Text"	"การสั่งซื้อเสร็จสมบูรณ์แล้ว! ไอเท็มของคุณจะปรากฏในคลังแสงของคุณในไม่ช้า"
"DOTA_ImmediatePurchase_Cancelled_Title"	"ยกเลิกแล้ว"
"DOTA_ImmediatePurchase_UnbundleTimeout"	"การรอการตอบสนองต่อคำขอเปิดชุดรวมหมดเวลา โปรดลองอีกครั้งในภายหลัง"
"DOTA_ImmediatePurchase_UnbundleFailure"	"ไม่สามารถแกะชุดรวมของคุณได้ โปรดลองอีกครั้งในภายหลัง"
"DOTA_ImmediatePurchase_LateCancel"	"การสั่งซื้อถูกยกเลิกไปก่อนหน้านี้ คุณไม่ถูกคิดเงิน"
"DOTA_ConfirmPurchaseTitle"	"ยืนยันการสั่งซื้อ"
"DOTA_ConfirmPurchaseText"	"คุณต้องการซื้อไอเท็มชิ้นนี้หรือไม่?"
"DOTA_PurchaseInProgress_Title"	"การสั่งซื้อกำลังดำเนินการ"
"DOTA_PurchaseInProgress_Text"	"คำสั่งซื้อของคุณกำลังถูกประมวลผล"
"DOTA_UnbundleInProgress_Title"	"กำลังดำเนินการเปิดชุดรวม"
"DOTA_UnbundleInProgress_Text"	"ชุดรวมของคุณกำลังจะถูกแกะ"
"DOTA_ConfirmUnbundleTitle"	"ยืนยันการเปิดชุดรวม"
"DOTA_ConfirmUnbundleText"	"คุณต้องเปิดชุดรวมนี้เพื่อที่จะสวมใส่ไอเท็มที่อยู่ในนั้น ดำเนินการต่อ?"
"DOTA_RequestingBalance_Title"	"กำลังขอยอดดุล"
"DOTA_RequestingBalance_Text"	"กำลังขอยอดดุลในบัญชี Perfect World ของคุณ..."
"DOTA_PartnerPurchaseRecharge_Title"	"เติมเงินยอดดุล"
"DOTA_PartnerPurchaseRecharge_Text"	"กำลังเปลี่ยนเป็นการเติมเงินยอดดุลบัญชีของคุณ..."
"DOTA_PartnerPurchase_Purchase"	"{g:dota_item_price:item_def}"
"DOTA_PartnerPurchase_Recharge"	"เติมเงินบัญชี"
"DOTA_PartnerPurchase_Balance"	"ยอดดุล: {m:balance}"
"DOTA_PartnerRecharge_Close"	"กลับไปที่การสั่งซื้อ"
"RequestBalanceBadAccount"	"ล้มเหลวในการขอยอดดุลบัญชี: ไม่พบบัญชี"
"RequestBalanceAccountNotLinked"	"ล้มเหลวในการขอยอดดุลบัญชี: บัญชีของคุณไม่ได้ถูกเชื่อมโยงกับ Perfect World"
"RequestBalanceUnsupportedPartner"	"ล้มเหลวในการขอยอดดุลบัญชี: บัญชึของคุณไม่ได้ถูกเชื่อมโยงกับพันธมิตรที่ได้รับการยอมรับ"
"StoreCheckout_Error_Title"	"ข้อผิดพลาด"
"StoreCheckout_NoItems"	"ตะกร้าสินค้าของคุณว่างเปล่า!"
"StoreCheckout_TooManyItems"	"คุณมีไอเท็มอยู่ในตะกร้าสินค้ามากเกินไป!"
"StoreCheckout_Loading"	"กำลังชำระเงิน..."
"StoreCheckout_Unavailable"	"ไม่สามารถชำระเงินได้ในขณะนี้"
"StoreCheckout_Cancelling"	"กำลังยกเลิก..."
"StoreCheckout_Fail"	"ร้านค้าในเกมปิดอยู่ในขณะนี้"
"StoreCheckout_InvalidParam"	"โปรแกรมเมอร์ทำพลาดซะแล้ว! พารามิเตอร์ที่ไม่ถูกต้องได้ถูกส่งต่อไปยังผู้ประสานงานตัวเกม กรุณาลองทำการสั่งซื้ออีกครั้ง"
"StoreCheckout_InternalError"	"ดูเหมือนว่าจะมีข้อผิดพลาดในการเริ่มต้นหรืออัปเดตการทำรายการของคุณ โปรดรอสักครู่แล้วลองอีกครั้ง หรือติดต่อฝ่ายสนับสนุนเพื่อขอความช่วยเหลือ"
"StoreCheckout_ContactSupport"	"ตรวจพบข้อผิดพลาดเกี่ยวกับการทำรายการของคุณ กรุณาติดต่อฝ่ายสนับสนุนเพื่อขอความช่วยเหลือ"
"StoreCheckout_NotApproved"	"ผู้ประสานงานตัวเกมไม่สามารถทำการอนุมัติการทำธุรกรรมของคุณกับ Steam ได้ กรุณาลองทำการสั่งซื้ออีกครั้งภายหลัง"
"StoreCheckout_NotLoggedin"	"คุณต้องเข้าสู่ระบบ Steam คำสั่งซื้อจึงจะเสร็จสมบูรณ์"
"StoreCheckout_WrongCurrency"	"สกุลเงินในการสั่งซื้อนี้ไม่ตรงกับสกุลเงินใน Wallet ของคุณ"
"StoreCheckout_NoAccount"	"บัญชี Steam ของคุณไม่สามารถใช้งานได้ในขณะนี้ โปรดทำการซื้ออีกครั้งในภายหลัง"
"StoreCheckout_InsufficientFunds"	"คุณไม่มีเงินพอที่จะทำให้การซื้อเสร็จสมบูรณ์"
"StoreCheckout_TimedOut"	"หมดเวลาในการดำเนินการ กรุณาสั่งซื้อใหม่อีกครั้ง"
"StoreCheckout_SteamAccountDisabled"	"บัญชี Steam ของคุณถูกปิดการใช้งานและไม่สามารถทำการสั่งซื้อได้"
"StoreCheckout_SteamAccountNoPurchase"	"การทำธุรกรรมผ่าน Steam Wallet ถูกระงับใช้ในบัญชีนี้"
"StoreCheckout_OldPriceSheet"	"รายการผลิตภัณฑ์ของคุณที่เก็บไว้เก่าเกินไปแล้ว กำลังร้องขอข้อมูลใหม่"
"StoreCheckout_TransactionNotFound"	"ไอดีของการทำธุรกรรมนี้ไม่ถูกพบโดยผู้ประสานงานตัวเกม กรุณาลองทำการสั่งซื้ออีกครั้ง"
"StoreCheckout_TransactionCancelled"	"การชำระเงินถูกยกเลิก คุณไม่ถูกคิดเงิน"
"StoreCheckout_TransactionCompleted"	"การชำระเงินเสร็จสมบูรณ์!\\\nขอให้เพลิดเพลินกับไอเท็มของคุณ!"
"StoreCheckout_CompleteButUnfinalized"	"ไม่สามารถยืนยันได้ว่าสำเร็จ หากประสบความสำเร็จ ไอเท็มของคุณจะถูกส่งมอบหลังจากนี้"
"StoreCheckout_NotEnoughRoom"	"คุณไม่มีพื้นที่ว่างในคลังแสงมากพอที่จะซื้อไอเท็มจำนวนมากขนาดนั้น"
"StoreCheckout_ContactSupport_Dialog_Title"	"คำเตือน"
"StoreCheckout_ContactSupport_Dialog_Btn"	"ติดต่อ"
"StoreCheckout_LimitedQuantityItemsUnavailable"	"ไอเท็มที่คุณกำลังจะซื้อเพิ่งหมดไปหรือไม่สามารถซื้อได้ในขณะนี้"
"StoreCheckout_Nexon_InsufficientFunds"	"คุณไม่มีเงินเพียงพอที่จะทำให้การสั่งซื้อเสร็จสมบูรณ์"
"StoreCheckout_Nexon_FundsLocked"	"เปิดการใช้ล็อค Nexon Cash"
"npc_dota_hero_abaddon_hype"	"Abaddon สามารถรอดจากการโจมตีจากศัตรูได้เกือบทั้งหมด เขาสามารถที่จะเปลี่ยนการโจมตีจากศัตรูมาเป็นการรักษาตัวเองได้ และยังช่วยใส่เกราะป้องกันให้กับเพื่อนร่วมทีมหรือปล่อยพลังสองด้านของเขาใส่เพื่อนหรือศัตรูได้อีกด้วย เขาพร้อมที่มุ่งเข้าสู่สนามรบที่มั่ววุ่นวายอยู่เสมอ"
"npc_dota_hero_alchemist_hype"	"เขาสามารถแปรเงินที่ได้จากการฆ่าหรือสังหารแต่ละครั้งเป็นเงินพิเศษได้ Alchemist ไม่มีปัญหาในการรวบรวมเครื่องมือที่จะสู้กับศัตรูของเขา เขาสามารถซุ่มโจมตีศัตรูด้วยกรดกัดกร่อนและสารเคมีที่มีส่วนประกอบไม่แน่นอนใส่ศัตรูได้ ซึ่งเขาต่อสู้เพื่อทำให้เจ้าออร์คจอมโลภของเขายังคงเชื่อฟังเขาต่อไป"
"npc_dota_hero_ancient_apparition_hype"	"Ancient Apparition สามารถกำจัดศัตรูที่อ่อนแอให้แตกสลายได้ไม่ว่าจะอยู่ที่ไหน เขาสามารถปล่อยพลังสะเก็ดน้ำแข็งอันรุนแรงที่สร้างความเสียหายได้ทั่วทั้งสนามรบ ทั้งยังช่วยลดความเร็วศัตรูหรือเพิ่มพลังโจมตีเพื่อให้เพื่อนร่วมทีมของเขาบุกเข้ามายังสนามรบได้ เขาสามารถกดดันศัตรูได้ตลอดเวลา"
"npc_dota_hero_antimage_hype"	"เมื่อ Anti-Mage มีช่วงโอกาส เขาสามารถทำให้ตัวเองแข็งแกร่งขึ้นอย่างมาก ซึ่งมีน้อยคนที่จะหยุดเขาได้ เขาสามารถเผาผลาญมานาของศัตรูได้ทุกครั้งเมื่อโจมตี หรือเทเลพอร์ตในระยะสั้น ๆ เพื่อหนีเมื่อถูกซุ่มโจมตีได้ การต้อนเขาให้จนมุมยากและท้าทายมากสำหรับศัตรู"
"npc_dota_hero_axe_hype"	"Axe สับหัวศัตรูได้ทีละคนเรื่อย ๆ เขาสามารถเปิดฉากให้กับทีม หรือล็อคตัวศัตรูในสนามรบแล้วสวนกลับศัตรูด้วยการหมุนตัวฟันด้วยขวานได้ รวมถึงกระโดดสับหัวศัตรูที่อ่อนแอด้วยขวานคู่ใจของเขา เขาบุกเข้าไปยังสนามรบได้ตลอดเวลา"
"npc_dota_hero_bane_hype"	"Bane นำความหวาดกลัวมาสู่ศัตรูของเขาด้วยสกิลหยุดจำนวนมาก ทั้งกักขังพวกเขาไว้ในฝันร้ายที่ติดต่อกันได้ หรือจับยึดศัตรูของเขาให้อยู่กับที่ ซื้อเวลาให้กับเพื่อนร่วมทีมมากพอที่พวกเขาจะสังหารเป้าหมายได้"
"npc_dota_hero_batrider_hype"	"เมื่อเขาอยู่บนฟ้า Batrider สามารถโจมตีลงมาจากทางไหนก็ได้ ฉกตัวศัตรูออกมาด้วยบ่วงบาศของเขา พุ่งทะยานขึ้นไปเหนือยอดไม้ ลากเหยื่อของเขาไปตามทางที่ลุกโชนเป็นไฟ ก่อนจะลากมาหาเพื่อนร่วมทีมที่กระหายเลือดของเขา"
"npc_dota_hero_beastmaster_hype"	"อัญเชิญหมูป่าพ่นพิษกับเหยี่ยวสอดแนมมาช่วยในการล่า Beastmaster ไม่เคยย่างเข้ามาในสนามรบโดยไม่เตรียมพร้อม ตัดผ่านป่าไม้ด้วยขวาน เสียงคำรามอันทรงพลังของเขาเปิดโอกาสให้เพื่อนร่วมทีมได้รุมยำศัตรูจนสิ้นซาก"
"npc_dota_hero_bloodseeker_hype"	"Bloodseeker บังคับให้ศัตรูของเขาต้องตัดสินใจในโจทย์สุดยาก สามารถบีบให้พวกเขาล่าถอยโดยสาดพื้นที่วงกว้างด้วยพิธีกรรมที่สร้างความเสียหาย ในขณะที่อัลติเมทอันน่ากลัวของเขาสั่งให้ศัตรูต้องอยู่นิ่ง ไม่เช่นนั้นก็ตาย"
"npc_dota_hero_bounty_hunter_hype"	"หายตัวสอดแนมฝีเท้าของศัตรู Bounty Hunter สามารถติดตามความเคลื่อนไหวของศัตรูของเขาได้เสมอ เมื่อใดก็ตามที่เป้าหมายของเขาสักตัวสิ้นชีพในสนามรบ เขาและเพื่อนของเขาที่อยู่ที่นั่นก็จะได้รับเงินพิเศษ"
"npc_dota_hero_brewmaster_hype"	"นักสู้ที่น่าเกรงขามในทุกสถานการณ์ Brewmaster สามารถพลิกเกมบนสนามรบได้ด้วยการแยกออกมาเป็นสามร่างวิญญาณแห่งธาตุ ซึ่งแต่ละตัวมีความสามารถที่แตกต่างกันไป เมื่อยังไม่แยกร่าง เขานำความหายนะแบบเมา ๆ มาสู่ศัตรู ด้วยการกระทืบลดความเร็วในการเคลื่อนที่ และการกวัดแกว่งคทาอันทรงพลังของเขา"
"npc_dota_hero_bristleback_hype"	"ถ้าพูดถึงเรื่องการต่อสู้แล้ว ต้องบอกว่า Bristleback นั้นสู้อย่างหลังขดหลังแข็งจริง ๆ ลดความเสียหายทั้งหมดที่ได้รับจากด้านหลังและด้านข้าง เขาลุยเข้าสู่สนามรบอย่างไม่สนใจอะไรทั้งนั้น พ่นขนไปยังศัตรูเพื่อสร้างความเสียหายและพ่นน้ำมูกทำให้ศัตรูช้าลง"
"npc_dota_hero_broodmother_hype"	"ซ่อนตัวล่องหนอยู่ภายในใยของเธอ Broodmother ให้กำเนิดกองกำลังแมงมุมเพื่อนำทัพให้ทีมของเธอไปสู่ฐานของศัตรู เมื่อเหยื่อเข้ามาใกล้ เธอจะเข้าร่วมโจมตีกับเหล่าลูก ๆ ทำให้ศัตรูช้าลงด้วยการกัดที่ทำให้เป็นอัมพาต ในขณะที่เธอปลดปล่อยความหิวกระหายที่ไม่มีวันสิ้นสุดออกมา"
"npc_dota_hero_centaur_hype"	"Centaur Warrunner เป็นผู้เชี่ยวชาญในทั้งการสร้างและรับความเสียหาย นำทัพเข้าสู่สนามรบ เขากระทืบเพื่อหยุดศัตรูและสวนกลับทุกการโจมตีของพวกเขาในทันที การวิ่งอย่างแตกตื่นช่วยเพิ่มความเร็วให้กับเพื่อนร่วมทีมของเขา ในทั้งการต่อสู้และการหนี ช่วยให้การสังหารหมู่เป็นไปอย่างรวดเร็ว"
"npc_dota_hero_chaos_knight_hype"	"Chaos Knight เป็นได้ทั้งกองทัพในตัวเอง สามารถอัญเชิญร่างเงากองทหารม้าเพื่อทำลายล้างการป้องกันของคู่ต่อสู้ เมื่อเห็นศัตรู เขาสามารถสร้างรอยแยกบนความเป็นจริง แล้วดึงตัวเขากับร่างเงาปีศาจให้เข้ามาใกล้พอที่จะหวดปลิดชีพพวกเขาด้วยกระบองอย่างโหดร้าย"
"npc_dota_hero_chen_hype"	"เปลี่ยนความคิดของเหล่าสัตว์ในป่าให้ทำตามเขา Chen นำกองทัพชั่วคราวของเขามาช่วยทีมในการต่อสู้ เขาจู่โจมศัตรูด้วยสัตว์ร้าย ในขณะที่ส่งเพื่อนไปยังที่ปลอดภัย จากนั้น เมื่อสถานการณ์เลวร้ายถึงขีดสุด เขาสามารถรักษาพวกพ้องไม่ว่าพวกเขาจะยืนอยู่ที่ไหน"
"npc_dota_hero_clinkz_hype"	"เมื่อ Clinkz ล่องหนย่องเข้าสู่สนามรบ ไม่มีใครปลอดภัยจากการซุ่มโจมตี รวดเร็วทั้งการเคลื่อนที่และฝีมือธนู เขาสาดสายฝนไฟแห่งความตายใส่ศัตรู แล้วล่าถอยไปดูดกลืนพลังชีวิตจากสิ่งมีชีวิตในป่า เพื่อเตรียมพร้อมการจู่โจมครั้งต่อไป"
"npc_dota_hero_crystal_maiden_hype"	"คอยดูไม่ให้เพื่อนร่วมทีมขาดมานา ในขณะที่ทำให้ศัตรูช้าลงเพื่อการสังหารที่แน่นอน Crystal Maiden เป็นตัวช่วยที่ดีสำหรับทุกทีม และเมื่อโอกาสเหมาะมาถึง เธอก็จะปลดปล่อยอัลติเมทอันทรงพลังออกมาทำลายล้างศัตรู"
"npc_dota_hero_dark_seer_hype"	"รอบรู้และเต็มไปด้วยแผนการ Dark Seer เหนือกว่าในเรื่องการควบคุมตำแหน่งของเหล่าศัตรู ดูดเป้าหมายเข้ามารับการโจมตีของเพื่อนร่วมทีม เขาสามารถใช้ความแข็งแกร่งของศัตรูโจมตีกลับไป ด้วยการดึงพวกมันผ่านกำแพงที่สามารถสร้างร่างเงาได้"
"npc_dota_hero_dazzle_hype"	"เกิดมาเพื่อสนับสนุนพวกพ้องในการต่อสู้ Dazzle คอยประทังชีวิตเพื่อนร่วมทีมที่บาดเจ็บ เพื่อให้พวกเขาสามารถส่งความตายให้ศัตรูทีหลังได้ พลังเวทอันแปลกประหลาดของเขาทะลุลงไปในเกราะข้างเคียง ทำให้ศัตรูอ่อนแอลงและทำให้พวกพ้องแข็งแกร่งขึ้น"
"npc_dota_hero_death_prophet_hype"	"เมื่อกองทัพภูติผีของเธอถูกปลดปล่อย Death Prophet นั้นเหนือกว่าในการทำลายล้างทั้งคู่ต่อสู้และการป้องกันของพวกเขา นำทัพทีมของเธอขึ้นไปสู่ฐานของศัตรูด้วยคลื่นทำล้ายล้างจากฝูงปีศาจ การจู่โจมของเธอดูเหมือนจะไม่มีสิ่งใดหยุดได้เลย"
"npc_dota_hero_disruptor_hype"	"Disruptor มีความสามารถในการทำลายแผนของศัตรู สร้างกำแพงที่ไม่สามารถผ่านได้เพื่อขังเป้าหมายและเรียกพายุมาใบ้ศัตรู หากศัตรูพยายามจะทำสิ่งไม่คาดฝันสิ่งใด เขาสามารถเทเลพอร์ตศัตรูกลับไปตำแหน่งที่พวกมันอยู่ในก่อนหน้านี้ได้"
"npc_dota_hero_doom_bringer_hype"	"Doom ปลิดชีพศัตรูของเขาไม่ด้วยวิธีใดก็วิธีหนึ่ง กลืนกินครีปเพื่อรับความสามารถต่าง ๆ ที่พวกมันมี เขาสามารถแผดเผาให้ศัตรูเป็นใบ้ไม่สามารถใช้สกิลและไอเท็มได้ด้วยอัลติเมทของเขา"
"npc_dota_hero_dragon_knight_hype"	"เมื่อเขากลายร่างเป็นมังกรอันน่าสะพรึง Dragon Knight มอบความกลัวให้กับผู้ที่เผชิญหน้าเขา แข็งแกร่งและปรับตัวได้ เขาสามารถสตันศัตรูและพ่นไฟใส่ทุกคนที่อยู่ข้างหน้า เขามักจะมอบพลังที่ทีมต้องการเพื่อนำพวกเขาไปสู่ชัยชนะ"
"npc_dota_hero_drow_ranger_hype"	"หากอยู่ในระยะของเธอแล้ว น้อยคนนักที่จะหนี Drow Ranger พ้น หลังจากศัตรูของเธอถูกใบ้ด้วยแรงกระแทกอันเย็นยะเยือก พวกเขาจะถูกปลิดชีพด้วยด้วยสายฝนของลูกธนูที่มีหัวเป็นน้ำแข็งซึ่งทำให้เคลื่อนที่ช้า และน้อยคนนักที่จะรอดออกมาได้"
"npc_dota_hero_earth_spirit_hype"	"Earth Spirit คอยป่วนศัตรูให้วุ่นวายและคอยคุ้มกันเพื่อนให้ปลอดภัย ปรับเปลี่ยนได้กับทุกสถานการณ์ในสนามรบ เขาสามารถส่งรูปปั้นกลับหลังและไปข้างหน้าเพื่อทำความเสียหายต่อศัตรู หรือฉุดเพื่อนร่วมทีมออกมาจากเงื้อมมือมัจจุราช"
"npc_dota_hero_earthshaker_hype"	"ไม่ว่าจะเป็นการปิดทางหนีของศัตรู หรือแบ่งแยกกองกำลังของพวกมัน หรือแม้แต่แยกแผ่นดินเพื่อรวบรวมพวกมันให้อยู่ในที่เดียวกัน Earthshaker นั้นจะอยู่ในสภาพที่ดีที่สุดหากตัวเขาสามารถบุกโจมตีได้โดยไร้การแจ้งเตือน ไม่ว่าจะเป็นสิ่งใดหากรอดจากแรงกระแทกจากแผ่นดินไหวไปได้ ก็ยังมีการโจมตีจากโทเทมอันทรงพลังของเขารออยู่"
"npc_dota_hero_elder_titan_hype"	"สอดส่องเส้นทางด้วยวิญญาณแห่งดวงดาวของเขา Elder Titan สามารถโจมตีได้จากทุกทาง หยุดศัตรูด้วยการกระทืบกีบเท้าในขณะที่การปรากฏตัวของเขาทำให้การป้องกันของเหล่าศัตรูลดลง เขายังสามารถแยกพื้นโลกเพื่อทำลายศัตรูของเขาได้อีกด้วย"
"npc_dota_hero_ember_spirit_hype"	"รวดเร็วและยากที่จะเดาได้ Ember Spirit จู่โจมศัตรูรอบข้างพร้อมกันอย่างว่องไว แล้วใช้โซ่เพลิงผูกพวกเขาไว้ด้วยกัน เคลื่อนที่ข้ามสนามรบอย่างว่องไวโดยการไปโผล่ที่ร่างเงาซึ่งระเบิดได้ น้อยคนนักที่จะหนีหรือจับทางไฟของเขาได้"
"npc_dota_hero_enigma_hype"	"ผู้คนมากมายหวาดกลัวสกิลอัลติเมทของเขา Enigma เสกหลุมดำที่สามารถตรึงกองทัพศัตรูเอาไว้ เพื่อให้เพื่อนร่วมทีมของเขาทำลายพวกมัน ด้วยกองทัพ Eidolon ที่คอยอยู่เคียงข้าง เขาสามารถโจมตีศัตรูอย่างหนักหน่วงจากระยะไกล"
"npc_dota_hero_faceless_void_hype"	"เวลาเป็นทุกสิ่งของ Faceless Void เขาเร่งเวลาเพื่อเคลื่อนที่ไปยังอีกพื้นที่อย่างรวดเร็ว ควบคุมเวลาเพื่อหลบการโจมตี หยุดเวลาในพื้นที่เป็นวงกว้างเพื่อทำลายล้างศัตรู และถ่วงเวลาให้มากพอที่จะเก็บรวบรวมทรัพยากร เขาสามารถพัฒนาตัวเองให้แข็งแกร่งได้อย่างไม่น่าเชื่อ"
"npc_dota_hero_gyrocopter_hype"	"คลังกระสุนพร้อม Gyrocopter ถลาเข้าสู่สนามรบ ระเบิดศัตรูด้วยปืนใหญ่และถล่มพวกมันด้วยจรวดจำนวนมาก หากเขาสามารถทำตัวเองให้แข็งแกร่งได้มากพอ การบดขยี้ฝั่งตรงข้ามจะกลายเป็นเรื่องง่ายไปในทันที"
"npc_dota_hero_huskar_hype"	"ยิ่งพลังชีวิตต่ำลงเท่าไหร่ ความสามารถในการสังหารของ Huskar ก็จะยิ่งมากขึ้น ตัดพลังชีวิตของทั้งตัวเองและเป้าหมายได้ด้วยสกิลอัลติเมท เมื่อใกล้ตาย เขาสามารถขว้างหอกไฟโจมตีได้ด้วยความเร็วอันน่าสะพรึงกลัว"
"npc_dota_hero_keeper_of_the_light_hype"	"Keeper of the Light เป็นตัวช่วยที่ดีของทุกทีม ควบคุมมานาของทั้งเพื่อนร่วมทีมและฝั่งตรงข้าม เขาสามารถกวาดศัตรูตัวน้อยได้ด้วยคลื่นแห่งแสง จากนั้นก็เข้าสู่ร่างวิญญาณและรวบรวมทีมของพวกเขาเพื่อครอบครองสนามรบ"
"npc_dota_hero_kunkka_hype"	"Kunkka มักจะทำนายทิศทางที่ศัตรูจะมุ่งไปอยู่เสมอ เขาสามารถโจมตีตำแหน่งนั้นด้วยกระแสน้ำที่พุ่งขึ้นหรือเรือผีที่ผุพังได้ และหากการเล็งของเขาถูกต้อง ตัวเขาและเพื่อนร่วมทีมก็จะไม่มีปัญหาใด ๆ เลยในการเก็บกวาดสิ่งใดก็ตามที่เหลืออยู่"
"npc_dota_hero_legion_commander_hype"	"สวนสนามข้ามผ่านสมรภูมิ Legion Commander ท้าดวลศัตรูของเธอในการต่อสู้แบบหนึ่งต่อหนึ่ง การชนะดวลแต่ละครั้งจะทำให้พลังโจมตีของเธอเพิ่มมากขึ้น จนในที่สุดเธอจะกลายเป็นหญิงแกร่งทรหดเทียบเท่าทั้งกองทัพรวมกัน"
"npc_dota_hero_mirana_hype"	"หลังจากที่เธอเล็งยิงธนูสังหารมาจากระยะไกล Mirana จะต้องพร้อมกระโดดเข้าไปสู่สมรภูมิอยู่เสมอ เนื่องจากสามารถปกปิดพวกพ้องจากสายตาของเหล่าศัตรูได้ จึงรับประกันว่าทีมของเธอจะเคลื่อนที่ได้อย่างแนบเนียน"
"npc_dota_hero_ogre_magi_hype"	"ด้วยโอกาสที่จะเกิดผลซ้อนกันเวลาพวกเขาร่ายเวทแต่ละครั้ง โชคดีคือสิ่งเดียวที่ Ogre Magi ต้องการ เพื่อเผาศัตรูของเขาให้เป็นเถ้าถ่าน หรือเร่งพลังให้กับเพื่อนร่วมทีม และแน่นอนว่าโชคชะตาไม่ใช่สิ่งที่น่าไว้ใจสักเท่าไร..."
"npc_dota_hero_phoenix_hype"	"ด้วยการโฉบเข้าไปในการสู้รบ Phoenix เผาศัตรูและฟื้นฟูพลังชีวิตเพื่อนร่วมทีมด้วยพลังลำแสงแห่งดวงอาทิตย์ เมื่อถึงจังหวะเวลาที่ถูกต้อง มันสามารถเปลี่ยนร่างเป็นดวงอาทิตย์เพื่อเผาผลาญศัตรูรอบข้างก่อนที่จะปลดปล่อยระเบิดสตันที่สามารถฟื้นฟูความแข็งแกร่งของ Phoenix ให้กลับมาเต็มใหม่อีกครั้งได้"
"npc_dota_hero_puck_hype"	"Puck มีความสามารถพิเศษทำให้ศัตรูสับสนด้วยความขี้เล่นอันแสนร้ายกาจ ด้วยการเทเลพอร์ตระยะสั้นไปยังลูกแก้วที่สร้างความเสียหาย มันโจมตีศัตรูด้วยการปล่อยผงฝุ่นใบ้ออกมา กว่าศัตรูจะตั้งตัวได้ Puck ก็ได้หนีหายออกไปนานแล้ว"
"npc_dota_hero_pudge_hype"	"แต่ละครั้งที่ Pudge ค่อย ๆ เล็งและขว้างตะขอเกี่ยวออกไปนั้นสามารถสร้างความหวาดกลัวให้แก่ศัตรูได้ทุกครั้ง ตะขออันเป็นเอกลักษณ์นี้สามารถดึงศัตรูให้เข้ามาใกล้เพื่อนำมาชำแหละด้วยปังตอของเขา เขาจะได้รับพลังชีวิตและพลังโจมตีเพิ่มขึ้นทุกครั้งที่สังหารศัตรู และจะกลายเป็นนักฆ่าที่ไม่มีใครหยุดยั้งได้ในที่สุด"
"npc_dota_hero_queenofpain_hype"	"Queen of Pain จู่โจมโดยไม่มีการเตือนล่วงหน้า ทำลายศัตรูที่อยู่รวมกันด้วยเสียงกรีดร้องที่ทำให้หูหนวก หากมีใครรอดจากการจู่โจมนั้นมาได้ เธอก็จะทำให้พวกเขาหนีได้ช้าลงด้วยการปามีดสั้น ก่อนจะปลิดชีพพวกเขาทิ้ง"
"npc_dota_hero_razor_hype"	"Razor เข้าสู่สนามรบด้วยพายุฝนฟ้าคะนองที่สั่งใดดั่งใจ ปลดปล่อยวงแหวนไฟฟ้ากวาดออกไปย่างสดเหล่าศัตรู เขาเชื่อมต่อตัวเองกับเป้าหมายและดูดกลืนพลัง ก่อนจะใช้มันจัดการกับพวกเขา"
"npc_dota_hero_riki_hype"	"Riki ย่องเข้าสู่สมรภูมิ โดยที่เหล่าศัตรูไม่อาจสังเกตเห็น เขาเลือกจังหวะอย่างรอบคอบและจู่โจมภายใต้เขม่าควันที่ทำให้เป็นใบ้ สังหารศัตรูก่อนที่พวกมันจะรู้ตัวว่าเขาอยู่ที่นั่นเสียอีก"
"npc_dota_hero_sniper_hype"	"ความตายจากระยะไกลคือเรื่องถนัดของ Sniper เขาทำให้ศัตรูตื่นตัวด้วยการยิงรบกวนอย่างสม่ำเสมอ และเมื่อถึงเวลาที่เหมาะสม เขาก็เด็ดหัวพวกมันด้วยกระสุนสังหาร"
"npc_dota_hero_terrorblade_hype"	"สำหรับ Terrorblade ไม่มีสิ่งใดเป็นอย่างที่ตาเห็น เสกร่างเงาอันทรงพลังเพื่อหลอกลวงศัตรูและทำลายการป้องกันของพวกเขา โจรปีศาจตนนี้สามารถแลกเปลี่ยนพลังชีวิตของเขากับศัตรูหรือเพื่อนร่วมทีมเพื่อหลีกเลี่ยงความตาย และทำให้ศัตรูอ่อนแอลง"
"npc_dota_hero_shredder_hype"	"เข้าใจยากและคาดเดาไม่ได้ Timbersaw ตัดผ่านป่ามาตรงหน้าศัตรูของเขา ปลดปล่อยกรงจักรจำนวนมากออกมาชำแหละศัตรูเป็นชิ้น ๆ เขาพุ่งใส่ต้นไม้ใกล้เคียงด้วยโซ่ของเขา พร้อมกับจู่โจมศัตรูไปตลอดทาง"
"npc_dota_hero_ursa_hype"	"ในทุกครั้งที่เขาตะปบกรงเล็บ Ursa ทำให้ศัตรูอ่อนแอลงสำหรับการจู่โจมครั้งต่อไป สามารถเพิ่มความเร็วการโจมตีได้ในระยะเวลาอันสั้น และทำให้เหยื่อรอบตัวเคลื่อนที่ช้าลง เขาสามารถฉีกร่างของศัตรูออกเป็นชิ้นได้ในเวลาอันสั้น"
"npc_dota_hero_venomancer_hype"	"Venomancer นำความตายอันเชื่องช้ามาสู่ศัตรูของเขา แตกหน่อกองทัพจำนวนมหาศาลของผู้สังเกตการณ์ที่พ่นพิษได้เพื่อป้องกันพื้นที่ของเขา หากศัตรูเข้ามาใกล้ เขาก็สามารถปลดปล่อยควันพิษจำนวนมากออกมาทำให้ศัตรูหมดเรี่ยวแรง"
"npc_dota_hero_winter_wyvern_hype"	"Winter Wyvern โผบินเหนือท้องนภา ทำให้ศัตรูช้าลงด้วยการเผาผลาญจากความหนาวเหน็บในขณะที่เธอบินข้ามผ่านสนามรบ หากศัตรูโง่เขลาพอที่จะอยู่รวมตัวกัน เธอสามารถสาปศัตรูเหล่านั้นให้โจมตีพวกเดียวกันเองและสามารถยิงกระสุนน้ำแข็งใส่กลุ่มศัตรูได้อีกด้วย"
"npc_dota_hero_skeleton_king_hype"	"ย่างก้าวไปสู่ศัตรูโดยไม่เกรงกลัวใคร Wraith King สตันศัตรูและฟาดฟันพวกมันให้ยอมจำนนแก่เขา ถ้าหากศัตรูได้เปรียบ สกิลอัลติเมทของเขาทำให้สามารถกลับมาเกิดได้ใหม่อีกรอบ ทำให้กลับมามีโอกาสแกว่งดาบของเขาอีกครั้ง"
"DOTA_AbilityTooltip_Name"	"{s:name}"
"DOTA_AbilityTooltip_Level"	"เลเวล {s:level}"
"DOTA_AbilityTooltip_TargetType"	"ส่งผลต่อ: {s:targettype}"
"DOTA_AbilityTooltip_CastType"	"ประเภทสกิล: {s:casttype}"
"DOTA_AbilityTooltip_DamageType"	"ประเภทความเสียหาย: {s:damagetype}"
"DOTA_AbilityTooltip_SpellImmunityType"	"การป้องกันเวทโดยสมบูรณ์: {s:spellimmunity}"
"DOTA_AbilityTooltip_Description"	"{s:description}"
"DOTA_AbilityTooltip_ScepterDescription"	"{s:scepterdescription}"
"DOTA_AbilityTooltip_ExtraDescription"	"{s:extradescription}"
"DOTA_AbilityTooltip_Attributes"	"{s:attributes}"
"DOTA_AbilityTooltip_Cooldown"	"{s:cooldown}"
"DOTA_AbilityTooltip_ManaCost"	"{s:manacost}"
"DOTA_AbilityTooltip_Lore"	"{s:lore}"
"DOTA_AbilityTooltip_UpgradeLevel"	"อัปสกิลได้เมื่อฮีโร่ถึงเลเวล {d:upgradelevel}"
"DOTA_AbilityTooltip_BuildHeader"	"คู่มือสกิล"
"DOTA_AbilityTooltip_BuildComment"	"{s:buildcomment}"
"DOTA_PersonaTooltip_Title"	"{g:dota_persona:account_id}"
"DOTA_PersonaTooltip_TitlePro"	"{g:dota_persona_pro:account_id}"
"DOTA_PendingInvites"	"คำเชิญปาร์ตี้"
"DOTA_PendingInvitesTooltip_None"	"ไม่มีคำเชิญที่กำลังดำเนินการ"
"DOTA_PendingInvitesTooltip_1"	"1 คำเชิญ กำลังดำเนินการอยู่"
"DOTA_PendingInvitesTooltip_N"	"{d:pending_invite_count} คำเชิญ กำลังดำเนินการอยู่"
"DOTA_PendingInvitesTooltip_Leader"	"คลิกเพื่อจัดการคำเชิญ"
"DOTA_PendingInvitesTooltip_NonLeader"	"คลิกเพื่อดูคำเชิญ"
"DOTA_PendingInvitesCancelAll"	"ยกเลิกคำเชิญทั้งหมด"
"DOTA_PendingInvitesNotPartyLeader"	"เฉพาะหัวหน้าปาร์ตี้เท่านั้นที่สามารถจัดการคำเชิญได้"
"DOTA_ChatTab_NotInChannelMessage"	"ไม่มีใครได้ยินคุณ"
"DOTA_ChatTab_ToggleGlobal"	"แสดงข้อความจากแชนแนลนี้ในทุกแท็บ"
"DOTA_ChatTab_Close"	"ปิดแท็บนี้"
"DOTA_ChatTab_Leave"	"ออกจากแชนแนลนี้"
"DOTA_JoinChatChannel_Title"	"เข้าร่วมแชนแนล"
"DOTA_JoinChatChannel_Description"	"สร้างหรือเข้าร่วมแชนแนลสนทนา"
"DOTA_JoinChatChannel_AddToCurrentTab"	"เพิ่มไปยังแท็บปัจจุบัน '{s:current_tab_name}'"
"DOTA_JoinChatChannel_CreateNewTab"	"สร้างแท็บใหม่:"
"DOTA_Chat_ChannelName"	"{s:channel_name}"
"DOTA_Chat_ChannelMemberCount_Singular"	"1 สมาชิก"
"DOTA_Chat_ChannelMemberCount_Plural"	"{d:channel_member_count} สมาชิก"
"DOTA_EditChatTab_Title"	"ปรับเปลี่ยนแท็บสนทนา"
"DOTA_EditChatTab_Description"	"เลือกข้อความสนทนาที่ต้องการให้แสดงในทุกแท็บ"
"DOTA_EditChatTab_AddNewChannel"	"เพิ่มแชนแนลใหม่..."
"DOTA_EditChatTab_TabName"	"ชื่อแท็บ:"
"DOTA_EditChatTab_ChannelToggleDisabled"	"{s:target} ต้องมีอย่างน้อยหนึ่งแท็บเสมอ"
"DOTA_EditChatTab_Target"	"{s:target}"
"DOTA_Chat_TimestampFormat"	"{t:t:timestamp}"
"DOTA_Chat_Autocomplete_Title"	"{s:autocomplete_title}"
"DOTA_Chat_Autocomplete_NoMatches"	"ไม่พบคำสั่ง"
"DOTA_Chat_Autocomplete_WhisperFriends"	"กระซิบหาเพื่อน"
"DOTA_Chat_Autocomplete_InviteFriends"	"เชิญเพื่อน"
"DOTA_Chat_Autocomplete_Channels"	"แชนแนล"
"DOTA_Chat_Autocomplete_Commands"	"คำสั่ง"
"DOTA_Chat_Autocomplete_CommandName"	"/{s:command_name}"
"DOTA_Chat_Autocomplete_CommandDescription"	"{s:command_description}"
"dota_suggest_invite_format"	"โปรดเชิญ {s:invite_persona} เข้าสู่ปาร์ตี้"
"dota_suggest_invite_format_leader"	"โปรดเชิญ {s:invite_persona} เข้าสู่ปาร์ตี้ ( <a href=\"event:DOTAInviteToParty({s:invite_persona_steamid})\" class=\"InviteButton\">ส่งคำเชิญ</a> )"
"dota_suggest_invite_format_lobby"	"โปรดเชิญ {s:invite_persona} เข้าสู่ล็อบบี้"
"dota_suggest_invite_format_lobby_leader"	"โปรดเชิญ {s:invite_persona} เข้าสู่ล็อบบี้ ( <a href=\"event:DOTAInviteToLobby({s:invite_persona_steamid})\" class=\"InviteButton\">ส่งคำเชิญ</a> )"
"DOTA_ChatTarget_Format_Default"	"{s:target}"
"DOTA_ChatTarget_Prompt_Default"	"ถึง ({s:target}):"
"DOTA_ChatTarget_Format_Whisper"	"{s:persona}"
"DOTA_ChatTarget_Prompt_Whisper"	"ถึง [{s:persona}]:"
"DOTA_ChatTarget_Party"	"ปาร์ตี้"
"DOTA_ChatTarget_Lobby"	"ล็อบบี้"
"DOTA_ChatTarget_Team"	"ทีม"
"DOTA_ChatTarget_Guild"	"กิลด์"
"DOTA_ChatTarget_Fantasy"	"Fantasy"
"DOTA_ChatTarget_Console"	"คอนโซล"
"DOTA_ChatTarget_Whisper"	"กระซิบ"
"DOTA_ChatTarget_Invalid"	"ไม่มีแชนแนล"
"DOTA_ChatTarget_GameAll"	"ทั้งหมด"
"DOTA_ChatTarget_GameAllies"	"เพื่อนร่วมทีม"
"DOTA_ChatTarget_GameCoaching"	"การฝึกสอน"
"DOTA_ChatTarget_GameSpectator"	"ผู้เข้าชม"
"DOTA_ChatTargetMenu_Title"	"{s:target}"
"DOTA_ChatTargetMenu_ToggleEnabled"	"{s:toggle_enabled}"
"DOTA_ChatTargetMenu_NotActive"	"(ไม่ได้ใช้งาน)"
"DOTA_Chat_Placeholder"	"พิมพ์ที่นี่เพื่อสนทนา ใช้ '/' เพื่อสั่งคำสั่ง"
"DOTA_Chat_MissedMessages"	"{s:missed_message_count}"
"DOTA_ChatCommand_Party"	"p"
"DOTA_ChatCommand_Party_Name"	"ปาร์ตี้"
"DOTA_ChatCommand_Party_Description"	"แชทกับปาร์ตี้ปัจจุบัน"
"DOTA_ChatCommand_Lobby"	"l"
"DOTA_ChatCommand_Lobby_Name"	"ล็อบบี้"
"DOTA_ChatCommand_Lobby_Description"	"แชทกับล็อบบี้ปัจจุบัน"
"DOTA_ChatCommand_Channel"	"c"
"DOTA_ChatCommand_Channel_Name"	"แชนแนล"
"DOTA_ChatCommand_Channel_Description"	"แชทกับแชนแนลสนทนาที่ระบุ"
"DOTA_ChatCommand_Whisper"	"w"
"DOTA_ChatCommand_Whisper_Name"	"กระซิบ"
"DOTA_ChatCommand_Whisper_Description"	"กระซิบเป็นการส่วนตัวกับเพื่อน"
"DOTA_ChatCommand_Reply"	"r"
"DOTA_ChatCommand_Reply_Name"	"ตอบกลับ"
"DOTA_ChatCommand_Reply_Description"	"ตอบกลับการกระซิบเป็นการส่วนตัวที่ส่งมาจากเพื่อน"
"DOTA_ChatCommand_Help"	"?"
"DOTA_ChatCommand_Help_Name"	"วิธีใช้"
"DOTA_ChatCommand_Help_Description"	"แสดงวิธีใช้คำสั่งสนทนา"
"DOTA_ChatCommand_InviteToParty"	"partyinvite"
"DOTA_ChatCommand_InviteToParty_Name"	"เชิญเข้าสู่ปาร์ตี้"
"DOTA_ChatCommand_InviteToParty_Description"	"เชิญเพื่อนให้เข้าร่วมปาร์ตี้ปัจจุบัน"
"DOTA_ChatCommand_LeaveParty"	"leaveparty"
"DOTA_ChatCommand_LeaveParty_Name"	"ออกจากปาร์ตี้"
"DOTA_ChatCommand_LeaveParty_Description"	"ออกจากปาร์ตี้ปัจจุบัน"
"DOTA_ChatCommand_JoinChannel"	"joinchannel"
"DOTA_ChatCommand_JoinChannel_Name"	"เข้าร่วมแชนแนล"
"DOTA_ChatCommand_JoinChannel_Description"	"เข้าร่วมหรือสร้างแชนแนลสนทนา"
"DOTA_ChatCommand_LeaveChannel"	"leavechannel"
"DOTA_ChatCommand_LeaveChannel_Name"	"ออกจากแชนแนล"
"DOTA_ChatCommand_LeaveChannel_Description"	"ออกจากแชนแนลสนทนาที่ระบุ"
"DOTA_ChatCommand_GameAll"	"all"
"DOTA_ChatCommand_GameAll_Name"	"ทั้งหมด"
"DOTA_ChatCommand_GameAll_Description"	"สนทนากับผู้เล่นทุกคนในเกม"
"DOTA_ChatCommand_GameAllies"	"allies"
"DOTA_ChatCommand_GameAllies_Name"	"เพื่อนร่วมทีม"
"DOTA_ChatCommand_GameAllies_Description"	"สนนากับเพื่อนร่วมทีมของคุณ"
"DOTA_ChatCommand_GameCoaching"	"coach"
"DOTA_ChatCommand_GameCoaching_Name"	"การฝึกสอน"
"DOTA_ChatCommand_GameCoaching_Description"	"สนทนากับนักเรียนหรือผู้ฝึกสอนของคุณ"
"DOTA_ChatCommand_GameSpectator"	"spectator"
"DOTA_ChatCommand_GameSpectator_Name"	"ผู้เข้าชม"
"DOTA_ChatCommand_GameSpectator_Description"	"สนทนากับผู้เข้าชมคนอื่น ๆ"
"DOTA_ChatCommand_Clear"	"clear"
"DOTA_ChatCommand_Clear_Name"	"ล้าง"
"DOTA_ChatCommand_Clear_Description"	"ล้างการสนทนาทั้งหมดในแท็บนี้"
"DOTA_Chat_UnknownCommandMessage"	"ไม่ทราบคำสั่งสนทนา '{s:chat_command}'"
"DOTA_ChatHelp_Targets"	"เป้าหมาย"
"DOTA_ChatHelp_Commands"	"คำสั่ง"
"DOTA_ChatHelp_NameFormat"	"{s:command_name}:"
"DOTA_ChatHelp_CommandFormat"	"/{s:command}"
"DOTA_Chat_JoinedParty"	"เข้าร่วมปาร์ตี้: {s:party_members}"
"DOTA_Chat_LeftParty"	"ปาร์ตี้ถูกยุบ"
"DOTA_Chat_MemberJoinedParty"	"ผู้เล่นเข้าร่วมปาร์ตี้: {s:party_members}"
"DOTA_Chat_MemberLeftParty"	"ผู้เล่นออกจากปาร์ตี้: {s:party_members}"
"DOTA_Chat_InvitedToJoinParty"	"เชิญ: {s:party_members}"
"DOTA_Chat_RequestedToJoinParty"	"ขอเข้าร่วม: {s:party_members}"
"DOTA_Chat_PartyMemberSeparator"	", "
"DOTA_Feature_Under_Construction_Title"	"อยู่ระหว่างการสร้าง"
"DOTA_Feature_Under_Construction_Text"	"คุณสมบัตินี้กำลังอยู่ระหว่างการสร้าง และยังไม่พร้อมใช้งาน"
"DOTA_Treasure_Purchase_Under_Construction_Text"	"การสั่งซื้อสมบัติยังไม่พร้อมใช้งาน แต่การสั่งซื้อจากร้านค้า Dota ยังรองรับอยู่ ดูชุดเซ็ตไอเท็มได้ที่ด้านซ้ายสุดของรายชื่อชุดเซ็ตไอเท็มที่วางจำหน่าย"
"DOTA_Marketplace_Purchase_Under_Construction_Text"	"การสั่งซื้อจากตลาดชุมชนยังไม่พร้อมใช้งาน แต่การสั่งซื้อจากร้านค้า Dota ยังรองรับอยู่ ดูชุดเซ็ตไอเท็มได้ที่ด้านซ้ายสุดของรายชื่อชุดเซ็ตไอเท็มที่วางจำหน่าย"
"DOTA_PartyJoinRequest_Title"	"คำขอเข้าร่วมปาร์ตี้"
"DOTA_PartyJoinRequest_Description"	"{g:dota_persona:b:inviter} ได้ขอเข้าร่วมปาร์ตี้ของคุณ"
"DOTA_PartyMergeRequest_Title"	"คำขอรวมปาร์ตี้"
"DOTA_PartyMergeRequest_Description"	"{g:dota_persona:b:inviter} ได้ขอให้ปาร์ตี้ของเขาเข้าร่วมปาร์ตี้ของคุณ"
"DOTA_PartyMergeRequestLowPriWarning"	"หมายเหตุ: การยอมรับคำขอนี้จำทำให้ปาร์ตี้ของคุณเปลี่ยนสถานะเป็นความสำคัญต่ำ"
"DOTA_PartyInvite_Title"	"คำเชิญปาร์ตี้"
"DOTA_Invite_IOfN"	"{d:received_invite_index} ของ {d:received_invite_count}"
"DOTA_PartyInvite_Description"	"{g:dota_persona:b:inviter} ได้เชิญคุณเข้าร่วมปาร์ตี้"
"DOTA_PartyInvite_LowPriority_Title"	"คำเชิญปาร์ตี้ความสำคัญต่ำ"
"DOTA_PartyInvite_LowPriority_Description"	"{g:dota_persona:b:inviter} ได้เชิญคุณเข้าร่วมปาร์ตี้ความสำคัญต่ำ"
"DOTA_PartyInvite_BlockPartyLeader"	"บล็อคการติดต่อสื่อสารทั้งหมดจาก {g:dota_persona:b:inviter}"
"DOTA_LobbyInvite_BlockInviter"	"บล็อคการติดต่อสื่อสารทั้งหมดจากผู้เล่นคนนี้"
"DOTA_PartyInvite_BlockNonFriendInvites"	"บล็อคคำเชิญจากผู้เล่นที่ไม่อยู่บนรายชื่อเพื่อน"
"DOTA_PartyInvite_BlockNonFriendInvitesDescription"	"สามารถเปลี่ยนได้ที่ ตัวเลือก/โปรไฟล์ บนแผงตั้งค่า"
"DOTA_PartyInvite_Expired"	"คำขอได้ถูกยกเลิก หรือไม่มีอยู่แล้ว"
"DOTA_PartyInvite_Coach"	"ผู้ฝึกสอน:"
"DOTA_PartyVisTooltip_TitleOpen"	"กำลังมองหาสมาชิกปาร์ตี้"
"DOTA_PartyVisTooltip_TitleNotOpen"	"ไม่ได้มองหาสมาชิกปาร์ตี้"
"DOTA_PartyVisTooltip_SoloNotOpen"	"คลิกเพื่อเปลี่ยนสถานะของคุณ"
"DOTA_PartyVisTooltip_SoloOpen"	"เพื่อนสามารถขอเข้าร่วมกับคุณได้<br/>คลิกเพื่อเปลี่ยนสถานะของคุณ"
"DOTA_PartyVisTooltip_LeaderOpen"	"คำขอเข้าร่วมจากเพื่อนของสมาชิกปาร์ตี้จะถูกยอมรับโดยอัตโนมัติ<br/>คลิกเพื่อเปลี่ยนสถานะเปิดปาร์ตี้ของคุณ"
"DOTA_PartyVisTooltip_LeaderOpenManualAccept"	"เพื่อนของสมาชิกปาร์ตี้สามารถขอเข้าร่วมได้<br/>คลิกเพื่อเปลี่ยนสถานะของคุณ"
"DOTA_PartyVisTooltip_LeaderNotOpen"	"เพื่อนของสมาชิกปาร์ตี้สามารถขอเข้าร่วมได้<br/>คลิกเพื่อตั้งสถานะเปิดปาร์ตี้ ซึ่งจะเพิ่มการแสดงผลที่โดดเด่นให้เพื่อนเห็น"
"DOTA_PartyVisTooltip_NotOpenHidden"	"คุณเป็นสมาชิกที่ซ่อนอยู่ในปาร์ตี้นี้ เนื่องจากการตั้งค่าความเป็นส่วนตัวของคุณ<br/>หมายเหตุ: สมาชิกปาร์ตี้คนอื่นอาจให้เพื่อนของเขาเห็นปาร์ตี้หรือขอเข้าร่วมได้"
"DOTA_PartyVisTooltip_NonLeaderOpen"	"คำขอเข้าร่วมจากเพื่อน<br/>คลิกเพื่อนปิดสถานะเปิดปาร์ตี้"
"DOTA_PartyVisTooltip_NonLeaderNotOpen"	"เพื่อนของสมาชิกปาร์ตี้สามารถขอเข้าร่วมได้<br/>เฉพาะหัวหน้าปาร์ตี้เท่านั้นที่สามารถยอมรับคำขอเข้าร่วมได้<br/>คลิกเพื่อตั้งสถานะเปิดปาร์ตี้ ซึ่งจะเพิ่มการแสดงผลที่โดดเด่นให้เพื่อนเห็น"
"DOTA_TogglePartyOpenMic_Tooltip"	"เปิด/ปิดไมค์ปาร์ตี้"
"DOTA_PartySettings"	"การตั้งค่าปาร์ตี้"
"DOTA_PartySettings_OpenParty"	"เปิดปาร์ตี้นี้เพื่อให้ขอเข้าร่วมได้"
"DOTA_PartySettings_BroadcastToFriends"	"ให้เพื่อนของฉันเห็นเมื่อฉันอยู่ในปาร์ตี้"
"DOTA_PartySettings_OpenState_NotOpen"	"หัวหน้าปาร์ตี้ได้ตั้งปาร์ตี้เป็นเปิดเพื่อให้ขอเข้าร่วมได้"
"DOTA_PartySettings_OpenState_NotOpenLeader"	"ปาร์ตี้นี้ไม่ได้เปิดให้ขอเข้าร่วม"
"DOTA_PartySettings_OpenState_OpenButHiddenFromFriends"	"ปาร์ตี้นี้เปิดให้ขอเข้าร่วมได้ คุณไม่ได้แจ้งปาร์ตี้นี้ให้เพื่อนของคุณเห็น แต่เพื่อนของสมาชิกปาร์ตี้คนอื่นอาจมองเห็นได้"
"DOTA_PartySettings_OpenState_Open"	"ปาร์ตี้นี้เปิดให้ขอเข้าร่วมได้ และเพื่อนของคุณก็มองเห็นได้ และเพื่อนของสมาชิกปาร์ตี้คนอื่นก็อาจมองเห็นได้เช่นกัน"
"DOTA_LobbyInvite_Title"	"คำเชิญล็อบบี้"
"DOTA_LobbyInvite_Description"	"{g:dota_persona:inviter} ได้เชิญคุณเข้าร่วมล็อบบี้"
"DOTA_PartyJoinedLobby_Title"	"เข้าร่วมล็อบบี้"
"DOTA_PartyJoinedLobby_Generic"	"{s:party_leader} ได้ย้ายคุณเข้าสู่ล็อบบี้"
"DOTA_PartyJoinedLobby_Custom"	"{s:party_leader} ได้ย้ายคุณเข้าสู่ล็อบบี้ {s:custom_game}"
"DOTA_PartyLeader"	"หัวหน้าปาร์ตี้"
"DOTA_LobbyKicked_Header"	"ถูกเตะออกจากล็อบบี้"
"DOTA_LobbyKicked_Message"	"คุณถูกเตะออกจากล็อบบี้โดยหัวหน้าล็อบบี้"
"DOTA_PlayerContextMenu_ViewProfile"	"ดูโปรไฟล์"
"DOTA_PlayerContextMenu_ChatWithPlayer"	"ส่งข้อความ"
"DOTA_PlayerContextMenu_InviteToParty"	"เชิญเข้าสู่ปาร์ตี้"
"DOTA_PlayerContextMenu_SuggestInviteToParty"	"แนะนำให้เชิญเข้าสู่ปาร์ตี้"
"DOTA_PlayerContextMenu_KickFromParty"	"เตะออกจากปาร์ตี้"
"DOTA_PlayerContextMenu_SetPartyLeader"	"ตั้งเป็นหัวหน้าปาร์ตี้"
"DOTA_PlayerContextMenu_LeaveParty"	"ออกจากปาร์ตี้"
"DOTA_PlayerContextMenu_CoachParty"	"ฝึกสอนปาร์ตี้นี้"
"DOTA_PlayerContextMenu_StopCoachingParty"	"หยุดการฝึกสอนปาร์ตี้นี้"
"DOTA_PlayerContextMenu_AddFriend"	"เพิ่มเพื่อน"
"DOTA_PlayerContextMenu_RemoveFriend"	"ลบเพื่อน"
"DOTA_PlayerContextMenu_AcceptFriendRequest"	"ยอมรับคำขอเป็นเพื่อน"
"DOTA_PlayerContextMenu_IgnoreFriendRequest"	"ละเว้นคำขอเป็นเพื่อน"
"DOTA_PlayerContextMenu_Spectate"	"เข้าชมเกม"
"DOTA_PlayerContextMenu_InviteToLobby"	"เชิญเข้าสู่ล็อบบี้"
"DOTA_PlayerContextMenu_SuggestInviteToLobby"	"แนะนำให้เชิญเข้าสู่ล็อบบี้"
"DOTA_PlayerContextMenu_KickFromLobby"	"เตะออกจากล็อบบี้"
"DOTA_PlayerContextMenu_KickFromLobbyTeam"	"เตะออกจากทีมล็อบบี้"
"DOTA_FeaturedHero_UnableToLoad"	"ไม่สามารถโหลดฮีโร่ที่โดดเด่นได้"
"DOTA_FeaturedHero_ViewGrid"	"มุมมองแบบตาราง"
"DOTA_FeaturedHero_HeroName"	"{s:hero_name}"
"DOTA_FeaturedHero_ItemName"	"{g:dota_item_name:item_def}"
"DOTA_FeaturedHeroReason_NewHero"	"ฮีโร่ที่เพิ่งเปิดตัวใหม่"
"DOTA_FeaturedHeroReason_NewItem"	"{s:item_rarity} ใหม่"
"DOTA_FeaturedHeroReason_FrequentlyPlayedHero"	"เพราะคุณเพิ่งเล่น"
"DOTA_FeaturedHeroReason_FeaturedItem"	"ไอเท็มโดดเด่น"
"DOTA_FeaturedHeroReason_PopularItem"	"ขายดี"
"DOTA_FeaturedHeroReason_SaleItem"	"กำลังลดราคา"
"DOTA_NewFeaturedHero_WinterWyvern"	"ท่ามกลางวายุอันเหน็บหนาว มังกรโบราณได้ปรากฏตัวขึ้น"
"DOTA_HeroSelectorCategory_Default"	"ฮีโร่ทั้งหมด"
"DOTA_HeroSelectorCategory_NewItems"	"ที่มีไอเท็มใหม่"
"DOTA_HeroSelectorCategory_Favorites"	"ที่ชื่นชอบ"
"DOTA_HeroSelectorCategory_MostPlayed"	"ที่ฉันเล่นบ่อยที่สุด"
"DOTA_HeroSelectorCategory_LeastPlayed"	"ที่ฉันเล่นน้อยที่สุด"
"DOTA_HeroSelectorCategory_HaveItems"	"ที่ฉันมีไอเท็มใส่"
"DOTA_HeroSelectorCategory_PrimaryAttribute_Strength"	"Strength"
"DOTA_HeroSelectorCategory_PrimaryAttribute_Agility"	"Agility"
"DOTA_HeroSelectorCategory_PrimaryAttribute_Intelligence"	"Intelligence"
"DOTA_HeroSelectorCategory_AttackRange_Melee"	"ระยะประชิด"
"DOTA_HeroSelectorCategory_AttackRange_Ranged"	"ระยะไกล"
"DOTA_HeroSelector_SelectHero_Label"	"เลือก"
"DOTA_HeroSelector_ClearFilters"	"ล้างตัวกรอง"
"DOTA_OwnedItemSet_Selector_Title"	"เป็นเจ้าของแล้ว"
"DOTA_EquippedItemSet_Selector_Title"	"สวมใส่อยู่"
"DOTA_OwnedItemSet_Available_Title"	"พร้อมสวมใส่"
"DOTA_FeaturedItemSet_Selector_Title"	"โดดเด่น"
"DOTA_AllItemSet_Selector_Title"	"ทั้งหมด"
"DOTA_ConfirmLANLobby_title"	"ล็อบบี้ท้องถิ่น"
"DOTA_ConfirmLANLobby_desc"	"เกมท้องถิ่นจะถูกโฮสต์บนเครื่องของคุณ ความต้องการของระบบจะมากขึ้นบนเครื่องนี้"
"DOTA_ConfirmLANLobbyDisconnect_title"	"ออกจากล็อบบี้ท้องถิ่น?"
"DOTA_ConfirmLANLobbyDisconnect_desc"	"เกมล็อบบี้นี้จะถูกโฮสต์บนเครื่องของคุณ การยกเลิกการเชื่อมต่อจะยุติเกมสำหรับผู้เล่นทุกคน ดำเนินการต่อ?"
"DOTA_ConfirmLANLobbyDisconnect_ok"	"ใช่ ยกเลิกการเชื่อมต่อ"
"DOTA_Lobby_Settings_General"	"การตั้งค่าล็อบบี้ทั่วไป"
"DOTA_Lobby_Settings_Required"	"จำเป็น"
"DOTA_Lobby_Settings_Confirm"	"{s:lobby_confirm_label}"
"DOTA_Lobby_Settings_Game_Mode"	"โหมดเกม"
"DOTA_Lobby_Settings_Region"	"สถานที่ตั้งเซิร์ฟเวอร์"
"DOTA_Lobby_Settings_Password"	"รหัสผ่านล็อบบี้"
"DOTA_Lobby_Settings_Game_Name"	"ชื่อเกม"
"DOTA_Lobby_Settings_Advanced"	"การตั้งค่าล็อบบี้ขั้นสูง"
"DOTA_Lobby_Settings_Competitive"	"การแข่งขัน"
"DOTA_Lobby_Settings_Starting_Team"	"ทีมที่เริ่มก่อน"
"DOTA_Lobby_Settings_Starting_Team_Random"	"สุ่ม"
"DOTA_Lobby_Settings_Starting_Team_Radiant"	"RADIANT"
"DOTA_Lobby_Settings_Starting_Team_Dire"	"DIRE"
"DOTA_Lobby_Settings_Penalty_Radiant"	"การลงโทษ - RADIANT"
"DOTA_Lobby_Settings_Penalty_Dire"	"การลงโทษ - DIRE"
"DOTA_Lobby_Settings_Penalty_Level_0"	"ไม่มีการลงโทษ"
"DOTA_Lobby_Settings_Penalty_Level_1"	"ระยะเวลาแบน -30 วินาที"
"DOTA_Lobby_Settings_Penalty_Level_2"	"ระยะเวลาแบน -70 วินาที"
"DOTA_Lobby_Settings_Penalty_Level_3"	"ระยะเวลาแบน -110 วินาที"
"DOTA_Lobby_Settings_Penalty_Tooltip"	"เมื่ออยู่ใน Captain's Mode สิ่งนี้จะลดระยะเวลาช่วงแบนของทีมนี้"
"DOTA_Lobby_Settings_Series_Type"	"รูปแบบการแข่งขัน"
"DOTA_Lobby_Settings_No_Series"	"เกมเดียว"
"DOTA_Lobby_Settings_Series_Best_of_3"	"BEST OF 3"
"DOTA_Lobby_Settings_Series_Best_of_5"	"BEST OF 5"
"DOTA_Lobby_Settings_Gameplay_Rules"	"กฎในการเล่น"
"DOTA_Lobby_Settings_Enable_Cheats"	"เปิดการใช้สูตรโกง"
"DOTA_Lobby_Settings_All_Chat"	"สนทนากับทุกคน"
"DOTA_Lobby_Settings_Fill_Bots"	"เติมช่องว่างด้วยบอท"
"DOTA_Lobby_Settings_Bot_Difficulty"	"ระดับความยากของบอท"
"DOTA_Lobby_Settings_Bot_Difficulty_Passive"	"ตั้งรับ"
"DOTA_Lobby_Settings_Bot_Difficulty_Easy"	"ง่าย"
"DOTA_Lobby_Settings_Bot_Difficulty_Medium"	"ปานกลาง"
"DOTA_Lobby_Settings_Bot_Difficulty_Hard"	"ยาก"
"DOTA_Lobby_Settings_Bot_Difficulty_Unfair"	"ขี้โกง"
"DOTA_Lobby_Settings_Version"	"เวอร์ชัน"
"DOTA_Lobby_Settings_Version_Latest"	"ล่าสุด"
"DOTA_Lobby_Settings_Version_Tournament"	"ทัวร์นาเมนต์"
"DOTA_Lobby_Settings_Spectator_Section"	"ผู้ชม"
"DOTA_Lobby_Settings_Dota_TV_Delay"	"ดีเลย์ของ DOTA TV"
"DOTA_Lobby_Settings_Dota_TV_Delay_2_Minutes"	"2 นาที"
"DOTA_Lobby_Settings_Dota_TV_Delay_5_Minutes"	"5 นาที"
"DOTA_Lobby_Settings_Dota_TV_Delay_10_Seconds"	"10 วินาที"
"DOTA_Lobby_Settings_Spectators"	"ผู้สังเกตการณ์"
"DOTA_Lobby_Settings_Spectators_Enabled"	"เปิดการใช้งาน"
"DOTA_Lobby_Settings_Spectators_Disabled"	"ปิดการใช้งาน"
"dota_lobby_settings_hide_password"	"ซ่อนรหัสผ่าน"
"dota_lobby_settings_local_host"	"โฮสต์ท้องถิ่น"
"DOTA_Lobby_Settings_Visibility"	"การมองเห็นล็อบบี้"
"DOTA_Lobby_Settings_Visibility_Public"	"สาธารณะ"
"DOTA_Lobby_Settings_Visibility_Friends"	"เพื่อน"
"DOTA_Lobby_Settings_Visibility_Unlisted"	"ไม่แสดงในรายการ"
"DOTA_Lobby_Settings_Visibility_Tooltip"	"ควบคุมการมองเห็นของล็อบบี้ ล็อบบี้สาธารณะสามารถมองเห็นได้ที่เบราว์เซอร์ล็อบบี้ และในรายชื่อเพื่อน ล็อบบี้เพื่อนสามารถมองเห็นได้เฉพาะเพื่อน แต่ก็สามารเชิญผู้เล่นคนอื่นได้ ล็อบบี้ไม่แสดงในรายการจะไม่สามารถมองเห็นได้ที่เบราว์เซอร์และรายชื่อเพื่อน"
"DOTA_TeamUnsetHeader"	"ยังไม่ตั้งทีม"
"DOTA_TeamUnsetMessage"	"มีอย่างน้อยหนึ่งทีมที่ยังไม่ได้ตั้งชื่อ/สัญลักษณ์ทีม เริ่มการแข่งขันเลยหรือไม่?"
"DOTA_LeagueUnsetHeader"	"ลีกไม่ได้ถูกตั้ง"
"DOTA_LeagueUnsetMessage"	"ไม่มีลีกถูกตั้งในล็อบบี้นี้ แต่คุณสามารถตั้งได้ ต้องการเริ่มแมตช์จริง ๆ หรือ?"
"DOTA_LobbyAllowSpectatingHeader"	"ไม่สามารถเริ่มเกมล็อบบี้ได้"
"DOTA_LobbyAllowSpectatingMessage"	"เกมนี้ต้องถูกตั้งเป็นเข้าชมได้ หากมีผู้เข้าชมในล็อบบี้ เปิดการเข้าชมในแผงการตั้งค่า"
"dota_radiant"	"Radiant"
"dota_dire"	"Dire"
"dota_lobby_team_name_radiant"	"{s:team_name_good_guys}"
"dota_lobby_team_name_dire"	"{s:team_name_bad_guys}"
"dota_lobby_no_team"	"ไม่มีทีม"
"dota_lobby_broadcast_default_channel_name"	"ชื่อแชนแนล"
"dota_lobby_broadcast_join"	"เข้าร่วม"
"dota_lobby_broadcast_leave"	"ออก"
"dota_lobby_broadcast_create"	"สร้างแชนแนลใหม่"
"dota_lobby_broadcast_no_channels"	"ไม่มีแชนแนลผู้พากย์ที่ถูกสร้าง"
"dota_popup_broadcast_channel_edit_title"	"ปรับแต่งแชนแนลผู้พากย์"
"dota_lobby_broadcast_default_channel_name_custom"	"{s:custom_title}"
"dota_popup_broadcast_channel_edit_channel_name"	"ชื่อแชนแนล"
"dota_popup_broadcast_channel_edit_country"	"ประเทศ"
"dota_popup_broadcast_channel_edit_language"	"ภาษา"
"dota_popup_broadcast_channel_edit_save"	"บันทึกเป็นค่าเริ่มต้น และนำไปใช้งานเมื่อเข้าร่วมล็อบบี้ที่ว่างเปล่า"
"DOTA_Lobby_Broadcaster_Channel_Other_Language"	"ภาษาอื่น ๆ"
"lobby_slot_error_header"	"ไม่สามารถเปลี่ยนช่องได้"
"generic_gc_timeout"	"หมดเวลาส่งข้อความ"
"lobby_slot_success_header"	"สำเร็จ"
"lobby_slot_denied"	"คุณไม่ได้รับอนุญาตให้ร่วมเล่นในช่องนี้"
"lobby_slot_cameramanalready"	"ช่องแชนแนลนักพากย์จะมีตากล้องเพียงหนึ่งคนเท่านั้น"
"lobby_slot_cameramanon"	"คุณได้รับเลือกเป็นตากล้องแล้ว"
"lobby_slot_cameramanoff"	"คุณไม่ได้เป็นตากล้องอีกต่อไปแล้ว"
"lobby_slot_error"	"ล้มเหลวในการเปลี่ยนช่องในล็อบบี้"
"lobby_create_timeout"	"สร้างล็อบบี้ล้มเหลว"
"find_match_error"	"ไม่สามารถเข้าคิวค้นหาแมตช์ได้ในขณะนี้"
"DOTA_DialogVariableTest1"	"เรียบง่าย: {s:var}"
"DOTA_DialogVariableTest2"	"ค่าเงิน: {m:money}"
"DOTA_DialogVariableTest3"	"ลิงก์ไอเท็ม: {g:dota_item_link:item_def}"
"DOTA_DialogVariableTest4"	"ราคาไอเท็ม: {g:dota_item_price:item_def}"
"DOTA_DialogVariableTest5"	"ชื่อ ID บัญชี: {g:dota_persona:account_id} ชื่อมืออาชีพ: {g:dota_persona:pro:account_id}"
"DOTA_DialogVariableTest6"	"เรียบง่ายเป็นช่วง: <span class=\"TextSpan\">{s:var}</span>"
"LobbySetting_GameMode"	"โหมดเกม"
"LobbySetting_GameMode_Value"	"{s:lobbysetting_gamemode}"
"LobbySetting_Bots"	"บอท"
"LobbySetting_Bots_Value"	"{s:lobbysetting_bots}"
"LobbySetting_Password"	"รหัสผ่าน"
"LobbySetting_Password_Value"	"{s:lobbysetting_password}"
"LobbySetting_Server"	"เซิร์ฟเวอร์"
"LobbySetting_Server_Value"	"{s:lobbysetting_server}"
"LobbySetting_Cheats"	"สูตรโกง"
"LobbySetting_Cheats_Value"	"{s:lobbysetting_cheats}"
"LobbySetting_Spectators"	"ผู้ชม"
"LobbySetting_Spectators_Value"	"{s:lobbysetting_spectators}"
"LobbySetting_Visibility"	"การมองเห็น"
"LobbySetting_Visibility_Value"	"{s:lobbysetting_visibility}"
"dota_lobby_lan_title"	"ล็อบบี้ท้องถิ่น"
"dota_lobby_coaches_none"	"ผู้ฝึกสอน: ไม่มี"
"dota_lobby_coaches"	"ผู้ฝึกสอน:"
"DOTA_Custom_Game"	"เกมแบบกำหนดเอง"
"DOTA_Custom_Game_Info"	"ข้อมูล"
"DOTA_Custom_Game_View_Details"	"ดูรายละเอียดเกม"
"DOTA_Custom_Game_Author"	"โดย {g:dota_persona:author}"
"DOTA_Custom_Game_Lobby_Count"	"{d:lobby_count} ล็อบบี้"
"DOTA_Custom_Game_Lobby_Count_Plural"	"{d:lobby_count} ล็อบบี้"
"DOTA_Custom_Game_Friend_Lobbies_Alert"	"คุณมีเพื่อน {d:friend_count} คน อยู่ในล็อบบี้เกมเปิด"
"DOTA_Custom_Game_Friend_Lobbies_Alert_Plural"	"คุณมีเพื่อน {d:friend_count} คน อยู่ในล็อบบี้เกมเปิด"
"DOTA_Custom_Game_Quick_Join"	"เข้าร่วมอย่างรวดเร็ว"
"DOTA_Custom_Game_View_Lobbies"	"ดูล็อบบี้"
"DOTA_Custom_Game_Find_Lobby"	"ค้นหาล็อบบี้"
"DOTA_Custom_Game_Create_Lobby"	"สร้างล็อบบี้"
"DOTA_Custom_Game_Game_Page"	"หน้าเกม"
"DOTA_Custom_Game_Workshop_Page"	"หน้าเวิร์กชอป"
"DOTA_Custom_Game_Download_Queued"	"เพิ่มในคิวดาวน์โหลด"
"DOTA_Custom_Game_Downloading"	"กำลังดาวน์โหลด..."
"DOTA_Custom_Game_Downloading_Percent"	"กำลังดาวน์โหลด - {d:lobby_download_percent}%"
"DOTA_Custom_Game_Needs_Update"	"ต้องการการอัปเดต"
"DOTA_Custom_Game_Play"	"เล่น {s:game_mode_name}"
"DOTA_Custom_Game_Uninstall"	"ถอนการติดตั้ง"
"DOTA_Custom_Game_Install"	"ติดตั้ง"
"DOTA_Custom_Game_Installed"	"ติดตั้งแล้ว"
"DOTA_Custom_Game_Not_Installed"	"ยังไม่ได้ติดตั้ง"
"DOTA_Custom_Game_Connect"	"เข้าร่วมล็อบบี้"
"DOTA_Custom_Game_FileSize"	"{d:file_size} MB"
"DOTA_Custom_Game_Name"	"{s:game_mode_name}"
"DOTA_Custom_Game_Released_By"	"เปิดตัวเมื่อ {s:release_date}</b> โดย <b>{g:dota_persona:author}</b>"
"DOTA_Custom_Game_Subscription"	"{s:subscriptions_count} คน สมัครสมาเป็นชิก"
"DOTA_Custom_Game_Subscriptions"	"{s:subscriptions_count} คน สมัครเป็นสมาชิก"
"DOTA_Custom_Game_Rating"	"คะแนน"
"DOTA_Custom_Game_Release_Date"	"เปิดตัวเมื่อ"
"DOTA_Custom_Game_Playing_Now"	"{s:player_count} คน กำลังเล่นในขณะนี้"
"DOTA_Custom_Game_Ratings_Count"	"({d:ratings_count})"
"DOTA_Custom_Game_Description"	"{s:game_description}"
"DOTA_Custom_Game_Last_Updated"	"อัปเดตล่าสุดเมื่อ {s:last_updated_date}"
"DOTA_Custom_Game_Update_Note_Title"	"{s:timestamp}"
"DOTA_Custom_Game_Screenshots"	"ภาพหน้าจอ"
"DOTA_Custom_Game_Map_Label"	"แผนที่"
"DOTA_Custom_Game_Map_Any"	"อะไรก็ได้"
"DOTA_Custom_Game_Update"	"อัปเดต"
"DOTA_Custom_Game_Spectate"	"สังเกตการณ์"
"DOTA_Custom_Game_Already_In_Lobby"	"เล่นเกมปัจจุบันของคุณให้จบ เพื่อเริ่มต้นโหมดเกมนี้"
"DOTA_Custom_Game_Friends_Playing"	"เพื่อนที่กำลังเล่นเกมแบบกำหนดเอง"
"DOTA_Custom_Game_Friends_In_Lobbies"	"{d:friends_in_open_lobbies} คน อยู่ในล็อบบี้เปิด"
"DOTA_Custom_Game_Friends_In_Game"	"{d:friends_in_game} คน กำลังเล่นเกมแบบกำหนดเอง"
"DOTA_Custom_Games_Friends_Play"	"เกมแบบกำหนดเองที่เพื่อนของคุณเล่น"
"DOTA_Custom_Game_Invite_Friend"	"เชิญเพื่อน"
"DOTA_Custom_Game_Tooltip_Subscribers"	"{d:subscriber_count} คน สมัครเป็นสมาชิก"
"DOTA_Custom_Game_Tooltip_Subscriber"	"{d:subscriber_count} คน สมัครเป็นสมาชิก"
"DOTA_Custom_Game_Most_Popular"	"ยอดนิยม"
"DOTA_Custom_Game_Installed_Games"	"เกมที่ติดตั้งแล้ว"
"DOTA_Custom_Game_Favorite_Games"	"แสดงเฉพาะที่ชื่นชอบ"
"DOTA_Custom_Game_Add_Favorite"	"ชื่นชอบ"
"DOTA_Custom_Game_VotePrompt"	"เราควรหาผู้คนมาลองเล่นเกมนี้เพิ่มไหม?"
"DOTA_Custom_Game_DetailsPrompt"	"เยี่ยมชมหน้ารายละเอียดของเกมเพื่อเรียนรู้เพิ่มเติม ติดตั้ง และเล่น"
"DOTA_Custom_Game_Vote_Box_Title"	"ให้คะแนนเวิร์กชอป"
"DOTA_Custom_Game_Vote_Box_Desc"	"ช่วยเกมที่ยังไม่ค่อยมีคนเล่นให้เป็นที่นิยมในชุมชน"
"DOTA_Custom_Game_Vote_Start"	"เริ่มให้คะแนน"
"DOTA_Custom_Game_VoteThanks"	"ขอบคุณสำหรับการให้คะแนน!"
"DOTA_Custom_Game_Vote_PrevLabel"	"เกมก่อนหน้า"
"DOTA_Custom_Game_Vote_NextLabel"	"เกมถัดไป"
"DOTA_Custom_Game_Vote_ControlsLabel"	"ให้คะแนนเวิร์กชอป"
"DOTA_Custom_Game_Vote_YesLabel"	"ใช่ สนับสนุนเกมนี้!"
"DOTA_Custom_Game_Vote_NoLabel"	"ไม่ละ ยังต้องปรับปรุง"
"DOTA_Custom_Game_Vote_SkipLabel"	"ข้ามเกมนี้ไปก่อน ฉันยังไม่มีความเห็น"
"DOTA_Custom_Game_Vote_Up"	"เป็นเกมที่ดี"
"DOTA_Custom_Game_Vote_Down"	"ยังต้องปรับปรุง"
"Video_Support_Coming_Soon"	"การรองรับวิดีโอจะมาเร็ว ๆ นี้"
"DOTA_Custom_Game_Leave_Lobby"	"ออกจากล็อบบี้นี้"
"DOTA_Custom_Game_Suggested_Title"	"เกมที่แนะนำ"
"DOTA_Custom_Game_Suggested_Info"	"รายชื่อจะประกอบไปด้วยเกมต่าง ๆ ที่ได้รับความนิยมหรือได้รับคะแนนจากผู้เล่นในเชิงบวก<br><br>ตัวเลือกจะเปลี่ยนทุก ๆ 30 นาที โดยจะนำเสนอทุก ๆ คนในชุมชนด้วย 15 เกมเดียวกันในเวลาที่กำหนด"
"DOTA_Custom_Game_Addon_Restricted"	"ไม่สามารถทำการดำเนินการนี้ได้ ขณะที่กำลังทำงานในโหมดเครื่องมือส่วนเสริมที่ถูกจำกัด"
"DOTA_Custom_Game_Search"	"ค้นหาเกมแบบกำหนดเอง"
"DOTA_Custom_Lobby_Create_Button"	"สร้างล็อบบี้แบบกำหนดเอง"
"DOTA_Custom_Lobby_Settings_Title"	"สร้างล็อบบี้"
"DOTA_Custom_Lobby_Settings_Mode"	"โหมดเกม"
"DOTA_Custom_Lobby_Settings_Map"	"แผนที่"
"DOTA_Custom_Lobby_LobbyName"	"คำอธิบายเพิ่มเติม"
"DOTA_Custom_Lobby_List_Desc"	"รายชื่อของล็อบบี้ส่วนตัว (ป้องกันด้วยรหัสผ่าน) และเกมแบบกำหนดเองที่พร้อมที่ไม่ได้กรอง"
"DOTA_Custom_Lobby_Public"	"สาธารณะ"
"DOTA_Custom_Lobby_Passworded"	"ผู้เล่นสามารถเข้าร่วมล็อบบี้นี้ผ่านการเชิญหรือการกรองรายชื่อล็อบบี้โดยใช้รหัสผ่านเท่านั้น"
"DOTA_Custom_Lobby_Join_Failed_Title"	"การเข้าร่วมล้มเหลว"
"DOTA_Custom_Lobby_Join_Failed_Reason"	"{s:join_error}"
"DOTA_Custom_Lobby_Join_Failed_Prompt"	"ต้องการค้นหาล็อบบี้เปิด {s:game_name} ตอนนี้เลยไหม?"
"DOTA_Lobby_Failed_Pings"	"ล้มเหลวในการรวบรวมข้อมูลค่าปิง โปรดตรวจสอบให้แน่ใจว่าการเชื่อมต่ออินเทอร์เน็ตของคุณทำงาน และเซิร์ฟเวอร์ Dota 2 กำลังออนไลน์"
"DOTA_Custom_Lobby_Create_Private_Button"	"สร้างล็อบบี้ส่วนตัว"
"DOTA_Custom_Lobby_Find_Private_Button"	"ค้นหาล็อบบี้ส่วนตัว"
"DOTA_Custom_Lobby_Find_Private_Title"	"ค้นหาล็อบบี้ส่วนตัว"
"DOTA_Custom_Lobby_Find_Private_Desc"	"ป้อนรหัสผ่านเพื่อค้นหาล็อบบี้ส่วนตัว"
"DOTA_Custom_Lobby_List_Game_Header"	"เกม"
"DOTA_Custom_Lobby_List_Name_Header"	"คำอธิบาย"
"DOTA_Custom_Lobby_List_Players_Header"	"ผู้เล่น"
"DOTA_Custom_Lobby_List_Map_Header"	"แผนที่"
"DOTA_Custom_Lobby_List_Region_Header"	"ภูมิภาค"
"DOTA_Custom_Lobby_List_Connection_Header"	"การเชื่อมต่อ"
"DOTA_Custom_Lobby_List_Status_Header"	"สถานะภายในเครื่อง"
"DOTA_Custom_Lobby_List_Game"	"{s:lobby_game}"
"DOTA_Custom_Lobby_List_Lobby_Name"	"{s:lobby_name}"
"DOTA_Custom_Lobby_List_Players"	"{s:lobby_players} / {s:lobby_max_players}"
"DOTA_Custom_Lobby_List_Map"	"{s:lobby_map}"
"DOTA_Custom_Lobby_List_Region"	"{s:lobby_region}"
"DOTA_Custom_Lobby_List_Connection"	"..."
"DOTA_Custom_Lobby_List_Status"	"{s:lobby_status}"
"DOTA_Custom_Lobby_List_Connect"	"{s:connect_button_text}"
"DOTA_Custom_Lobby_Game_Name"	"{s:game_name}"
"DOTA_Custom_Lobby_Map_Name"	"แผนที่: {s:map_name}"
"DOTA_Custom_Lobby_Player_Count"	"ผู้เล่น: {d:player_count} / {d:max_player_count}"
"DOTA_Custom_Lobby_Player_Count_Short"	"{d:player_count} / {d:max_player_count}"
"DOTA_Custom_Lobby_Visibility"	"การมองเห็นล็อบบี้"
"DOTA_Custom_Join_Chat"	"เข้าร่วมแท็บสนทนา"
"DOTA_Custom_Join_Chat_Member_Count"	"({d:ChatMemberCount})"
"DOTA_Custom_Leave_Chat"	"ออกจากแท็บสนทนา"
"DOTA_Custom_Game_Vote_Up_Tooltip"	"คลิกเพื่อถูกใจเกมนี้บนเวิร์กชอป Steam"
"DOTA_Page_Number"	"หน้า: {d:current_page} / {d:num_pages}"
"DOTA_TabName_ModsOverview"	"ภาพรวม"
"DOTA_TabName_ModsSubscribed"	"คลัง"
"DOTA_TabName_ModsWorkshop"	"เวิร์กชอป"
"DOTA_TabName_ModsBrowse"	"เปิดหา"
"DOTA_WatchTabName_Live"	"สด"
"DOTA_WatchTabName_Featured"	"โดดเด่น"
"DOTA_WatchTabName_Replays"	"รีเพลย์"
"DOTA_WatchTabName_Tournaments"	"ทัวร์นาเมนต์"
"DOTA_WatchTabName_Downloads"	"ดาวน์โหลด"
"DOTA_WatchLive_Search"	"ค้นหาฮีโร่ที่ต้องการเข้าชม"
"DOTA_WatchLive_DataPending"	"กำลังค้นหาเกมถ่ายทอดสด..."
"DOTA_WatchLive_DataError"	"ล้มเหลวในการโหลดเกมถ่ายทอดสด"
"DOTA_WatchLive_NoGames"	"ไม่มีเกมถ่ายทอดสดที่กำลังถูกเล่นในขณะนี้"
"DOTA_WatchLive_Connecting"	"กำลังรอข้อมูลเกม..."
"DOTA_WatchLive_HeroFilter"	"ตัวกรอง: {s:hero_filter_name}"
"DOTA_WatchLive_CountSpec"	"{i:num_spectating} คนกำลังรับชม"
"DOTA_WatchLive_CountSpecFriend"	"เพื่อน {i:num_friends_spectating} คนและอีก {i:num_spectating} คนกำลังรับชม"
"DOTA_WatchLive_CountSpecFriends"	"เพื่อน {i:num_friends_spectating} คนและอีก {i:num_spectating} คนกำลังรับชม"
"DOTA_WatchLive_CountFriends"	"เพื่อน {i:num_friends_playing} คนกำลังเล่น"
"DOTA_WatchLive_ParticipantsUnranked"	"เกมไม่จัดอันดับ"
"DOTA_WatchLive_Participants1"	"{s:friend_1}"
"DOTA_WatchLive_Participants2"	"{s:friend_1} และ {s:friend_2}"
"DOTA_WatchLive_Participants3"	"{s:friend_1}, {s:friend_2} และ {s:friend_3}"
"DOTA_WatchLive_Participants4Plus"	"{s:friend_1}, {s:friend_2}, {s:friend_3} และเพื่อนอีก {i:friend_count_over_3} คน"
"DOTA_WatchLive_MatchType_MM_Kills"	"{s:game_mode}"
"DOTA_WatchLive_MatchType_MM"	"{s:game_mode}"
"DOTA_WatchLiveDotaTV"	"รับชมใน DotaTV"
"DOTA_WatchLivePurchase"	"ซื้อตั๋วเข้าชมทัวร์นาเมนต์ {g:dota_item_price:ticket_itemdef}"
"DOTA_WatchLiveSpectatorFriends1"	"{g:dota_persona:spectator_friend_1} กำลังรับชม"
"DOTA_WatchLiveSpectatorFriends2"	"{g:dota_persona:spectator_friend_1} และ {g:dota_persona:spectator_friend_2} กำลังรับชม"
"DOTA_WatchLiveSpectatorFriends3"	"{g:dota_persona:spectator_friend_1}, {g:dota_persona:spectator_friend_2} และ {g:dota_persona:spectator_friend_3} กำลังรับชม"
"DOTA_WatchLiveSpectatorFriends4Plus"	"{g:dota_persona:spectator_friend_1}, {g:dota_persona:spectator_friend_2}, {g:dota_persona:spectator_friend_3} และเพื่อนอีก {i:spectator_friend_count_over_3} คนกำลังรับชม"
"DOTA_WatchLiveSpectatorCount"	"{i:spectator_count} คนกำลังรับชม"
"DOTA_WatchLivePreGame"	"รอเริ่มเกม"
"DOTA_WatchLive_ElapsedTime"	"เวลาที่ผ่านไป:"
"DOTA_WatchLive_Spectating"	"ผู้ชม:"
"DOTA_WatchReplays_TournamentsHeader"	"แมตช์ทัวร์นาเมนต์ยอดนิยม"
"DOTA_WatchReplays_FriendsHeader"	"แมตช์ของเพื่อน"
"DOTA_WatchReplays_Popular"	"แมตช์ยอดนิยม"
"DOTA_WatchReplays_SavedForLater"	"บันทึกไว้ดูในภายหลัง"
"DOTA_WatchReplays_ParticipantsVs"	"{s:team_1} ปะทะ {s:team_2}"
"DOTA_WatchReplays_MatchType_League"	"{s:league_name}"
"DOTA_WatchReplays_MatchType_Public"	"แมตช์ {s:match_id} - {s:game_mode}"
"DOTA_WatchReplays_Recommendations"	"{i:recommendations}"
"DOTA_WatchReplays_Recommendations1"	"{g:dota_persona:friend_1} + {i:recommendations}"
"DOTA_WatchReplays_Recommendations2"	"{g:dota_persona:friend_1}, {g:dota_persona:friend_2} + {i:recommendations}"
"DOTA_WatchReplays_Recommendations3Plus"	"{g:dota_persona:friend_1} + เพื่อนอีก {i:friend_count_over_1} คน + {i:recommendations}"
"DOTA_WatchReplays_Friends1"	"{g:dota_persona:b:friend_1} ได้เล่น"
"DOTA_WatchReplays_Friends2"	"{g:dota_persona:b:friend_1} และ {g:dota_persona:friend_2} ได้เล่น"
"DOTA_WatchReplays_Friends3Plus"	"{g:dota_persona:b:friend_1}, {g:dota_persona:b:friend_2} และเพื่อนอีก {i:friend_count_over_2} คน"
"DOTA_WatchReplays_Views"	"{i:views} ผู้ชม"
"DOTA_WatchReplays_Price"	"{g:dota_item_price:ticket_itemdef}"
"DOTA_WatchReplays_SharedMatch"	"{g:dota_persona:shared_by} ได้แบ่งปัน - '{s:shared_text}'"
"DOTA_WatchReplays_SharedHighlight"	"{g:dota_persona:shared_by} ได้แบ่งปันไฮไลต์"
"DOTA_WatchReplays_Duration"	"{s:minutes}:{s:seconds}"
"DOTA_WatchReplays_Tag"	"\"{s:recommendation_text}\""
"DOTA_WatchTournaments_FeaturedTitle"	"{s:tournament_featured_title}"
"DOTA_WatchTournaments_FeaturedDates"	"{s:tournament_featured_start} - {s:tournament_featured_end}"
"DOTA_WatchTournaments_FeaturedDescription"	"{s:tournament_featured_description}"
"DOTA_WatchTournaments_FeaturedTeams"	"ทีม"
"DOTA_WatchTournaments_PrizePool"	"เงินรางวัลรวม:"
"DOTA_WatchTournaments_PrizePoolAmt"	"{s:tournament_featured_prize_pool}"
"DOTA_WatchTournaments_Purchase"	"ตั๋วเข้าชมทัวร์นาเมนต์ - {s:tournament_featured_price}"
"DOTA_WatchTournament_TournamentName"	"{s:tournament_name}"
"DOTA_WatchTournament_Price"	"{s:price}"
"DOTA_Replays_Search"	"ค้นหาไอดีแมตช์"
"DOTA_Watch_GameStatus"	"สถานะเกมที่เข้าชม"
"DOTA_Watch_Pending"	"กำลังรอเพื่อรับชมเกม..."
"DOTA_Watch_GameServerNotFound"	"ไม่พบเซิร์ฟเวอร์ที่ใช้เป็นโฮสต์เกมนี้"
"DOTA_Watch_Unavailable"	"ไม่สามารถรับชมเกมนี้ได้ในขณะนี้"
"DOTA_Watch_LobbyNotFound"	"ไม่พบล็อบบี้"
"DOTA_Watch_MissingLeagueSubscription"	"เกมนี้เป็นประเภทเกมลีกซึ่งจะต้องลงทะเบียนก่อนเข้าชม"
"vs"	"ปะทะ"
"dota_matchmaking_language_title"	"เลือกภาษาการค้นหาคู่ต่อสู้"
"dota_matchmaking_language_primary_label"	"ภาษาหลักสำหรับการค้นหาคู่ต่อสู้ของคุณคือ:"
"dota_matchmaking_language_primary"	"{s:environment_language}"
"dota_matchmaking_language_primary_invalid"	"ภาษาของคุณ (ภาษา{s:environment_language}) นั้นไม่สามารถใช้เป็นภาษาสำหรับค้นหาคู่ต่อสู้ใน Dota 2 ได้"
"dota_matchmaking_language_select_secondary"	"หากคุณต้องการ คุณสามารถเลือกภาษารองของคุณได้:"
"dota_matchmaking_language_select_primary"	"กรุณาเลือกภาษาสำหรับการค้นหาคู่ต่อสู้:"
"dota_matchmaking_language_no_selection"	"ไม่เลือก"
"dota_matchmaking_language_english"	"อังกฤษ"
"dota_matchmaking_language_russian"	"รัสเซีย"
"dota_matchmaking_language_chinese"	"จีน"
"dota_matchmaking_language_schinese"	"จีน"
"dota_matchmaking_language_korean"	"เกาหลี"
"dota_matchmaking_language_koreana"	"เกาหลี"
"dota_matchmaking_language_spanish"	"สเปน"
"dota_matchmaking_language_portuguese"	"โปรตุเกส"
"GameUI_Language_English"	"อังกฤษ"
"GameUI_Language_German"	"เยอรมัน"
"GameUI_Language_French"	"ฝรั่งเศส"
"GameUI_Language_Italian"	"อิตาลี"
"GameUI_Language_Korean"	"เกาหลี"
"GameUI_Language_Spanish"	"สเปน"
"GameUI_Language_Simplified_Chinese"	"จีนตัวย่อ"
"GameUI_Language_Traditional_Chinese"	"จีนตัวเต็ม"
"GameUI_Language_Russian"	"รัสเซีย"
"GameUI_Language_Thai"	"ไทย"
"GameUI_Language_Japanese"	"ญี่ปุ่น"
"GameUI_Language_Portuguese"	"โปรตุเกส"
"GameUI_Language_Polish"	"โปแลนด์"
"GameUI_Language_Danish"	"เดนมาร์ก"
"GameUI_Language_Dutch"	"ดัตช์"
"GameUI_Language_Finnish"	"ฟินแลนด์"
"GameUI_Language_Norwegian"	"นอร์เวย์"
"GameUI_Language_Swedish"	"สวีเดน"
"GameUI_Language_Hungarian"	"ฮังการี"
"GameUI_Language_Czech"	"เช็ก"
"GameUI_Language_Romanian"	"โรมาเนีย"
"GameUI_Language_Turkish"	"ตุรกี"
"GameUI_Language_Brazilian"	"โปรตุเกส-บราซิล"
"GameUI_Language_Bulgarian"	"บัลแกเรีย"
"GameUI_Language_Greek"	"กรีก"
"GameUI_Language_Ukrainian"	"ยูเครน"
"client_version_out_of_date_title"	"ต้องการการอัปเดต"
"client_version_out_of_date"	"ตัวเกมของคุณเก่าเกินไป กรุณาปิด Dota 2 และเริ่มใหม่อีกครั้งเพื่อปรับให้เป็นเวอร์ชันล่าสุด"
"dota_matchmaking_region_title"	"เลือกภูมิภาคการค้นหาคู่ต่อสู้"
"dota_matchmaking_region_auto"	"เลือกภูมิภาคที่ดีที่สุดโดยขึ้นอยู่กับตำแหน่งของฉัน"
"dota_matchmaking_region_select"	"เลือกภูมิภาคการค้นหาคู่ต่อสู้ได้สูงสุดสามภูมิภาค ควรเลือกภูมิภาคที่อยู่ใกล้เคียงกับคุณที่สุดเพื่อให้สามารถเล่นได้ดีที่สุด"
"limited_heroes_abandon_header"	"โหมด Limited Heroes"
"limited_heroes_abandon_explanation"	"จะไม่มีบทลงโทษเมื่อออกจากเกมในแมตช์โหมดเกม Limited Heroes ฮีโร่ของคุณจะถูกเล่นแทนโดยบอท แต่ถ้าหากออกจากเกมในโหมดเกมอื่นอาจทำให้คุณถูกบังคับให้เล่นในแมตช์ความสำคัญต่ำ"
"dota_abandon_dialog_title"	"ละทิ้งเกม"
"dota_abandon_dialog_confirm"	"คุณแน่ใจหรือว่าจะละทิ้งเกมนี้กลางคัน?"
"dota_abandon_dialog_yes"	"ใช่ ละทิ้งเกมนี้"
"dota_leave_dialog_title"	"ออกจากเกม"
"dota_leave_dialog_confirm"	"คุณแน่ใจหรือว่าต้องการที่จะออกจากเกมนี้?"
"dota_leave_dialog_yes"	"ใช่ ออกจากเกม"
"dota_accept_match_title"	"เกมของคุณพร้อมแล้ว"
"dota_accept_match_readyup_title"	"กำลังรอผู้เล่น"
"dota_accept_match_accept"	"ยอมรับ"
"dota_accept_match_accept_low_pri"	"ยอมรับแมตช์ความสำคัญต่ำ"
"dota_accept_match_accept_button"	"{s:accept}"
"dota_accept_match_decline"	"ปฏิเสธ"
"dota_accept_match_subtitle"	"{s:subtitle}"
"dota_finding_match_players"	"( {s:searching_player_count} คน กำลังค้นหาอยู่ )"
"dota_finding_match_time"	"เวลาค้นหาแมตช์: {s:find_match_time}"
"dota_finding_match_accept_count"	"ยอมรับแมตช์: {s:match_num_accepted} / {s:match_num_total}"
"dota_finding_match_generic"	"แมตช์ธรรมดา"
"dota_finding_match_ranked"	"แมตช์จัดอันดับ"
"dota_finding_match_bot"	"แมตช์สู้กับบอท"
"dota_finding_match_bot_passive"	"แมตช์สู้กับบอท ( ตั้งรับ )"
"dota_finding_match_bot_easy"	"แมตช์สู้กับบอท ( ง่าย )"
"dota_finding_match_bot_medium"	"แมตช์สู้กับบอท ( ปานกลาง )"
"dota_finding_match_bot_hard"	"แมตช์สู้กับบอท ( ยาก )"
"dota_finding_match_bot_unfair"	"แมตช์สู้กับบอท ( ขี้โกง)"
"dota_finding_match_team"	"แมตช์จัดอันดับแบบทีม"
"dota_finding_1v1_match_casual"	"แมตช์ 1v1"
"dota_finding_match_practice_lobby"	"เกมล็อบบี้"
"dota_safe_to_abandon_inline"	"ปลอดภัยที่จะออกจากเกมนี้"
"dota_match_connected"	"กำลังเชื่อมต่อเกมอยู่"
"dota_match_local_game"	"กำลังเชื่อมต่อกับเกมท้องถิ่น"
"dota_match_connecting"	"กำลังเชื่อมต่อเข้าสู่เกม..."
"dota_match_in_progress"	"เกมกำลังดำเนินอยู่"
"dota_match_finished"	"เกมได้จบลงแล้ว"
"matchmaking_waiting_for_players"	"กำลังรอผู้เล่นอื่น"
"matchmaking_player_declined"	"มีผู้เล่นปฏิเสธที่จะเล่น"
"dota_match_wait_for_host"	"กำลังรอโฮสต์"
"dota_match_find_server"	"กำลังค้นหาเซิร์ฟเวอร์"
"ranked_disabled"	"การค้นหาแมตช์จัดอันดับถูกปิดการใช้งานชั่วคราว"
"ranked_mmr"	"คะแนนจัดอันดับของคุณ"
"ranked_mmr_solo_label"	"เดี่ยว"
"ranked_mmr_solo_value"	"{i:solo_mmr}"
"ranked_mmr_solo_calibrating"	"รอผล - เหลืออีก {i:solo_calibrating_games} เกม"
"ranked_mmr_solo_no_data"	"ต้องการ {i:solo_calibrating_required_games} เกมเพื่อปรับเทียบ"
"ranked_mmr_party_label"	"ปาร์ตี้"
"ranked_mmr_party_value"	"{i:party_mmr}"
"ranked_mmr_party_calibrating"	"รอผล - เหลืออีก {i:party_calibrating_games} เกม"
"ranked_mmr_party_no_data"	"ต้องการ {i:party_calibrating_required_games} เกมเพื่อปรับเทียบ"
"ranked_mmr_locked_explain"	"การค้นหาแมตช์จัดอันดับ:\nปลดล็อคเมื่อถ้วยรางวัลประสบการณ์ระดับ 50\nโหมดเกมที่มีการแข่งขันสูงขึ้นซึ่งติดตามและแสดงผล MMR (คะแนนการจัดอันดับ) ของผู้เล่นแต่ละคน"
"matchmaking_account_disabled"	"คุณได้สร้างความวุ่นวายมากเกินไป คุณจะไม่สามารถสนทนาหรือเข้าร่วมค้นหาคู่ต่อสู้ เวลาที่เหลือ: {t:r:match_denied_time}"
"matchmaking_match_disabled_party"	"{s:match_denied_player_name} ถูกห้ามค้นหาคู่ต่อสู้ เนื่องจากล้มเหลวในการยอมรับเกมหรือการละทิ้งเกมล่าสุด เวลาที่เหลือ: {t:r:match_denied_time}"
"matchmaking_low_priority_party"	"{s:match_denied_player_name} ถูกบังคับให้ค้นหาแมตช์ความสำคัญต่ำเท่านั้น เนื่องจากละทิ้งเกมหรือได้รับรายงานผู้เล่นเกินกำหนด จำนวนเกมที่เหลือ: {d:match_denied_games}"
"matchmaking_match_disabled_local"	"คุณถูกห้ามค้นหาคู่ต่อสู้ เนื่องจากล้มเหลวในการยอมรับเกมหรือการละทิ้งเกมล่าสุด เวลาที่เหลือ: {t:r:match_denied_time}"
"matchmaking_low_priority_local"	"คุณจะสามารถค้นหาแมตช์ความสำคัญต่ำเท่านั้น เนื่องจากละทิ้งเกมหรือได้รับรายงานผู้เล่นเกินกำหนด จำนวนเกมที่เหลือ: {d:match_denied_games}"
"dota_ready_up_count"	"{s:ready_up_ready} / {s:ready_up_lobby_members}"
"dota_play_normal_match"	"แมตช์ธรรมดา"
"dota_play_ranked_match"	"แมตช์จัดอันดับ"
"dota_play_practice_1v1"	"ฝึกซ้อม 1v1"
"dota_play_practice_with_bots"	"ฝึกซ้อมกับบอท"
"dota_play_practice_1v1_playtab"	"ฝึกซ้อม 1v1"
"dota_play_1v1_desc"	"ฝึกซ้อมการเล่นแบบลุยเดี่ยวเลนกลางของคุณกับผู้เล่นคนอื่นหนึ่งคน การฝึกซ้อมจะจบลงเมื่อผู้เล่นคนใดคนหนึ่งตายสองครั้งหรือสูญเสียป้อมปราการ"
"dota_play_practice_1v1_party_warning"	"ปาร์ตี้ไม่ได้รับอนุญาตให้ค้นหาแมตช์ 1v1"
"dota_play_button_label"	"{s:play_button_label}"
"dota_play"	"เล่น Dota"
"dota_play_searching"	"กำลังค้นหาแมตช์"
"dota_play_connecting"	"โฮสต์กำลังโหลด..."
"dota_play_lobby_find_server"	"กำลังค้นหาเซิร์ฟเวอร์"
"dota_play_find_match_label"	"{s:find_match_label}"
"dota_reconnect"	"เชื่อมต่ออีกครั้ง"
"dota_abandon_game"	"ละทิ้ง"
"dota_safe_leave_game"	"ออกจากเกม"
"dota_disconnect"	"ยกเลิกการเชื่อมต่อ"
"dota_play_unavailable"	"ไม่มี"
"dota_leaver_consequence_tooltip_header"	"ผลกระทบ"
"dota_leaver_consequences"	"{s:leaver_consequences}"
"dota_leaver_consequences_details"	"{s:leaver_consequences_details}"
"dota_leaver_view_tooltip"	"ดูรายละเอียด"
"dota_leaver_consequence_header_failure_to_reconnect"	"หากล้มเหลวในการเชื่อมต่ออีกครั้งจะส่งผลกระทบดังต่อไปนี้:"
"dota_leaver_consequence_header_leave_match"	"การออกจากแมตช์นี้จะส่งผลกระทบในด้านลบ"
"dota_leaver_consequence_LetDownTeammates"	"เพื่อนร่วมทีมของคุณจะเสียเปรียบในการเล่น"
"dota_leaver_consequence_SmallMatchmakingCooldown"	"คุณจะไม่สามารถค้นหาแมตช์ในช่วงเวลาครู่หนึ่ง"
"dota_leaver_consequence_CreditWithAbandon"	"คุณจะได้รับผลว่าละทิ้งเกม"
"dota_leaver_consequence_ForcedLossForLeaver"	"คุณจะได้รับผลว่าแพ้"
"dota_leaver_consequence_ForcedLossForLeaversParty"	"ทุกคนในปาร์ตี้ของคุณจะได้รับผลว่าแพ้"
"dota_leaver_consequence_ForcedLossForLeaversTeam"	"ทีมของคุณ (%s1) จะได้รับผลว่าแพ้"
"dota_leaver_consequence_MMRLossForLeaver"	"MMR ของคุณจะลดลง"
"dota_leaver_consequence_MMRLossForLeaversParty"	"MMR ของทุกคนในปาร์ตี้ของคุณจะลดลง"
"dota_leaver_consequence_MMRLossForLeaversTeam"	"MMR ทีมของคุณ (%s1) จะลดลง"
"dota_leaver_consequence_MatchDiscardedForOtherPlayers"	"ผู้เล่นคนอื่น ๆ ในแมตช์นี้จะไม่ได้รับผลคะแนน"
"dota_leaver_consequence_NotDecrementLowPriGamesRemaining"	"คุณจะไม่ถูกนับเป็นผู้เล่นจนจบแมตช์"
"dota_reconnect_popup_title"	"เชื่อมต่ออีกครั้ง?"
"dota_reconnect_popup_message"	"ข้อความแทนที่ - คุณต้องการเชื่อมต่อเกมอีกครั้งหรือไม่?"
"dota_matchmaking_regions_refresh"	"รีเฟรชค่าปิง"
"dota_matchmaking_region_ping"	"{s:region_ping}"
"dota_matchmaking_region_offline"	"ออฟไลน์เพื่อการซ่อมบำรุง"
"dota_matchmaking_region_unknown_ping"	"ค่าปิง: ไม่ทราบ"
"dota_matchmaking_region_ping_time"	"ค่าปิง: {i:ping_ms} มิลลิวินาที"
"DOTA_VAC_Verification_Header"	"Valve Anti-Cheat (VAC)"
"DOTA_VAC_Verification_Header_Solo"	"ไม่สามารถเข้าร่วมการค้นหาคู่ต่อสู้ได้ เนื่องจากมีปัญหาคอมพิวเตอร์ของคุณกำลังระงับการทำงานของระบบ VAC กรุณาตรวจสอบให้แน่ใจว่าคุณไม่ได้ใช้โปรแกรมใดที่อาจขัดขวางการทำงานของ VAC และยืนยันว่า Steam ได้ติดตั้งอย่างถูกต้องแล้ว"
"DOTA_VAC_Verification_Button1"	"ข้อมูลเพิ่มเติม"
"DOTA_VAC_Verification_Button2"	"ปิด"
"dota_matchmaking_regions_button"	"{s:regions_selected}"
"dota_region_automatic"	"ภูมิภาค: อัตโนมัติ"
"dota_regions_selected"	"ภูมิภาค: "
"dota_lobby_region_invalid"	"ไม่มี"
"dota_play_no_language_selected"	"เลือกภาษา"
"dota_play_language"	"{s:match_language}"
"dota_play_language_many"	"ภาษา: {i:match_language_count}"
"dota_ready_fail"	"ล้มเหลวในการเตรียมความพร้อม"
"dota_ready_fail_desc"	"เกมของคุณพร้อมแล้ว แต่คุณไม่ตอบสนอง จึงถูกขับออกจากกลุ่มค้นหาคู่ต่อสู้"
"dota_all_chat_label"	"[ทั้งหมด]"
"dota_chatwheel_label_Ok"	"โอเค"
"dota_chatwheel_label_Care"	"ระวัง"
"dota_chatwheel_label_GetBack"	"ถอยกลับ"
"dota_chatwheel_label_NeedWards"	"ต้องการ Ward"
"dota_chatwheel_label_Stun"	"สตัน"
"dota_chatwheel_label_Help"	"ช่วยด้วย"
"dota_chatwheel_label_Push"	"ดัน"
"dota_chatwheel_label_GoodJob"	"เล่นได้ดี"
"dota_chatwheel_label_Missing"	"หาย"
"dota_chatwheel_label_Missing_Top"	"เลนบนหาย"
"dota_chatwheel_label_Missing_Mid"	"เลนกลางหาย"
"dota_chatwheel_label_Missing_Bottom"	"เลนล่างหาย"
"dota_chatwheel_label_Go"	"ไป!"
"dota_chatwheel_label_Initiate"	"เปิดให้ที!"
"dota_chatwheel_label_Follow"	"ตามฉันมา"
"dota_chatwheel_label_Group_Up"	"รวมกลุ่ม"
"dota_chatwheel_label_Spread_Out"	"กระจายกันออกไป"
"dota_chatwheel_label_Split_Farm"	"แยกกันไปฟาร์ม"
"dota_chatwheel_label_Attack"	"โจมตีเลย!"
"dota_chatwheel_label_BRB"	"เดี๋ยวกลับมา"
"dota_chatwheel_label_Dive"	"เข้าไปเลย!"
"dota_chatwheel_label_OMW"	"กำลังไป"
"dota_chatwheel_label_Get_Ready"	"เตรียมพร้อม"
"dota_chatwheel_label_Bait"	"เหยื่อล่อ"
"dota_chatwheel_label_Heal"	"ฮีลหน่อย"
"dota_chatwheel_label_Mana"	"มานา"
"dota_chatwheel_label_OOM"	"ไม่มีมานา"
"dota_chatwheel_label_Skill_Cooldown"	"คูลดาวน์"
"dota_chatwheel_label_Ulti_Ready"	"อัลติพร้อม"
"dota_chatwheel_label_Enemy_Returned"	"ศัตรูกลับมาแล้ว"
"dota_chatwheel_label_All_Missing"	"หายทั้งหมด"
"dota_chatwheel_label_Enemy_Incoming"	"ศัตรูบุกมาแล้ว"
"dota_chatwheel_label_Invis_Enemy"	"ศัตรูล่องหน"
"dota_chatwheel_label_Enemy_Had_Rune"	"ศัตรูเก็บรูนไปแล้ว"
"dota_chatwheel_label_Split_Push"	"แยกกันดัน"
"dota_chatwheel_label_Coming_To_Gank"	"กำลังไป Gank"
"dota_chatwheel_label_Request_Gank"	"ต้องการ Gank"
"dota_chatwheel_label_Fight_Under_Tower"	"เกาะป้อมเอาไว้"
"dota_chatwheel_label_Deny_Tower"	"Deny ป้อม"
"dota_chatwheel_label_Buy_Courier"	"ซื้อ Courier"
"dota_chatwheel_label_Upgrade_Courier"	"อัปเกรด Courier"
"dota_chatwheel_label_Need_Detection"	"เราต้องการการมองเห็น"
"dota_chatwheel_label_They_Have_Detection"	"พวกเขามองเห็น"
"dota_chatwheel_label_Buy_TP"	"ซื้อ TP"
"dota_chatwheel_label_Reuse_Courier"	"ใช้ Courier อีกครั้ง"
"dota_chatwheel_label_Deward"	"ทำลาย Ward"
"dota_chatwheel_label_Building_Mek"	"กำลังซื้อ Mek"
"dota_chatwheel_label_Building_Pipe"	"กำลังซื้อ Pipe"
"dota_chatwheel_label_Stack_And_Pull"	"กองแล้วลากครีป"
"dota_chatwheel_label_Pull"	"ลาก Creep"
"dota_chatwheel_label_Pulling"	"กำลังลากครีป"
"dota_chatwheel_label_Stack"	"ลากกองครีปป่า"
"dota_chatwheel_label_Jungling"	"กำลังฟาร์มป่า"
"dota_chatwheel_label_Roshan"	"Roshan"
"dota_chatwheel_label_Affirmative"	"รับทราบ"
"dota_chatwheel_label_Wait"	"รอก่อน"
"dota_chatwheel_label_Pause"	"หยุดเกม"
"dota_chatwheel_label_Current_Time"	"เวลาปัจจุบัน"
"dota_chatwheel_label_Check_Runes"	"เช็ครูน"
"dota_chatwheel_label_Smoke_Gank"	"Gank ใช้ Smoke!"
"dota_chatwheel_label_GLHF"	"ขอให้โชคดี"
"dota_chatwheel_label_Nice"	"เยี่ยม"
"dota_chatwheel_label_Thanks"	"ขอบคุณ"
"dota_chatwheel_label_Sorry"	"ขอโทษ"
"dota_chatwheel_label_No_Give_Up"	"อย่ายอมแพ้"
"dota_chatwheel_label_Just_Happened"	"นั่นมันเกิดขึ้นแล้ว"
"dota_chatwheel_label_Game_Is_Hard"	"เกมยากลำบากแล้ว"
"dota_chatwheel_label_New_Meta"	"การเล่นแบบใหม่"
"dota_chatwheel_label_My_Bad"	"ฉันผิดเอง"
"dota_chatwheel_label_Regret"	"เสียใจ"
"dota_chatwheel_label_Relax"	"ใจเย็น ๆ"
"dota_chatwheel_label_GG"	"GG"
"dota_chatwheel_label_GGWP"	"GGWP"
"dota_chatwheel_label_All_GG"	"(ทั้งหมด) GG"
"dota_chatwheel_label_All_GGWP"	"(ทั้งหมด) GGWP"
"dota_chatwheel_label_What_To_Buy"	"ซื้ออะไรดี?"
"dota_chatwheel_label_Im_Retreating"	"ฉันกำลังถอย"
"dota_chatwheel_label_Space_Created"	"เปิดโอกาสให้แล้ว"
"dota_chatwheel_label_Whoops"	"อุ๊บส์"
"dota_chatwheel_label_Tower_then_Back"	"พังป้อมแล้วถอย"
"dota_chatwheel_label_Barracks_then_Back"	"พังบาร์แร็คแล้วถอย"
"dota_chatwheel_label_Ward_Bottom_Rune"	"ปัก Ward รูนล่าง"
"dota_chatwheel_label_Ward_Top_Rune"	"ปัก Ward รูนบน"
"dota_chatwheel_label_Zeus_Ult"	"กดอัลติ Zeus"
"dota_chatwheel_header_positioning"	"การวางตำแหน่ง"
"dota_chatwheel_header_status"	"สถานะ"
"dota_chatwheel_header_enemy"	"ศัตรู"
"dota_chatwheel_header_lane"	"เลน"
"dota_chatwheel_header_items"	"ไอเท็ม"
"dota_chatwheel_header_neutrals"	"ครีปป่า"
"dota_chatwheel_header_misc"	"อื่น ๆ"
"dota_chatwheel_header_flavor"	"สีสัน"
"dota_chatwheel_message_Ok"	"โอเค"
"dota_chatwheel_message_Care"	"ระวัง!"
"dota_chatwheel_message_GetBack"	"ถอยกลับ!"
"dota_chatwheel_message_NeedWards"	"พวกเราต้องการ Ward"
"dota_chatwheel_message_Stun"	"สตันเลย!"
"dota_chatwheel_message_Help"	"ช่วยด้วย!"
"dota_chatwheel_message_Push"	"ดันเลย"
"dota_chatwheel_message_GoodJob"	"เล่นได้ดี!"
"dota_chatwheel_message_Missing"	"หาย!"
"dota_chatwheel_message_Missing_Top"	"เลนบนหาย!"
"dota_chatwheel_message_Missing_Mid"	"เลนกลางหาย!"
"dota_chatwheel_message_Missing_Bottom"	"เลนล่างหาย!"
"dota_chatwheel_message_Go"	"ไป!"
"dota_chatwheel_message_Initiate"	"เปิดให้ที!"
"dota_chatwheel_message_Follow"	"ตามฉันมา"
"dota_chatwheel_message_Group_Up"	"รวมกลุ่ม"
"dota_chatwheel_message_Spread_Out"	"กระจายกันออกไป"
"dota_chatwheel_message_Split_Farm"	"แยกกันไปฟาร์ม"
"dota_chatwheel_message_Attack"	"โจมตีเลย!"
"dota_chatwheel_message_BRB"	"เดี๋ยวฉันจะกลับมา"
"dota_chatwheel_message_Dive"	"บุกเข้าไปเลย!"
"dota_chatwheel_message_OMW"	"กำลังไป"
"dota_chatwheel_message_Get_Ready"	"เตรียมพร้อม"
"dota_chatwheel_message_Bait"	"ช่วยหลอกล่อที"
"dota_chatwheel_message_Heal"	"ฮีลหน่อย"
"dota_chatwheel_message_Mana"	"มานาหน่อย"
"dota_chatwheel_message_OOM"	"มานาหมดแล้ว"
"dota_chatwheel_message_Skill_Cooldown"	"สกิลกำลังคูลดาวน์"
"dota_chatwheel_message_Ulti_Ready"	"อัลติเมทพร้อมแล้ว"
"dota_chatwheel_message_Enemy_Returned"	"ศัตรูกลับมาแล้ว"
"dota_chatwheel_message_All_Missing"	"ฮีโร่ศัตรูหายทั้งหมด!"
"dota_chatwheel_message_Enemy_Incoming"	"ศัตรูบุกมาแล้ว!"
"dota_chatwheel_message_Invis_Enemy"	"มีศัตรูล่องหนอยู่แถวนี้!"
"dota_chatwheel_message_Enemy_Had_Rune"	"ศัตรูได้รูนไปแล้ว"
"dota_chatwheel_message_Split_Push"	"แยกกันดัน"
"dota_chatwheel_message_Coming_To_Gank"	"กำลังไป Gank"
"dota_chatwheel_message_Request_Gank"	"ช่วย Gank ที"
"dota_chatwheel_message_Fight_Under_Tower"	"สู้ด้านในป้อมเลย"
"dota_chatwheel_message_Deny_Tower"	"Deny ป้อมเลย!"
"dota_chatwheel_message_Buy_Courier"	"กรุณาซื้อ Courier ด้วย"
"dota_chatwheel_message_Upgrade_Courier"	"ใครก็ได้ช่วยอัปเกรด Courier ได้ไหม?"
"dota_chatwheel_message_Need_Detection"	"เราต้องการพื้นที่การมองเห็น"
"dota_chatwheel_message_They_Have_Detection"	"พวกเขามองเห็นเรา"
"dota_chatwheel_message_Buy_TP"	"ซื้อ Teleport Scroll"
"dota_chatwheel_message_Reuse_Courier"	"ใช้ Courier อีกรอบ"
"dota_chatwheel_message_Deward"	"ทำลาย Ward ด้วย"
"dota_chatwheel_message_Building_Mek"	"กำลังจะซื้อ Mekansm"
"dota_chatwheel_message_Building_Pipe"	"กำลังจะซื้อ Pipe"
"dota_chatwheel_message_Stack_And_Pull"	"ลากกองครีปป่าแล้วดึงครีปที"
"dota_chatwheel_message_Pull"	"ช่วยดึงครีปที"
"dota_chatwheel_message_Pulling"	"กำลังลากครีป"
"dota_chatwheel_message_Stack"	"ลากกองครีปป่าที"
"dota_chatwheel_message_Jungling"	"กำลังฟาร์มป่า"
"dota_chatwheel_message_Roshan"	"Roshan"
"dota_chatwheel_message_Affirmative"	"รับทราบ"
"dota_chatwheel_message_Wait"	"รอก่อน"
"dota_chatwheel_message_Pause"	"กรุณาหยุดเกมก่อน!"
"dota_chatwheel_message_Current_Time"	"เวลาปัจจุบันในเกม"
"dota_chatwheel_message_Check_Runes"	"ช่วยเช็ครูนที"
"dota_chatwheel_message_Smoke_Gank"	"Gank แบบใช้ Smoke กัน!"
"dota_chatwheel_message_GLHF"	"โชคดี ขอให้สนุก"
"dota_chatwheel_message_Nice"	"เจ๋ง"
"dota_chatwheel_message_Thanks"	"ขอบใจ!"
"dota_chatwheel_message_Sorry"	"ขอโทษที"
"dota_chatwheel_message_No_Give_Up"	"อย่ายอมแพ้!"
"dota_chatwheel_message_Just_Happened"	"นั่นมันเกิดขึ้นแล้ว"
"dota_chatwheel_message_Game_Is_Hard"	"เกมมันยากลำบากแล้ว"
"dota_chatwheel_message_New_Meta"	"การเล่นแบบใหม่"
"dota_chatwheel_message_My_Bad"	"ฉันผิดเอง"
"dota_chatwheel_message_Regret"	"ฉันเสียใจทันทีกับการตัดสินใจของฉัน"
"dota_chatwheel_message_Relax"	"ใจเย็น ๆ นายทำได้ดีแล้ว"
"dota_chatwheel_message_MissingHero"	"%s1 หายไป!"
"dota_chatwheel_message_ReturnedHero"	"%s1 ได้กลับมาแล้ว!"
"dota_chatwheel_message_GG"	"Good game"
"dota_chatwheel_message_GGWP"	"Good game, well played"
"dota_chatwheel_message_All_GG"	"Good game"
"dota_chatwheel_message_All_GGWP"	"Good game, well played"
"dota_chatwheel_message_What_To_Buy"	"ฉันควรซื้ออะไรดี?"
"dota_chatwheel_message_Im_Retreating"	"ฉันกำลังถอยกลับ"
"dota_chatwheel_message_Space_Created"	"เปิดโอกาสให้แล้ว"
"dota_chatwheel_message_Whoops"	"อุ๊บส์"
"dota_chatwheel_message_Tower_then_Back"	"พังป้อมแล้วถอยกลับ"
"dota_chatwheel_message_Barracks_then_Back"	"พังบาร์แร็คแล้วถอยกลับ"
"dota_chatwheel_message_Ward_Bottom_Rune"	"ปัก Ward รูนล่างที"
"dota_chatwheel_message_Ward_Top_Rune"	"ปัก Ward รูนบนที"
"dota_chatwheel_message_Zeus_Ult"	"กดอัลติเลย Zeus!"
"dota_settings_hotkeys"	"ปุ่มลัด"
"dota_settings_options"	"ตัวเลือก"
"dota_settings_audio"	"เสียง"
"dota_settings_voice"	"เสียงพูด"
"dota_settings_voice_level"	"ระดับการบันทึกปัจจุบัน"
"dota_settings_voice_steam_link"	"การตั้งค่าอุปกรณ์บันทึกใช้การกำหนดค่าบน <a href=\"event:DOTAShowSteamVoiceSettings()\">การตั้งค่าเสียงพูดบน Steam</a>"
"dota_settings_volume"	"ระดับเสียง"
"dota_settings_video"	"วิดีโอ"
"dota_settings_resetkeys"	"รีเซ็ตปุ่มลัด..."
"dota_settings_legacykeys"	"ใช้ปุ่มดั้งเดิม"
"dota_settings_abilities"	"สกิล"
"dota_settings_abilities_hero"	"ฮีโร่"
"dota_settings_abilities_neutrals"	"ครีปป่า"
"dota_settings_abilities_courier"	"Courier"
"dota_settings_abilities_primary1"	"1"
"dota_settings_abilities_primary2"	"2"
"dota_settings_abilities_primary3"	"3"
"dota_settings_abilities_secondary1"	"4"
"dota_settings_abilities_secondary2"	"5"
"dota_settings_abilities_neutral1"	"1"
"dota_settings_abilities_neutral2"	"2"
"dota_settings_abilities_neutral3"	"3"
"dota_settings_abilities_neutral4"	"4"
"dota_settings_abilities_courier1"	"1"
"dota_settings_abilities_courier2"	"2"
"dota_settings_abilities_courier3"	"3"
"dota_settings_abilities_courier4"	"4"
"dota_settings_abilities_courier5"	"5"
"dota_settings_abilities_courier6"	"6"
"dota_settings_abilities_ultimate"	"U"
"dota_settings_cast"	"ร่าย"
"dota_settings_autocast"	"ร่ายอัตโนมัติ"
"dota_settings_quickcast"	"ร่ายอย่างรวดเร็ว"
"dota_settings_mirror"	"คัดลอกปุ่มลัดจากแผงฮีโร่"
"dota_settings_abilitylearn"	"เรียนรู้สกิล"
"dota_settings_upgradestats"	"เพิ่มค่าสถานะ"
"dota_settings_unitactions"	"คำสั่งยูนิต"
"dota_settings_attack"	"เคลื่อนที่พร้อมโจมตี / บังคับโจมตี"
"dota_settings_move"	"เคลื่อนที่"
"dota_settings_stop"	"หยุด"
"dota_settings_holdposition"	"ประจำตำแหน่ง"
"dota_settings_selecthero"	"เลือกฮีโร่"
"dota_settings_selectall"	"เลือกยูนิตทั้งหมด"
"dota_settings_selectallothers"	"เลือกยูนิตที่เหลือทั้งหมด"
"dota_settings_selectcourier"	"เลือก Courier"
"dota_settings_courierdeliver"	"Courier ส่งไอเท็ม"
"dota_settings_courierhaste"	"เร่งความเร็ว Courier"
"dota_settings_useactionitem"	"ไอเท็มแอ็คชัน"
"dota_settings_herotaunt"	"ไอเท็มเยาะเย้ย"
"dota_settings_items"	"ไอเท็ม"
"dota_settings_openshop"	"เปิดร้านค้า"
"dota_settings_purchasequickbuy"	"ซื้อไอเท็มจากช่องซื้อเร่งด่วน"
"dota_settings_purchasesticky"	"ซื้อไอเท็มปักหมุด"
"dota_settings_grabstashitems"	"หยิบไอเท็มในคลังเก็บของ"
"dota_settings_camera"	"กล้อง"
"dota_settings_cameraactions"	"คำสั่งกล้อง"
"dota_settings_cameraup"	"เลื่อนกล้องไปข้างหน้า"
"dota_settings_cameradown"	"เลื่อนกล้องไปข้างหลัง"
"dota_settings_cameraleft"	"เลื่อนกล้องไปทางซ้าย"
"dota_settings_cameraright"	"เลื่อนกล้องไปทางขวา"
"dota_settings_cameragrip"	"จับมุมกล้อง"
"dota_settings_recentevent"	"แสดงเหตุการณ์ล่าสุด"
"dota_settings_inspectheroinworld"	"เปลี่ยนมุมมอง"
"dota_settings_chat"	"แชท"
"dota_settings_phrases"	"วลี"
"dota_settings_chatwheel_page"	"วงล้อสนทนา"
"dota_settings_chatteam"	"สนทนากับทีม"
"dota_settings_chatglobal"	"สนทนากับทุกคน"
"dota_settings_chatvoice_party"	"พูด (ปาร์ตี้)"
"dota_settings_chatvoice_team"	"พูด (ทีม)"
"dota_settings_chatwheel_show"	"วงล้อสนทนา"
"dota_settings_playeractions"	"คำสั่งผู้เล่น"
"dota_settings_activateglyph"	"ใช้งาน Glyph"
"dota_settings_scoreboardtoggle"	"กระดานคะแนน"
"dota_settings_pause"	"หยุดชั่วคราว"
"dota_settings_screenshot"	"ภาพหน้าจอ"
"dota_settings_console"	"คอนโซล"
"dota_settings_controlgroups"	"กลุ่มควบคุม"
"dota_settings_controlgroupsadditional"	"กลุ่มควบคุมเพิ่มเติม"
"dota_settings_controlgroupcycle"	"แท็บกลุ่มควบคุม"
"dota_settings_group1"	"กลุ่ม 1"
"dota_settings_group2"	"กลุ่ม 2"
"dota_settings_group3"	"กลุ่ม 3"
"dota_settings_group4"	"กลุ่ม 4"
"dota_settings_group5"	"กลุ่ม 5"
"dota_settings_group6"	"กลุ่ม 6"
"dota_settings_group7"	"กลุ่ม 7"
"dota_settings_group8"	"กลุ่ม 8"
"dota_settings_group9"	"กลุ่ม 9"
"dota_settings_group10"	"กลุ่ม 10"
"dota_settings_advancedpanel_goto"	"ขั้นสูง"
"dota_settings_standardpanel_goto"	"มาตรฐาน"
"dota_settings_spectatorandreplay"	"การควบคุมของผู้เข้าชม/รีเพลย์"
"dota_settings_spectatorandreplay_pt2"	"การควบคุมของผู้เข้าชม/รีเพลย์ (ต่อ)"
"dota_settings_spectatorcameraup"	"[ผู้ชม] เลื่อนกล้องไปข้างหน้า"
"dota_settings_spectatorcameradown"	"[ผู้ชม] เลื่อนกล้องไปข้างหลัง"
"dota_settings_spectatorcameraleft"	"[ผู้ชม] เลื่อนกล้องไปทางซ้าย"
"dota_settings_spectatorcameraright"	"[ผู้ชม] เลื่อนกล้องไปทางขวา"
"dota_settings_spectatorcameragrip"	"[ผู้ชม] จับมุมกล้อง"
"dota_settings_spectatorpause"	"[ผู้ชม] หยุดชั่วคราว"
"dota_settings_spectatorchat"	"[ผู้ชม] สนทนา"
"dota_settings_spectatorscoreboard"	"[ผู้ชม] กระดานคะแนน"
"dota_settings_spectatorbroadcastermenu"	"เปิดเมนูผู้พากย์"
"dota_settings_spectatorincreasereplayspeed"	"เพิ่มความเร็วของรีเพลย์"
"dota_settings_spectatordecreasereplayspeed"	"ลดความเร็วของรีเพลย์"
"dota_settings_spectatorstatsharvest"	"[ผู้ชม] เก็บข้อมูลสถิติ"
"dota_settings_spectatorstatsitem"	"[ผู้ชม] รายละเอียดไอเท็ม"
"dota_settings_spectatorstatsgold"	"[ผู้ชม] กราฟโกลด์"
"dota_settings_spectatorstatsxp"	"[ผู้ชม] กราฟ XP"
"dota_settings_spectatorstatsfantasy"	"[ผู้ชม] ค่าสถิติ Fantasy"
"dota_settings_spectatorfowboth"	"[ผู้ชม] หมอกมืดทั้งสองทีม"
"dota_settings_spectatorfowradient"	"[ผู้ชม] หมอกมืด Radiant"
"dota_settings_spectatorfowdire"	"[ผู้ชม] หมอกมืด Dire"
"dota_settings_statsdropdown"	"รายการสถิติ"
"dota_settings_spectatordropdown_sort"	"เปลี่ยนการจัดเรียง"
"dota_settings_spectatordropdown_close"	"ล้างประเภท"
"dota_settings_spectatordropdown_kda"	"สังหาร/ตาย/ช่วยเหลือ"
"dota_settings_spectatordropdown_lasthits_denies"	"Last Hit/Deny"
"dota_settings_spectatordropdown_level"	"เลเวลฮีโร่"
"dota_settings_spectatordropdown_xp_per_min"	"XP ต่อนาที"
"dota_settings_spectatordropdown_gold"	"โกลด์ปัจจุบัน"
"dota_settings_spectatordropdown_totalgold"	"รายได้สุทธิ"
"dota_settings_spectatordropdown_gold_per_min"	"โกลด์ต่อนาที"
"dota_settings_spectatordropdown_buyback"	"สถานะซื้อเกิด"
"dota_settings_spectatordropdown_fantasy"	"คะแนน Fantasy"
"dota_settings_coaching"	"การฝึกสอน"
"dota_settings_spectatorcoach_viewtoggle"	"ผู้ฝึกสอนสลับมุมมองของนักเรียน"
"dota_settings_keyboardtemplate"	"เลือกแม่แบบแป้นพิมพ์"
"dota_settings_or"	"หรือ"
"dota_settings_cancel"	"ยกเลิก"
"dota_settings_apply"	"เปิดใช้ความละเอียด"
"dota_settings_game"	"ตัวเลือก"
"dota_settings_autoattack"	"โจมตีอัตโนมัติ"
"dota_settings_attackafterspell"	"โจมตีอัตโนมัติหลังจากใช้สกิล"
"dota_settings_autopurchase"	"ซื้อไอเท็มอัตโนมัติ"
"dota_settings_autoselect"	"เลือกยูนิตที่อัญเชิญอัตโนมัติ"
"dota_settings_doubletapself"	"กดสกิล 2 ครั้ง เพื่อร่ายใส่ตัวเอง"
"dota_settings_unifiedorders"	"รวมคำสั่งยูนิต"
"dota_settings_teleportrequireshalt"	"กำหนดการหยุดของเทเลพอร์ต"
"dota_settings_herofinder"	"กดปุ่ม ALT ค้าง เพื่อชี้ตำแหน่งของฮีโร่"
"dota_settings_alwaysshownames"	"แสดงชื่อผู้เล่นด้านบนแถบพลังชีวิต"
"dota_settings_showhitpoints"	"แสดงจำนวนพลังชีวิตด้านบนแถบพลังชีวิต"
"dota_settings_forceshophotkeys"	"ใช้ปุ่มลัดกับร้านค้าเสมอ"
"dota_settings_usebroadcastermenu"	"ใช้รายการสถิติของผู้พากย์"
"dota_settings_colorblind"	"โหมดตาบอดสี"
"dota_settings_reducedflash"	"ลดแสงแฟลช"
"dota_settings_minimap"	"แผนที่ย่อ"
"dota_settings_minimapsimplecolors"	"ใช้สีแบบเรียบง่ายบนแผนที่ย่อ"
"dota_settings_minimaphidebackground"	"ซ่อนพื้นหลังของแผนที่ย่อ"
"dota_settings_minimapshowheroicon"	"แสดงไอคอนฮีโร่ในแผนที่ย่อ"
"dota_settings_minimapalwaysshowname"	"แสดงชื่อ/ไอคอนในแผนที่ย่อเสมอ"
"dota_settings_minimapflip"	"แสดงแผนที่ย่อฝั่งขวา"
"dota_settings_cameradecel"	"ชะลอความเร็วของหน้าจอ"
"dota_settings_cameraspeed"	"ความเร็วของกล้อง"
"dota_settings_camerareversegrip"	"มุมกล้องแบบกลับด้าน"
"dota_settings_cameraedgepan"	"เลื่อนขอบหน้าจอ"
"dota_settings_camerascreenshake"	"เปิดใช้การเขย่าหน้าจอ"
"dota_settings_cameraresetonspawn"	"เลื่อนกล้องเมื่อเกิดใหม่"
"dota_settings_cameradeadcolorshift"	"ปรับสีและมุมกล้องเมื่อตาย"
"dota_settings_profile"	"โปรไฟล์"
"dota_settings_hideprofile"	"ซ่อนโปรไฟล์ Dota และ Steam"
"dota_settings_exposematchdata"	"เปิดเผยข้อมูลแมตช์ต่อสาธารณะ"
"dota_settings_ignorenonfriendparties"	"บล็อคคำเชิญปาร์ตี้จากผู้ที่ไม่ใช่เพื่อน"
"dota_settings_ignorenonfriendguilds"	"บล็อคคำเชิญกิลด์จากผู้ที่ไม่ใช่เพื่อน"
"dota_settings_allowtradeinvitesheader"	"รับคำเชิญแลกเปลี่ยนจาก:"
"dota_settings_trade_guildandfriends"	"เพื่อนร่วมกิลด์และเพื่อน"
"dota_settings_trade_friends"	"เพื่อนเท่านั้น"
"dota_settings_trade_anyone"	"ทุกคน"
"dota_settings_network"	"เครือข่าย"
"dota_settings_networkquality"	"คุณภาพเครือข่าย"
"dota_settings_networkquality_low"	"ต่ำ"
"dota_settings_networkquality_high"	"สูง"
"dota_settings_usenativeresolution"	"ใช้ความละเอียดภาพปัจจุบันของหน้าจอของฉัน"
"dota_settings_customresolution"	"ใช้การตั้งค่าขั้นสูง"
"dota_settings_resolution"	"ความละเอียดภาพ"
"dota_settings_rendering"	"การเรนเดอร์"
"dota_settings_aspectratio"	"อัตราส่วนภาพ"
"dota_settings_aspectratio43"	"4:3"
"dota_settings_aspectratio169"	"16:9"
"dota_settings_aspectratio1610"	"16:10"
"dota_settings_resolution_size"	"ขนาด"
"dota_settings_resolution_display_mode"	"โหมดแสดงผล"
"dota_settings_fullscreen"	"เต็มจอแบบพิเศษ"
"dota_settings_window"	"หน้าต่าง"
"dota_settings_borderless"	"หน้าต่างแบบไร้ขอบ"
"dota_settings_videodefaults"	"ค่าวิดีโอเริ่มต้น"
"dota_settings_basicvideosettings"	"ใช้การตั้งค่าพื้นฐาน"
"dota_settings_fastestvideo"	"เร็วที่สุด"
"dota_settings_appearancevideo"	"สวยที่สุด"
"dota_settings_advancedvideosettings"	"ใช้การตั้งค่าขั้นสูง"
"dota_settings_antialiasing"	"ลบรอยหยัก"
"dota_settings_specular"	"แสงและภาพ"
"dota_settings_bloom"	"สะท้อนและกระจายแสง"
"dota_settings_waterquality"	"น้ำคุณภาพสูง"
"dota_settings_fog"	"บรรยากาศของหมอก"
"dota_settings_animateportrait"	"ภาพฮีโร่เคลื่อนไหว"
"dota_settings_additivelight"	"การผ่านของแสงแบบเติมแต่ง"
"dota_settings_worldlight"	"แสงสว่างในฉาก"
"dota_settings_ambientocclusion"	"การคำนวณแสง"
"dota_settings_ambientcreatures"	"สิ่งมีชีวิตในฉาก"
"dota_settings_normal_maps"	"นอร์มอลแมพ"
"dota_settings_vsync"	"VSync"
"dota_settings_renderquality"	"คุณภาพการเรนเดอร์หน้าจอเกม"
"dota_settings_shadowquality"	"คุณภาพของเงา"
"dota_settings_shadowquality_low"	"ต่ำ"
"dota_settings_shadowquality_med"	"ปานกลาง"
"dota_settings_shadowquality_high"	"สูง"
"dota_settings_texturequality"	"คุณภาพลายพื้นผิว"
"dota_settings_texturequality_low"	"ต่ำ"
"dota_settings_texturequality_med"	"ปานกลาง"
"dota_settings_texturequality_high"	"สูง"
"dota_settings_mastervolume"	"ระดับเสียงหลัก"
"dota_settings_gamevolume"	"เสียงเกม"
"dota_settings_musicvolume"	"ดนตรี"
"dota_settings_voicevolume"	"เสียงพูด"
"dota_settings_gamevoicevolume"	"เสียงพากย์ของยูนิต"
"dota_settings_openmic"	"เปิดใช้งานไมค์ในการสื่อสารกับสมาชิกปาร์ตี้"
"dota_settings_openmicthreshold"	"ระดับเสียงที่เริ่มใช้ไมค์"
"dota_settings_audiodefaults"	"ค่าเสียงเริ่มต้น"
"dota_settings_defaultaudio"	"ค่าเริ่มต้น"
"dota_settings_sounddevice"	"อุปกรณ์เสียง:"
"dota_settings_speakerconfig"	"การตั้งค่าลำโพง:"
"dota_settings_headphones"	"หูฟัง"
"dota_settings_2speakers"	"ลำโพง 2 ตัว"
"dota_settings_4speakers"	"ลำโพง 4 ตัว"
"dota_settings_5speakers"	"ลำโพงแบบ 5.1"
"dota_settings_7speakers"	"ลำโพงแบบ 7.1"
"dota_settings_captions"	"แสดงคำบรรยาย"
"dota_settings_playsoundinbackground"	"เล่นเสียงขณะอยู่หน้าเดสก์ทอป"
"dota_settings_chatsounds"	"เสียงข้อความสนทนา"
"dota_settings_mutecobroadcasters"	"ปิดเสียงผู้ร่วมพากย์"
"dota_settings_highqualityaudio"	"เสียงคุณภาพสูง"
"dota_settings_enhancestereo"	"ปรับปรุงสเตอริโอ"
"dota_settings_unitspeeh"	"เสียงพากย์ของยูนิต"
"dota_settings_unitspeech_off"	"ปิด"
"dota_settings_unitspeech_events"	"เหตุการณ์"
"dota_settings_unitspeech_all"	"ทั้งหมด"
"OS_Default_Device"	"อุปกรณ์ตั้งต้น"
"DOTA_Keybind_ARROW"	"ลูกศร (ค่าเริ่มต้น)"
"DOTA_Keybind_WASD"	"WASD"
"DOTA_Keybind_MMO"	"MMO"
"DOTA_Keybind_LEGACY"	"ปุ่มดั้งเดิม"
"DOTA_Keybind_LOL"	"League of Legends"
"DOTA_Keybind_HON"	"Heroes of Newerth"
"DOTA_Keybind_SMITE"	"Smite"
"DOTA_Hotkeys_Tooltip_LearnAbility"	"เข้าสู่โหมดเรียนรู้ความสามารถเมื่อคุณมีแต้มสกิล"
"DOTA_Hotkeys_Tooltip_LearnStats"	"เพิ่มสองแต้มให้แต่ละค่าสถานะของคุณเมื่อคุณมีแต้มสกิล"
"DOTA_Hotkeys_Tooltip_HeroAttack"	"เคลื่อนที่ไปยังตำแหน่งนั้นแต่จะทำการโจมตีศัตรูที่คุณมองเห็นขณะกำลังเดินไป / โจมตีใส่ยูนิตฝ่ายเดียวกันเมื่อสามารถสละได้"
"DOTA_Hotkeys_Tooltip_HeroMove"	"เคลื่อนที่ไปยังตำแหน่งหรือเดินตามยูนิตโดยไม่ทำการโจมตีมัน"
"DOTA_Hotkeys_Tooltip_HeroStop"	"ยกเลิกการกระทำของคุณที่ทำอยู่"
"DOTA_Hotkeys_Tooltip_HeroHold"	"ยกเลิกการกระทำของคุณที่ทำอยู่และหยุดอยู่ที่ตำแหน่งนั้น"
"DOTA_Hotkeys_Tooltip_HeroSelect"	"เลือกฮีโร่ของคุณ"
"DOTA_Hotkeys_Tooltip_SelectAll"	"เลือกยูนิตทั้งหมดที่คุณควบคุมได้"
"DOTA_Hotkeys_Tooltip_SelectAllOthers"	"เลือกยูนิตทั้งหมดที่คุณควบคุมได้ (ฮีโร่ของคุณจะไม่ถูกเลือกด้วย)"
"DOTA_Hotkeys_Tooltip_CourierSelect"	"เลือก Courier"
"DOTA_Hotkeys_Tooltip_CourierDeliver"	"ให้ Courier ส่งไอเท็มจากคลังเก็บของของคุณไปให้กับคุณ"
"DOTA_Hotkeys_Tooltip_CourierHaste"	"เปิดใช้การเร่งความเร็ว Courier ของคุณเมื่อมันใช้งานได้"
"DOTA_Hotkeys_Tooltip_UseActionItem"	"ใช้ไอเท็มแอ็คชัน"
"DOTA_Hotkeys_Tooltip_HeroTaunt"	"ใช้ท่าเยาะเย้ยของฮีโร่ของคุณ ใช้งานได้เมื่อสวมใส่ไอเท็มนั้นอยู่"
"DOTA_Hotkeys_Tooltip_ShopToggle"	"เปิดหน้าแผงร้านค้า"
"DOTA_Hotkeys_Tooltip_PurchaseQuickbuy"	"ซื้อไอเท็มชิ้นถัดไปที่อยู่ในช่องซื้อเร่งด่วน ถ้าคุณสามารถซื้อมันได้"
"DOTA_Hotkeys_Tooltip_PurchaseSticky"	"ซื้อไอเท็มที่อยู่ในช่องปักหมุด ถ้าคุณสามารถซื้อมันได้"
"DOTA_Hotkeys_Tooltip_GrabStashItems"	"หยิบไอเท็มทั้งหมดมาไว้ที่ช่องเก็บของของฮีโร่ของคุณ"
"DOTA_Hotkeys_Tooltip_RecentEvent"	"เลื่อนกล้องไปยังเหตุการณ์ล่าสุดในโลก"
"DOTA_Hotkeys_Tooltip_InspectHeroInWorld"	"ดูยูนิตในมุมมองอย่างใกล้ชิต"
"DOTA_Hotkeys_Tooltip_ChatTeam"	"ส่งข้อความให้กับทุกคนในทีมของคุณ"
"DOTA_Hotkeys_Tooltip_ChatGlobal"	"ส่งข้อความให้กับทุกคนในเกมในขณะนี้ (จะเพิ่มการกด SHIFT ของปุ่มลัดการสนทนาในทีม)"
"DOTA_Hotkeys_Tooltip_ChatVoiceParty"	"ใช้ไมโครโฟนของคุณในการสื่อสารกับสมาชิกทุกคนในปาร์ตี้ หากคุณเปิดใช้ไมโครโฟน การตั้งค่านี้ก็ทำงานในหน้าแดชบอร์ดด้วยเช่นกัน"
"DOTA_Hotkeys_Tooltip_ChatVoiceTeam"	"ใช้ไมโครโฟนของคุณในการสื่อสารกับสมาชิกทุกคนในทีม"
"DOTA_Hotkeys_Tooltip_ChatWheel"	"เปิดวงล้อสนทนาเพื่อการสื่อสารอย่างสะดวกโดยใช้วลีที่ใช้กันบ่อย ๆ"
"DOTA_Hotkeys_Tooltip_CameraGrip"	"กดค้างและลากบนโลกเพื่อเลื่อนมุมกล้อง นอกจากนี้ยังสามารถกำหนดด้วยลูกกลิ้งเมาส์ได้"
"DOTA_Hotkeys_Tooltip_ActivateGlyph"	"กดใช้ Glyph of Fortification เพื่อทำให้สิ่งก่อสร้างของทีมคุณเป็นอมตะ 5 วินาที"
"DOTA_Hotkeys_Tooltip_ScoreboardToggle"	"เปิดกระดานคะแนนในเกม"
"DOTA_Hotkeys_Tooltip_Pause"	"หยุดและยกเลิกการหยุดเกมที่กำลังดำเนินอยู่"
"DOTA_Hotkeys_Tooltip_ScreenshotSettings"	"ถ่ายภาพหน้าจอของมุมมองปัจจุบันของเกม"
"DOTA_Hotkeys_Tooltip_Console"	"เปิดคอลโซล (สำหรับผู้ใช้ระดับสูงเท่านั้น)"
"DOTA_Hotkeys_Tooltip_ControlGroupCycle"	"สลับยูนิตแต่ละตัวที่อยู่ในกลุ่มที่เลือก"
"DOTA_Hotkeys_Tooltip_Group"	"เลือกกลุ่มควบคุมของยูนิตที่ตั้งไว้ เพื่อกำหนดกลุ่มควบคุม เลือกยูนิตที่ต้องการและกด CTRL ค้างและกดปุ่มลัดของหนึ่งกลุ่มเหล่านี้"
"DOTA_Hotkeys_Tooltip_Legacy"	"ใช้ปุ่มลัดทั้งหมดเหมือนกับ Dota 1 ปุ่มลัดสกิลของฮีโร่แต่ละตัวจะแตกต่างกันออกไป"
"DOTA_Hotkeys_Tooltip_Quickcast"	"การร่ายสกิลอย่างรวดเร็วจะทำการร่ายบนตำแหน่งเคอร์เซอร์เมาส์ในขณะนั้นทันที เมื่อกดปุ่มลัด"
"DOTA_Hotkeys_Tooltip_Autocast"	"สลับเป็นการร่ายสกิลอัตโนมัติเมื่อมันพร้อมใช้งาน ใช้กับสกิลเพียงไม่กี่ชนิด"
"DOTA_Hotkeys_Tooltip_Cast"	"ปุ่มลัดที่จะร่ายสกิลของฮีโร่"
"DOTA_Hotkeys_Tooltip_ItemCast"	"ปุ่มลัดที่จะใช้ไอเท็มของคุณในช่องเก็บของ"
"DOTA_Hotkeys_Tooltip_ItemQuickcast"	"การร่ายไอเท็มอย่างรวดเร็วจะทำการร่ายบนตำแหน่งเคอร์เซอร์เมาส์ในขณะนั้นทันที เมื่อกดปุ่มลัด"
"DOTA_Settings_Tooltip_Autoattack"	"เคลื่อนที่และโจมตีศัตรูที่อยู่ใกล้เคียงอัตโนมัติ"
"DOTA_Settings_Tooltip_AutoattackAfterSpell"	"หากไม่เลือกเปิดใช้งาน ฮีโร่จะยืนอยู่ตำแหน่งเดิมหลังจากร่ายสกิล เพื่อรอคำสั่งต่อไป"
"DOTA_Settings_Tooltip_AutoPurchase"	"ทำการซื้อไอเท็มชิ้นถัดไปในรายการไอเท็มแนะนำเมื่อคุณสามารถซื้อได้"
"DOTA_Settings_Tooltip_AutoSelectSummons"	"เมื่อยูนิตตัวใหม่ถูกอัญเชิญโดยฮีโร่ พวกมันจะถูกเพิ่มยังกลุ่มเลือก"
"DOTA_Settings_Tooltip_DoubleTap"	"ดับเบิลคลิกบนสกิลหรือไอเท็ม หรือกดปุ่มลัดของมันสองครั้งจะร่ายมันกับตัวคุณเองเมื่อสามารถใช้ได้"
"DOTA_Settings_Tooltip_UnifiedOrders"	"การกดปุ่ม CTRL ค้าง เมื่อออกคำสั่งจะถูกส่งไปยังยูนิตทุกตัวที่คุณควบคุมอยู่"
"DOTA_Settings_Tooltip_TeleportStop"	"การเคลื่อนที่หรือร่ายสกิลจะไม่ยกเลิกการ Teleport มีผลต่อ Teleport Scroll หรือ Boots of Travel เท่านั้น"
"DOTA_Settings_Tooltip_BroadcasterStats"	"ขณะที่เข้าชมการแข่งขัน แสดงรายการสถิติที่ผู้พากย์กำลังใช้อยู่"
"DOTA_Settings_Tooltip_Deceleration"	"ความเร็วในการชะลอของกล้องก่อนที่จะหยุดนิ่ง จำนวนที่มากขึ้นเท่ากับการหยุดที่เร็วขึ้น"
"DOTA_Settings_Tooltip_Screenshake"	"สกิลและสตันบางอย่างจะเขย่าหน้าจอ"
"DOTA_Settings_Tooltip_CameraRespawn"	"จะโฟกัสหน้าจอฮีโร่ของคุณอีกครั้ง เมื่อเกิดใหม่"
"DOTA_Settings_Tooltip_HideProfile"	"โปรไฟล์ Dota 2 ของคุณจะไม่มีใครสามารถเข้าถึงได้ และโปรไฟล์ Steam ของคุณจะไม่สามารถเข้าถึงจาก Dota 2 ได้"
"DOTA_Settings_Tooltip_ShareMatchData"	"เปิดเผยข้อมูลแมตช์ของคุณจากเกมสาธารณะให้กับบุคคลอื่น"
"DOTA_Settings_Tooltip_NetworkQuality"	"ถ้าการเชื่อมต่อเครือข่ายของคุณมีคุณภาพต่ำ ตั้งค่านี้เป็น 'ต่ำ' อาจช่วยให้เครือข่ายของคุณมีประสิทธิภาพมากขึ้น"
"DOTA_Settings_Tooltip_MinimapSimple"	"สีของแผนที่ย่อถูกกำหนดโดยทีมแทนการกำหนดโดยผู้เล่นแต่ละคน"
"DOTA_Settings_Tooltip_MinimapDrawHeroes"	"เมื่อกด ALT ค้างจะใช้ภาพไอคอนของฮีโร่ในแผนที่ย่อ แทนการใช้ชื่อของฮีโร่"
"DOTA_Settings_Tooltip_MinimapNamesIcon"	"แสดงภาพไอคอนของฮีโร่หรือชื่อของฮีโร่ในแผนที่ย่อตลอด ขณะกดแสดงเป็น X และ O ชั่วคราว"
"DOTA_Settings_Tooltip_ShopHotkeys"	"ปุ่มลัดในร้านค้าจะแทนปุ่มใด ๆ ที่ถูกสั่งให้ทำงานอื่นขณะที่กำลังเปิดหน้าร้านค้า"
"DOTA_Settings_LegacyKeysActive"	"ปุ่มดั้งเดิมจาก Dota 1 กำลังเปิดใช้งานอยู่ หากต้องการปรับแต่งปุ่มลัดแต่ละปุ่ม กรุณาปิดการใข้งานปุ่มดั้งเดิมก่อน"
"DOTA_create_bot_practice_desc"	"เล่นแมตช์ต่อสู้กับ AI ศัตรู คุณสามารถใช้การค้นหาแมตช์กับเพื่อนร่วมทีมที่เป็นมนุษย์ได้ หรือเลือกให้บอทเล่นในตำแหน่งของทีมคุณที่ว่างอยู่"
"DOTA_Lobby_BotDifficulty"	"ระดับความยากของบอท"
"DOTA_Lobby_BotDifficulty_no_bot"	"ไม่มีบอท"
"DOTA_Lobby_BotDifficulty_passive"	"ตั้งรับ"
"DOTA_Lobby_BotDifficulty_easy"	"ง่าย"
"DOTA_Lobby_BotDifficulty_medium"	"ปานกลาง"
"DOTA_Lobby_BotDifficulty_hard"	"ยาก"
"DOTA_Lobby_BotDifficulty_unfair"	"ขี้โกง"
"DOTA_Lobby_BotTeam"	"เลือกทีม"
"DOTA_create_bot_practice_solo"	"เดี่ยว"
"DOTA_create_bot_practice_solo_desc"	"ฝึกซ้อมด้วยตัวคุณเองกับบอทในเกมท้องถิ่น ซึ่งไม่ใช้การค้นหาแมตช์และคุณสามารถออกได้ตลอดเวลา"
"DOTA_create_bot_practice_coop"	"ร่วมมือกัน"
"DOTA_create_bot_practice_coop_desc"	"ใช้การค้นหาแมตช์ในการเล่นสู้กับบอทกับผู้อื่น <font color='#dd6666'>หมายเหตุ:</font> การละทิ้งเกมสู้กับบอทก็มีการลงโทษ"
"DOTA_Lobby_BotDifficulty_bot_passive"	"บอทตั้งรับ"
"DOTA_Lobby_BotDifficulty_bot_easy"	"บอทง่าย"
"DOTA_Lobby_BotDifficulty_bot_medium"	"บอทปานกลาง"
"DOTA_Lobby_BotDifficulty_bot_hard"	"บอทยาก"
"DOTA_Lobby_BotDifficulty_bot_unfair"	"บอทขี้โกง"
"dota_lobby_title"	"{s:lobby_name}"
"dota_lobby_title_local_game"	"ล็อบบี้ท้องถิ่น"
"dota_lobby_title_default"	"ล็อบบี้"
"lobby_row_player_name"	"{s:player_name}"
"dota_lobby_row_game_name"	"{s:game_name}"
"dota_lobby_row_slots"	"{s:slots}"
"dota_lobby_row_game_mode"	"{s:game_mode}"
"dota_lobby_row_join"	"เข้าร่วม"
"dota_lobby_row_leave"	"ออก"
"dota_lobby_coaches_title"	"ผู้ฝึกสอน"
"dota_lobby_browser_all_game_modes"	"ทุกโหมดเกม"
"dota_lobby_browser_title"	"เปิดหาล็อบบี้ Dota"
"dota_lobby_browser_num_available"	"( {d:lobbies_available} available )"
"dota_lobby_browser_no_lobbies"	"ไม่พบล็อบบี้"
"dota_lobby_browser_no_matching_lobbies"	"ไม่พบล็อบบี้แมตช์ที่คุณค้นหา"
"dota_lobby_browser_updating"	"กำลังอัปเดตรายชื่อล็อบบี้..."
"dota_lobby_browser_search_placeholder"	"ค้นหาล็อบบี้"
"dota_lobby_browser_game_mode"	"โหมดเกม"
"dota_lobby_browser_refresh"	"รีเฟรช"
"dota_lobby_browser_filter_title"	"ตัวกรองล็อบบี้"
"dota_lobby_submit_filter"	"ส่ง"
"dota_popup_lobby_password_title"	"ป้อนรหัสผ่านล็อบบี้"
"DOTA_AttackCapability_Melee"	"ระยะประชิด"
"DOTA_AttackCapability_Ranged"	"ระยะไกล"
"DOTA_Item_OnMarket"	"ตลาด"
"DOTA_Items_DefaultSet"	"ค่าเริ่มต้น"
"DOTA_Items_SetEquipped_Label"	"สวมใส่อยู่"
"DOTA_EquippedItem_Label"	"สวมใส่อยู่"
"DOTA_PreviewingItem_Label"	"แสดงตัวอย่าง"
"DOTA_EquippedItem_Rarity"	"{s:equipped_econ_set_rarity}"
"DOTA_EquippedItem_SetName"	"{s:equipped_econ_set_name}"
"DOTA_EquippedItem_DefaultSet"	"ชุดเซ็ตเริ่มต้น"
"DOTA_EquippedItem_PartialSet"	"ชุดเซ็ตบางส่วน"
"DOTA_EquippedItem_Style"	"{i:equipped_econ_set_style_count} รูปแบบ"
"DOTA_EquippedItem_Button_Details"	"{s:equipped_details_button_text}"
"DOTA_EquippedItem_Customize"	"ปรับแต่ง"
"DOTA_EquippedItem_CustomSet"	"ชุดเซ็ตกำหนดเอง"
"DOTA_EquippedItem_Equip"	"สวมใส่"
"DOTA_EquippedItem_Unpack_And_Equip"	"แกะแล้วสวมใส่"
"DOTA_EquippedItem_Details"	"{s:equipped_econ_set_type_name} รายละเอียด"
"DOTA_EquippedItem_Purchase_Button"	"สั่งซื้อ"
"DOTA_EquippedItem_Marketplace_Button"	"ตลาด"
"DOTA_EquippedItem_BundleName"	"อยู่ในชุดรวม \"{s:equipped_econ_set_bundle}\""
"DOTA_EquippedItem_FilterText"	"แสดงตัวอย่าง"
"DOTA_EquippedItem_SaleAmount"	"-{i:equipped_econ_set_sale_amount}%"
"DOTA_EquippedItem_RegularSetPrice"	"{s:equipped_econ_regular_set_price}"
"DOTA_EquippedItem_SetPrice"	"{s:equipped_econ_set_price}"
"DOTA_EquippedItem_TreasurePrice"	"{s:equipped_econ_treasure_price}"
"DOTA_HeroDemo_Button"	"ลอง \"{s:econ_item_category_name}\""
"DOTA_HeroDemo_Button_Tooltip"	"เริ่มโหมดทดลองเพื่อลองเซ็ตไอเท็มของฮีโร่นี้หรือลองสกิล"
"DOTA_HeroDemo_Button_Return"	"กลับไปยังการทดลอง"
"DOTA_HeroDemo_Button_Return_Tooltip"	"กลับไปยังโหมดทดลองและโหลดฮีโร่หรือชุดเซ็ตไอเท็มใดก็ตามที่คุณเลือกไว้"
"DOTA_HeroDemo_Button_DBQuit"	"ออกจากการทดลอง"
"DOTA_EquippedItem_Bundle"	"ชุดรวม"
"DOTA_EquippedItem_ItemSet"	"ชุดเซ็ต"
"DOTA_EquippedItem_Item"	"ไอเท็ม"
"DOTA_EconItemSet_Name"	"{s:econ_set_name}"
"DOTA_EconItemSet_Rarity"	"{s:econ_set_rarity}"
"DOTA_EconItemSet_Status"	"{s:econ_set_status}"
"DOTA_EconItemSet_Price"	"{s:econ_set_price}"
"DOTA_EconItemSet_SaleAmount"	"-{i:econ_sale_amount}%"
"DOTA_EconItemSet_DeveloperOnly"	"ไม่เป็นสาธารณะ"
"DOTA_EconItemSet_Tooltip_InBundle"	"เซ็ตนี้ถูกบรรจุอยู่ในชุดรวม"
"DOTA_EconItemSet_Tooltip_PartialSet"	"ชิ้นนี้เป็นแค่ส่วนหนึ่งของไอเท็มครบทั้งเซ็ต"
"DOTA_EconItemSet_Tooltip_MultipleStyles"	"มีหลายรูปแบบ"
"DOTA_HeroRole_Carry"	"Carry"
"DOTA_HeroRole_Support"	"Support"
"DOTA_HeroRole_Nuker"	"Nuker"
"DOTA_HeroRole_Disabler"	"Disabler"
"DOTA_HeroRole_Jungler"	"Jungler"
"DOTA_HeroRole_Durable"	"Durable"
"DOTA_HeroRole_Escape"	"Escape"
"DOTA_HeroRole_LaneSupport"	"Lane Support"
"DOTA_HeroRole_Pusher"	"Pusher"
"DOTA_HeroRole_Initiator"	"Initiator"
"DOTA_HeroRole_Description_Carry"	"จะมีประโยชน์มากในช่วงท้ายของเกม หากพวกเขาได้รับโกลด์เพียงพอที่จะพลิกเกม"
"DOTA_HeroRole_Description_Support"	"สามารถเพิกเฉยต่อการสะสมโกลด์และไอเท็มได้ โดยมุ่งเป้าไปที่การใช้ความสามารถของพวกเขาสร้างความได้เปรียบให้แก่ทีม"
"DOTA_HeroRole_Description_Nuker"	"สามารถสังหารฮีโร่ฝ่ายศัตรูได้อย่างรวดเร็ว โดยใช้สกิลที่สร้างความเสียหายสูงและมีคูลดาวน์ต่ำ"
"DOTA_HeroRole_Description_Disabler"	"มีสกิลหยุดศัตรูอย่างน้อยหนึ่งสกิล"
"DOTA_HeroRole_Description_Jungler"	"สามารถฟาร์มครีป Neutral ในป่าได้อย่างมีประสิทธิภาพในช่วงต้นเกม"
"DOTA_HeroRole_Description_Durable"	"มีความสามารถที่จะอยู่ได้นานในการต่อสู้กับทีมตรงข้าม"
"DOTA_HeroRole_Description_Escape"	"มีความสามารถที่จะหลบเลี่ยงความตายได้อย่างรวดเร็ว"
"DOTA_HeroRole_Description_LaneSupport"	"มีประโยชน์มากในการคุมเลนช่วงต้นเกม ช่วยปกป้อง Carry ในทีมของคุณให้ฟาร์มครีปได้ง่าย"
"DOTA_HeroRole_Description_Pusher"	"สามารถบุกและทำลายป้อมและบาร์แร็คได้อย่างรวดเร็วในทุกช่วงของเกม"
"DOTA_HeroRole_Description_Initiator"	"สามารถเปิดฉากการต่อสู้ได้ดี"
"DOTA_HeroGrid_OptionCategory_Role"	"หน้าที่:"
"DOTA_HeroGrid_OptionCategory_Attributes"	"สาย:"
"DOTA_HeroGrid_OptionCategory_AttackType"	"ประเภทการโจมตี:"
"DOTA_HeroLoadout_PreviousHeroName"	"{s:previous_hero_name}"
"DOTA_HeroLoadout_NextHeroName"	"{s:next_hero_name}"
"DOTA_HeroLoadout_CurrentHeroName"	"{s:hero_name}"
"DOTA_HeroLoadout_AttackType"	"{s:hero_attack_type}"
"DOTA_HeroLoadout_HeroFilterName"	"ฮีโร่"
"DOTA_HeroLoadout_Search"	"ค้นหาไอเท็มสำหรับ {s:hero_name}"
"DOTA_HeroCustomize_Title"	"ปรับแต่งไอเท็ม"
"DOTA_HeroCustomize_OwnedItems"	"ไอเท็มที่เป็นเจ้าของ"
"DOTA_HeroCustomize_Slot"	"ช่อง"
"DOTA_HeroCustomize_SlotName"	"{s:slot_name}"
"DOTA_HeroCustomize_SlotEquippedItemName"	"{s:equipped_item_name}"
"DOTA_HeroCustomize_DefaultItemName"	"ไอเท็มดั้งเดิม"
"DOTA_HeroCustomize_PreviewItemName"	"{s:preview_item_name}"
"DOTA_HeroCustomize_PreviewStyle"	"{s:preview_style_name}"
"DOTA_HeroCustomize_PreviewItemSlot"	"{s:preview_item_slot}"
"DOTA_HeroCustomize_Rarity"	"{s:preview_item_rarity}"
"DOTA_HeroCustomize_StyleLocked"	"สิ่งที่จำเป็นต้องมีในการสวมใส่"
"DOTA_UIEconItem_StyleIndex"	"{i:style_index}"
"dota_ready_up_num_accepted"	"ยอมรับแล้ว {i:num_accepted} / {i:total_players} คน"
"returning_top_of_queue"	"กำลังกลับเข้าสู่ระบบหาคู่ต่อสู้เป็นอันดับแรก"
"returning_to_lobby"	"กลับไปยังล็อบบี้เพื่อค้นหาผู้เล่นเพิ่ม..."
"GC_reconnecting"	"กำลังเชื่อมต่อกลับเข้าสู่เครือข่ายของ Dota 2 ..."
"GC_nosteam"	"ไม่มีการเชื่อมต่อกับ Steam"
"GC_searching"	"กำลังค้นหาเครือข่ายสำหรับ Dota 2..."
"GC_noconnection"	"ไม่มีการเชื่อมต่อกับเครือข่ายของ Dota 2"
"GC_connecting"	"กำลังเชื่อมต่อเข้าสู่เครือข่าย Dota 2..."
"GC_connected"	"เชื่อมต่อกับเครือข่ายของ Dota 2 แล้ว"
"GC_down"	"ขณะนี้เครือข่าย Dota 2 กำลังออฟไลน์"
"GC_Network_Full"	"ขณะนี้เครือข่าย Dota 2 เต็ม"
"GC_Queue_Position"	"ขณะนี้เครือข่าย Dota 2 เต็ม ลำดับคิว: {i:gc_queue_position}"
"GC_Queue_Wait_Time"	"ขณะนี้เครือข่าย Dota 2 เต็ม ลำดับคิว: {i:gc_queue_position} เวลารอโดยประมาณ: {s:gc_queue_wait_time}"
"GC_Wait_Time"	"ระยะเวลาที่ต้องรอโดยประมาณ: %s1"
"GC_Wait_Time_Unknown"	"ไม่ทราบ"
"GC_suspended"	"บัญชีที่ถูกระงับหลังจากเครื่องมือภายนอกที่ติดอยู่กับ Dota 2 ถูกตรวจพบโดยระบบ Valve Anti-Cheat"
"dota_practice_vs_bots"	"เริ่มต้นฝึกซ้อมสู้กับบอท"
"dota_practice_vs_bots_desc"	"เล่นแมตช์ฝึกซ้อมสู้กับบอท ซึ่งไม่ใช้การค้นหาแมตช์และคุณก็สามารถออกจากแมตช์ได้ตลอดเวลา"
"dota_practice_vs_bots_difficulty"	"ระดับความยากของบอท"
"dota_practice_vs_bots_team"	"เล่นเป็นทีมใด?"
"DOTA_practice_vs_bots_team_radiant"	"Radiant"
"DOTA_practice_vs_bots_team_dire"	"Dire"
"DOTA_practice_vs_bots_team_random"	"สุ่ม"
"DOTA_EmoticonUpsell"	"อีโมติคอนจะถูกปลดล็อคโดยการสั่งซื้อไอเท็มฮีโร่หรือตั๋วลีกที่พิเศษเฉพาะ"
"DOTA_CurrentTime"	"{t:t:current_time}"
"DOTA_MonthlyPlayers"	"{s:users_last_month}"
"DOTA_MonthlyPlayersLabel"	"ผู้เล่นที่แตกต่างกันในเดือนที่ผ่านมา"
"DOTA_CurrentPlayers"	"{s:current_users}"
"DOTA_CurrentPlayersLabel"	"ผู้เล่นที่อยู่ในเกมในขณะนี้"
"DOTA_Search_NoResults"	"ไม่มีผลลัพธ์"
"DOTA_Search_ItemShortDescription"	"<span class=\"ItemRarityColor\">{s:item_rarity}</span> {s:item_slot}"
"join_error_already_in_game"	"ไม่สามารถเข้าร่วมล็อบบี้ฝึกซ้อมได้ในขณะที่คุณยังอยู่ในเกม"
"join_error_invalid_lobby"	"ไม่สามารถเข้าร่วมล็อบบี้ฝึกซ้อมได้ ล็อบบี้ที่คุณเลือกหายไปแล้ว"
"join_error_incorrect_password"	"ไม่สามารถเข้าร่วมล็อบบี้ฝึกซ้อมได้ รหัสผ่านไม่ถูกต้อง"
"join_error_access_denied"	"ไม่สามารถเข้าร่วมล็อบบี้ฝึกซ้อมได้ การเข้าถึงถูกปฏิเสธ"
"join_error_in_team_party"	"ไม่สามารถเข้าร่วมล็อบบี้ฝึกซ้อมได้ คุณต้องยุบปาร์ตี้ทีมของคุณก่อนที่จะเข้าร่วมเกมได้"
"join_error_lobby_full"	"ล็อบบี้เต็ม"
"join_error_timed_out"	"คำร้องขอหมดเวลา"
"DOTA_Friends_Ready_To_Play"	"เกมเปิด"
"DOTA_Friend_Finding_Match"	"กำลังค้นหาแมตช์..."
"DOTA_Friend_In_Match"	"อยู่ในแมตช์"
"DOTA_Friend_Solo_Open_Party"	"{s:player_name} กำลังมองหาเกมที่จะเล่น"
"DOTA_Friend_In_Party_Open"	"{s:player_name} อยู่ในปาร์ตี้เปิด"
"DOTA_Friend_Solo_Open_Party_Self"	"คุณกำลังมองหาสมาชิกปาร์ตี้"
"DOTA_Friend_In_Open_Party_Self"	"คุณอยู่ในปาร์ตี้เปิด"
"DOTA_Friends_In_Party_Open"	"เพื่อน {d:num_friends} คนอยู่ในปาร์ตี้เปิด"
"DOTA_Friend_Lobby_Mode_Self"	"คุณอยู่ในล็อบบี้ {s:game_mode}"
"DOTA_Friend_Lobby_Mode_1_Friend"	"{s:player_name} อยู่ในล็อบบี้ {s:game_mode}"
"DOTA_Friend_Lobby_Mode_N_Friends"	"เพื่อน {d:num_friends} คนอยู่ในล็อบบี้ {s:game_mode}"
"DOTA_Friend_Lobby_Mode_Small"	"ล็อบบี้ {s:game_mode}"
"DOTA_Friend_Lobby_Players"	"{d:player_count} / {d:max_player_count}"
"DOTA_Friend_Lobby_Join_Button"	"{s:join_button_text}"
"DOTA_Friend_Lobby_Friend_Count"	"+{d:extra_friend_count}"
"DOTA_Friend_Invite_To_Party"	"เชิญเข้าสู่ปาร์ตี้"
"DOTA_Friend_SuggestInviteToParty"	"แนะนำให้เชิญเข้าสู่ปาร์ตี้"
"DOTA_Request_Join_Party"	"ขอเข้าร่วมปาร์ตี้"
"DOTA_Request_Merge_Parties"	"ขอรวมปาร์ตี้"
"DOTA_Request_Merge_Parties_NotLeader"	"หัวหน้าปาร์ตี้สามารถขอรวมปาร์ตี้ได้"
"DOTA_Friend_PartyInvitePending"	"คำเชิญปาร์ตี้อยู่ระหว่างดำเนินการ"
"DOTA_Friend_PartyInvitePending_Leader"	"คำเชิญปาร์ตี้อยู่ระหว่างดำเนินการ<br/>คลิกเพื่อยกเลิกคำเชิญ"
"DOTA_Friend_PartyMergeRequestPending"	"คำขอเข้าร่วมปาร์ตี้อยู่ระหว่างดำเนินการ"
"DOTA_Friend_PartyMergeRequestPending_Leader"	"คำขอเข้าร่วมปาร์ตี้อยู่ระหว่างดำเนินการ<br/>คลิกเพื่อยกเลิกคำขอ"
"DOTA_Friend_JoinParty"	"เข้าร่วมปาร์ตี้"
"DOTA_Friend_Watch"	"เข้าชม"
"DOTA_PartyVisTooltip_SoloTitleOpen"	"กำลังอยากเล่น"
"DOTA_PartyMerge_Error_Title"	"เข้าร่วม/รวมปาร์ตี้ล้มเหลว"
"DOTA_PartyMerge_Error_NOT_LEADER"	"การดำเนินการของปาร์ตี้สามารถทำได้เฉพาะหัวปาร์ตี้เท่านั้น"
"DOTA_PartyMerge_Error_TOO_MANY_PLAYERS"	"ปาร์ตี้ไม่สามารถเข้าร่วมได้ เนื่องจากมีผู้เล่นมากเกินไป"
"DOTA_PartyMerge_Error_TOO_MANY_COACHES"	"ปาร์ตี้ไม่สามารถเข้าร่วมได้ เนื่องจากมีผู้ฝึกสอนมากเกินไป"
"DOTA_PartyMerge_Error_ENGINE_MISMATCH"	"ปาร์ตี้ไม่สามารถเข้าร่วมได้ เนื่องจากพวกเขากำลังเล่นเวอร์ชันของ Dota ที่ต่างกัน"
"DOTA_PartyMerge_Error_NO_SUCH_GROUP"	"ปาร์ตี้ไม่มีอยู่แล้ว"
"DOTA_PartyMerge_Error_OTHER_GROUP_NOT_OPEN"	"ปาร์ตี้ไม่ได้เปิดให้ขอเข้าร่วม/รวม"
"DOTA_Feed_Timestamp_Recently"	"เมื่อครู่นี้"
"DOTA_Feed_Timestamp_MinutesAgo"	"{i:value} นาทีที่ผ่านมา"
"DOTA_Feed_Timestamp_HourAgo"	"{i:value} ชั่วโมงที่ผ่านมา"
"DOTA_Feed_Timestamp_HoursAgo"	"{i:value} ชั่วโมงที่ผ่านมา"
"DOTA_Feed_Timestamp_Yesterday"	"เมื่อวานนี้"
"DOTA_Feed_Timestamp_Date"	"{s:day} {s:month}"
"dota_lobby_type_general"	"เกมไม่จัดอันดับ"
"dota_lobby_type_practice"	"เกมฝึกซ้อม"
"dota_lobby_type_practice_game_mode_custom"	"เกมแบบกำหนดเอง"
"dota_lobby_type_tournament"	"การแข่งขันทัวร์นาเมนต์"
"dota_lobby_type_coop_bot"	"ร่วมกันสู้กับบอท"
"dota_lobby_type_competitive"	"แมตช์จัดอันดับ"
"dota_lobby_type_casual_1v1"	"แมตช์ 1v1"
"dota_lobby_unknown"	"ไม่ทราบ"
"DOTA_Lobby_No_Players_Title"	"ไม่มีผู้เล่นอยู่ในทีม"
"DOTA_Lobby_No_Players_Desc"	"คุณต้องมีผู้เล่นอย่างน้อยหนึ่งคนอยู่ในทีม Radiant หรือ Dire"
"dota_match_result_won"	"ชนะ"
"dota_match_result_lost"	"แพ้"
"dota_match_result_none"	"???"
"dota_social_feed_loading"	"กำลังโหลด..."
"DOTA_LoadingPlayerUnknown"	"-"
"DOTA_LoadingPlayerLoading"	"กำลังโหลด..."
"DOTA_LoadingPlayerFullyConnected"	"พร้อม"
"DOTA_LoadingPlayerFailed"	"ล้มเหลว"
"LoadingScreenTimer"	"{t:d:countdown_timer_seconds}"
"HeroSelectionTimer"	"{i:timer_seconds}"
"LoadingScreenMapInfo"	"แผนที่: {s:map_name}"
"LoadingScreenPlayersInfo"	"ผู้เล่น: {i:players_loaded}/{i:players_total}"
"LoadingScreenSpectatorsInfo"	"ผู้ชม: {i:spectators_loaded}/{i:spectators_total}"
"custom_end_screen_victory_message"	"{s:winning_team_name} เป็นฝ่ายชนะ!"
"custom_end_screen_legend_player"	"ผู้เล่น"
"custom_end_screen_legend_level"	"เลเวล"
"custom_end_screen_legend_hero"	"ฮีโร่"
"custom_end_screen_legend_kills"	"K"
"custom_end_screen_legend_deaths"	"D"
"custom_end_screen_legend_assists"	"A"
"custom_end_screen_legend_items"	"ไอเท็ม"
"custom_end_screen_legend_gold"	"โกลด์"
"custom_end_screen_legend_team_score"	"คะแนน"
"custom_scoreboard_hero_name_and_desc"	"{s:hero_name} เลเวล {i:hero_level}"
"CustomEndScreenClose"	"ปิด"
"DOTA_Armory_Category_Heroes"	"ฮีโร่"
"DOTA_Armory_Category_Companions"	"คู่หู"
"DOTA_Armory_Category_Couriers"	"Courier"
"DOTA_Armory_Category_Pets"	"สัตว์เลี้ยง"
"DOTA_Armory_Category_World"	"โลก"
"DOTA_Armory_Category_Wards"	"Ward"
"DOTA_Armory_Category_Weather"	"เอฟเฟกต์สภาพอากาศ"
"DOTA_Armory_Category_Effigies"	"รูปสลัก"
"DOTA_Armory_Category_Interface"	"อินเตอร์เฟส"
"DOTA_Armory_Category_Emoticons"	"อีโมติคอน"
"DOTA_Armory_Category_LoadingScreens"	"หน้าจอโหลด"
"DOTA_Armory_Category_HUDs"	"HUD"
"DOTA_Armory_Category_CursorPacks"	"แพ็คเคอร์เซอร์"
"DOTA_Armory_Category_Audio"	"เสียง"
"DOTA_Armory_Category_VoicePacks"	"แพ็คเสียงพากย์"
"DOTA_Armory_Category_AnnouncerPacks"	"แพ็คเสียงผู้ประกาศ"
"DOTA_Armory_Category_Music"	"ดนตรี"
"DOTA_Armory_Category_All"	"ทั้งหมด"
"DOTA_Armory_Category_Other"	"อื่น ๆ"
"DOTA_Armory_Category_View"	"มุมมองตามประเภท"
"DOTA_Armory_Filter"	"ตั้งตัวกรอง"
"DOTA_Armory_SortBy"	"เรียงตาม:"
"DOTA_Armory_SortBy_Rarity"	"ความหายาก"
"DOTA_Armory_SortBy_Quality"	"คุณภาพ"
"DOTA_Armory_SortBy_Name"	"ชื่อ"
"DOTA_Armory_SortBy_Recent"	"วันที่ได้รับ"
"DOTA_Armory_SortBy_Sockets"	"จำนวนของซ็อกเก็ต"
"DOTA_Armory_Search"	"ค้นหาไอเท็มในคลังแสง"
"DOTA_Armory_ContextMenu_Preview"	"แสดงตัวอย่างไอเท็ม"
"DOTA_Armory_ContextMenu_PreviewSet"	"แสดงตัวอย่างชุดเซ็ต"
"DOTA_Armory_ContextMenu_Equip"	"สวมใส่"
"DOTA_Armory_ContextMenu_Unequip"	"เลิกสวมใส่"
"DOTA_Armory_ContextMenu_Socketing"	"การซ็อกเก็ต"
"DOTA_Armory_ContextMenu_GiftWrap"	"ไอเท็มห่อของขวัญ"
"DOTA_Armory_ContextMenu_Delete"	"ลบ"
"dota_page_match_details_loading"	"กำลังโหลดแมตช์..."
"dota_page_match_details_victory"	"ผู้ชนะ: {s:winner}"
"dota_page_match_details_legend_player"	"ผู้เล่น"
"dota_page_match_details_legend_level"	"เลเวล"
"dota_page_match_details_legend_hero"	"ฮีโร่"
"dota_page_match_details_legend_kills"	"K"
"dota_page_match_details_legend_deaths"	"D"
"dota_page_match_details_legend_assists"	"A"
"dota_page_match_details_legend_items"	"ไอเท็ม"
"dota_page_match_details_legend_gold"	"โกลด์"
"dota_page_match_details_legend_last_hits"	"LH"
"dota_page_match_details_legend_denies"	"DN"
"dota_page_match_details_legend_gold_per_min"	"GPM"
"dota_page_match_details_legend_xp_per_min"	"XPM"
"dota_page_match_details_legend_winner_tooltip"	"ทีมที่กำลังชนะ"
"dota_page_match_details_legend_kills_tooltip"	"สังหาร"
"dota_page_match_details_legend_deaths_tooltip"	"ตาย"
"dota_page_match_details_legend_assists_tooltip"	"ช่วยเหลือ"
"dota_page_match_details_legend_last_hits_tooltip"	"Last Hit ครีป"
"dota_page_match_details_legend_denies_tooltip"	"Deny ครีป"
"dota_page_match_details_legend_gold_per_min_tooltip"	"โกลด์ต่อนาที"
"dota_page_match_details_legend_xp_per_min_tooltip"	"ค่าประสบการณ์ต่อนาที"
"dota_page_match_details_header_league_name"	"ชื่อลีก"
"dota_page_match_details_header_custom_game_map_name"	"ชื่อแผนที่"
"dota_page_match_details_header_match_id"	"ไอดีแมตช์"
"dota_page_match_details_header_game_mode"	"โหมดเกม"
"dota_page_match_details_header_duration"	"ระยะเวลา"
"dota_page_match_details_header_timestamp"	"วันที่ / เวลาแมตช์"
"dota_page_match_details_voting_votes"	"{i:num_votes} โหวต"
"dota_page_match_details_match_discussion"	"การอภิปรายแมตช์"
"dota_page_match_details_comment_placeholder"	"เขียนความคิดเห็น..."
"dota_page_match_details_comment_loading_comments"	"กำลังโหลดความคิดเห็น..."
"dota_page_match_details_comment_no_comments"	"ไม่มีความคิดเห็นถูกโพสต์ลงในแมตช์นี้"
"dota_page_match_details_replay_existence_unknown"	"กำลังค้นหารีเพลย์..."
"dota_page_match_details_replay_existence_cdn_found"	"ดาวน์โหลดรีเพลย์"
"dota_page_match_details_replay_existence_not_found"	"ไม่พบรีเพลย์"
"dota_page_match_details_replay_existence_downloading"	"กำลังดาวน์โหลด..."
"dota_page_match_details_replay_existence_disk_found_replay"	"ดูรีเพลย์"
"dota_page_match_details_replay_existence_disk_found_highlights"	"ชมไฮไลต์"
"dota_page_match_details_replay_existence_wrong_engine"	"รีเพลย์บน Source 1 ไม่สามารถทำงานบน Source 2 ได้"
"dota_profile_content_tab_activity_feed"	"ฟีดกิจกรรม"
"dota_profile_content_tab_recent_games"	"เกมที่ผ่านมา"
"dota_profile_recent_games_option_show_practice_matches"	"แสดงแมตช์ฝึกฝน"
"dota_profile_recent_game_header_timestamp"	"วันที่ / เวลา"
"dota_profile_recent_game_header_hero_name"	"ฮีโร่ที่เล่น"
"dota_profile_recent_game_header_result"	"ผลการแข่ง"
"dota_profile_recent_game_header_duration"	"ระยะเวลา"
"dota_profile_recent_game_header_type"	"ชนิด"
"dota_profile_recent_game_result_win"	"ชนะ"
"dota_profile_recent_game_result_loss"	"แพ้"
"dota_profile_recent_game_result_abandon"	"ละทิ้ง"
"dota_profile_recent_game_icon_source1"	"S1"
"dota_profile_hero_with_index"	"{d:hero_index} {s:hero_name}"
"dota_profile_hero"	"{s:hero_name}"
"dota_replay_manager_error_not_found"	"ไม่สามารถค้นหารีเพลย์บน CDN ได้"
"dota_replay_manager_error_existing_partial"	"ไม่สามารถลบไฟล์รีเพลย์บางส่วนที่มีอยู่ได้"
"dota_replay_manager_error_creation_failure"	"ไม่สามารถสร้างไฟล์รีเพลย์บางส่วนได้"
"dota_replay_manager_error_disk_full"	"ไม่สามารถจัดสรรพื้นที่สำหรับไฟล์รีเพลย์ได้"
"dota_replay_manager_error_chunk_failed"	"ล้มเหลวในการดาวน์โหลดไฟล์รีเพลย์"
"dota_replay_manager_error_write_failure"	"ไม่สามารถเขียนไฟล์รีเพลย์บางส่วนได้"
"dota_replay_manager_error_partial_compressed_open_failure"	"ไม่สามารถเปิดไฟล์รีเพลย์ที่ถูกบีบอัดได้"
"dota_replay_manager_error_partial_decompressed_open_failure"	"ไม่สามารถเปิดไฟล์รีเพลย์ที่แตกออกได้"
"dota_replay_manager_error_partial_decompression_failure"	"ล้มเหลวในการแตกไฟล์รีเพลย์"
"dota_replay_manager_error_partial_decompression_write_failure"	"ล้มเหลวในการเขียนไฟล์รีเพลย์ที่แตกออกได้"
"dota_page_match_details_replay_error_not_found"	"ไม่พบรีเพลย์บนดิสก์"
"DOTA_tooltip_econ_item_name"	"{s:item_name}"
"DOTA_tooltip_econ_item_description"	"{s:item_description}"
"DOTA_tooltip_econ_item_set"	"หน้าของ: <font color='#dddddd'>{s:item_set}</font>"
"DOTA_tooltip_econ_item_rarity_label"	"ระดับความหายาก: "
"DOTA_tooltip_econ_item_rarity"	"{s:item_rarity}"
"DOTA_tooltip_econ_item_slot"	"ช่อง: {s:item_slot}"
"DOTA_tooltip_econ_item_gifter"	"{g:dota_persona:gifter_name}"
"DOTA_tooltip_econ_item_gift_received_date"	"ได้รับ: {t:T:gift_received_date_time}"
"DOTA_tooltip_econ_item_trade_restriction_permanent"	"ไม่สามารถแลกเปลี่ยนได้"
"DOTA_tooltip_econ_item_trade_restriction_date"	"ไม่สามารถแลกเปลี่ยนได้จนถึง: {t:T:tradable_after_date_time} {t:s:tradable_after_date_time}"
"DOTA_tooltip_econ_item_market_restriction_permanent"	"ไม่สามารถซื้อขายในตลาดได้"
"DOTA_tooltip_econ_item_gift_restriction_permanent"	"ไม่สามารถมอบเป็นของขวัญได้"
"DOTA_tooltip_econ_item_gift_restriction_date"	"ไม่สามารถมอบเป็นของขวัญได้จนถึง: {t:T:giftable_after_date_time} {t:s:giftable_after_date_time}"
"DOTA_tooltip_econ_item_gem_type"	"{s:gem_type}"
"DOTA_tooltip_econ_item_gem_strange_count"	"{d:strange_count}"
"DOTA_tooltip_econ_item_gem_description"	"{s:gem_description}"
"DOTA_tooltip_econ_item_partner"	"{s:partner}"
"DOTA_econ_item_details_item_name"	"{s:item_name}"
"DOTA_econ_item_details_item_creation_date"	"วันที่สร้าง: {t:l:creation_date}"
"DOTA_econ_item_details_set_includes"	"ประกอบไปด้วยดังนี้:"
"DOTA_econ_item_details_item_set"	"หน้าของ: <font color='#dddddd'>{s:item_set}</font>"
"DOTA_econ_item_details_rarity_label"	"ระดับความหายาก: "
"DOTA_econ_item_details_item_rarity"	"{s:item_rarity}"
"DOTA_econ_item_details_item_slot"	"ช่อง: {s:item_slot}"
"DOTA_econ_item_details_item_description"	"{s:item_description}"
"DOTA_econ_item_details_gem_type"	"{s:gem_type}"
"DOTA_econ_item_details_gem_strange_count"	"{d:strange_count}"
"DOTA_econ_item_details_gem_description"	"{s:gem_description}"
"DOTA_Treasure_Name"	"{s:treasure_name}"
"DOTA_Treasure_Rarity"	"สมบัติ <span class=\"ItemRarityColor\">{s:treasure_rarity}</span>"
"DOTA_Voice_Party"	"เสียงพูดปาร์ตี้"
"custom_game_mismatch_title"	"ข้อมูลเกมแบบกำหนดเองไม่ตรงกัน"
"custom_game_mismatch_desc"	"ข้อมูลเกมแบบกำหนดเองที่เก็บไว้ระหว่างเซิร์ฟเวอร์และไคลเอนต์เกมไม่ตรงกัน"
"custom_game_team_select"	"เลือกทีม"
"custom_game_team_select_timer"	"{i:countdown_timer_seconds}"
"custom_game_team_select_shuffle"	"สับเปลี่ยน"
"custom_game_team_select_auto_start"	"เริ่มอัตโนมัติ"
"custom_game_team_select_starting"	"กำลังเริ่ม"
"custom_game_team_select_unassigned_players"	"ผู้เล่นที่ไม่ได้กำหนด"
"custom_game_team_select_lock_start"	"ล็อค + เริ่ม"
"custom_game_team_select_cancel_unlock"	"ยกเลิก + ปลดล็อค"
"custom_game_team_select_join"	"เข้าร่วม"
"custom_game_team_select_empty_slot"	"ช่องว่าง"
"custom_game_team_select_auto_assign"	"กำหนดอัตโนมัติ"
"custom_game_default_gameinfo_text"	"กลับมาดูอีกทีสำหรับข้อมูลเพิ่มเติมเกี่ยวกับเกมแบบกำหนดเองนี้!"
"CouldntFindCompendium"	"ไม่สามารถโหลดไฟล์ทดสอบของ Compendium: %s1"
"CompendiumPageError_Pages"	"ไม่พบบล็อค 'pages' ในไฟล์ข้อมูล Compendium"
"CompendiumPageError_Template"	"ไม่สามารถค้นหารายการ 'template' สำหรับ Compendium หน้า '{s:s1}' (หน้าที่ {s:s2}) ได้"
"CompendiumPageError_Template2"	"ไม่สามารถค้นหาแม่แบบที่ชื่อ '{s:s1}' ใน Compendium หน้า '{s:s2}'"
"CompendiumPageError_Image"	"ไม่สามารถค้นหาภาพที่ชื่อ '{s:s1}' ใน Compendium หน้า '{s:s2}'"
"CompendiumPageError_Text"	"ไม่สามารถค้นหาช่องข้อความที่ชื่อ '{s:s1}' ใน Compendium หน้า '{s:s2}' ได้"
"CompendiumPageError_Video"	"ไม่พบวิดีโอที่ชื่อว่า '{s:s1}' ใน Compendium หน้า '{s:s2}'"
"CompendiumPageError_Scrollbar"	"ไม่สามารถค้นหาแถบเลื่อนที่ชื่อ '{s:s1}' ใน Compendium หน้า '{s:s2}' ได้"
"CompendiumPageError_Selection"	"ไม่สามารถค้นหาตัวเลือกที่ชื่อ '{s:s1}' ใน Compendium หน้า '{s:s2}' ได้"
"CompendiumPageError_PageNames"	"หน้า '{s:s1}' ที่ถูกฝังมีเหมือนกับอีกหน้า ชื่อหน้าจำเป็นต้องแตกต่างกัน"
"CompendiumPageError_CustomText"	"เกิดข้อผิดพลาดในช่องข้อความ '{s:s1}' ที่กำหนดเองใน Compendium หน้า '{s:s2}'"
"CompendiumPageError_CustomImg"	"เกิดข้อผิดพลาดในช่องภาพ \\'%s1\\'"
"CompendiumPageError_CustomBar"	"พบข้อผิดพลาดในแถบสถานะ '{s:s1}' ใน Compendium หน้า '{s:s2}'"
"CompendiumPageError_CustomEle"	"ล้มเหลวในการยกตัวอย่างแบบกำหนดเองขององค์ประกอบ '{s:s1}' ใน Compendium หน้า '{s:s2}'"
"CompendiumPageError_CTFont"	"ฟอนต์ '{s:s1}' ที่ระบุใน Compendium หน้า '{s:s2}' ฟอนต์ที่ถูกต้อง:\\\ntext, textbold, title"
"CompendiumPageError_CTAlign"	"การจัดวางตำแหน่งของ '{s:s1}' ที่ระบุใน compendium หน้า '{s:s2}' การจัดวางตำแหน่งที่ถูกต้อง:\\\n left, right, center"
"CompendiumPageError_CTDepth"	"ความลึก '{s:s1}' ไม่ถูกต้อง ความลึกที่ถูกต้อง:\n front, back"
"CompendiumPageError_LinePos"	"บรรทัด '{s:s1}' ไม่มีตำแหน่งบล็อค 'start' และ 'end'"
"CompendiumPageError_CTPoints"	"ตัวเลือกสารบัญ '{s:s1}' ในส่วน 'points' ของข้อความ '{s:s2}' ที่กำหนดเองไม่ถูกต้อง"
"CompendiumPageError_CTPoints2"	"ตัวเลือกสารบัญ '{s:s1}' ในส่วน \\'แต้ม\\' ของข้อความ '{s:s2}' ที่กำหนดเองไม่ถูกต้อง ไม่พบตัวเลือกที่หน้าสารบัญนั้น"
"CompendiumPageError_SelDesc"	"ไม่พบข้อ 'description' สำหรับตัวเลือก '{s:s1}' ใน Compendium หน้า '{s:s2}' ได้"
"CompendiumPageError_Points"	"'points' ที่ระบุไว้สำหรับตัวเลือก '{s:s1}' ใน Compendium หน้า '{s:s2}' หายไป (หรือว่างเปล่า)"
"CompendiumPageError_SelType"	"'choice_type' สำหรับตัวเลือก '{s:s1}' ใน Compendium หน้า '{s:s2}' หายไป"
"CompendiumPageError_BarType"	"ไม่พบ 'data' สำหรับแถบสถานะ '{s:s1}' ใน Compendium หน้า '{s:s2}'"
"CompendiumPageError_NoTime"	"'time' ที่ระบุไว้สำหรับตัวเลือก '{s:s1}' ใน '{s:s2}' หายไปหรือไม่ถูกต้อง"
"CompendiumPageError_ElementType"	"'elementtype' สำหรับองค์ประกอบ '{s:s1}' ใน Compendium หน้า '{s:s2}' หายไปหรือไม่ถูกต้อง"
"CompendiumPageError_SelTimer"	"ไม่ทราบชื่อ '{s:s1}' ของตัวจับเวลาใน Compendium หน้า '{s:s2}'"
"CompendiumPageError_BadElement"	"ไม่ทราบองค์ประกอบ SF ที่ชื่อ '{s:s1}' ใน Compendium หน้า '{s:s2}'"
"CompendiumPageError_SelNoTimer"	"ไม่พบตัวจับเวลาใน Compendium หน้า '{s:s1}' (เพราะมันมีตัวเลือก ที่ต้องการตัวจับเวลา)"
"CompendiumPageError_SelUnknown"	"'choice_type' ของ '{s:s1}' สำหรับตัวเลือก '{s:s2}' ไม่ถูกต้อง"
"CompendiumPageError_BarUnknown"	"'ข้อมูล' ของ '{s:s1}' สำหรับตัวเลือก '{s:s2}' ไม่ถูกต้อง"
"CompendiumPageError_InvalidEquation"	"สมการที่ระบุไม่ถูกต้อง: '{s:s1}' สำหรับ '{s:s2}'"
"CompendiumPageError_SelChoices"	"ช่อง 'choices' สำหรับตัวเลือก '{s:s1}' ใน Compendium หน้า '{s:s2}' หายไป"
"CompendiumPageError_NoHero"	"ไม่สามารถหาฮีโร่ด้วย ID ฮีโร่ของ '{s:s1}' สำหรับตัวเลือก '{s:s2}'"
"CompendiumPageError_Unknown"	"ภายในตรรกกะ Compendium ผิดพลาด ติดต่อ Valve เพื่อแก้ไขปัญหานี้"
"CompendiumPageError_ImageDL"	"ล้มเหลวในการเริ่มดาวน์โหลดภาพ Compendium '{s:s1}' ({s:s2})"
"CompendiumPageError_ImageDLErr"	"ล้มเหลวในการดาวน์โหลดภาพ Compendium '%s' ({s:s2})"
"CompendiumPageError_BtnNoElem"	"ไม่พบช่อง 'selection_elements' สำหรับปุ่ม '{s:s1}' ใน Compendium หน้า '{s:s2}'"
"CompendiumPageError_BtnBadVal"	"ค่าตัวเลือก '{s:s1}' ในปุ่ม '{s:s2}' ไม่ได้อยู่ในรายการทางเลือกสำหรับดัชนีตัวเลือกนั้น"
"CompendiumPageError_BtnBadSel"	"การตั้งค่า 'selection_force_to' ในส่วน '{s:s1}' ไม่ได้อยู่ในรายการตัวเลือกสำหรับการเลือก '{s:s2}'"
"CompendiumPageError_BtnSelIdx"	"ปุ่ม '{s:s1}' ใน Compendium หน้า '{s:s2}' ได้หายไปหรือ 'selection_index' ไม่ถูกต้อง"
"CompendiumPageError_CmdSelIdx"	"ส่วน '{s:s1}' ในหน้า Compendium '{s:s2}' มีคำสั่ง 'selection_index' หรือ 'force_selection_index' ที่ผิดพลาดหรือไม่ถูกต้อง"
"CompendiumPageError_ImgSelIdx"	"'selection_index' ของ '{s:s1}' ในรูปภาพ '{s:s2}' ไม่ถูกต้อง"
"CompendiumPageError_ImgShowSelIdx"	"'show_selection_index' ของ '{s:s1}' ในภาพ '{s:s2}' ไม่ถูกต้อง"
"CompendiumPageError_ImgSelVal"	"ทางเลือกตัวเลือก '{s:s1}' ในส่วน 'show_selection_images' ของภาพ '{s:s2}' ไม่ถูกต้อง"
"CompendiumPageError_ImgBadStyle"	"รูปแบบ '{s:s1} ของภาพ '{s:s2}' ไม่ถูกต้อง"
"CompendiumPageError_DynTxtSel"	"ข้อความ '{s:s1}' ในหน้า '{s:s2}' มี % selection_X % ที่ไม่ถูกต้อง ไม่มีตัวเลือกลงทะเบียนล่วงหน้ากับสารบัญนั้น"
"CompendiumPageError_NoTxtList"	"ไม่พบ Textlist ชื่อ '{s:s1}' บนหน้า '{s:s2}'"
"CompendiumPageError_TOCPage"	"table_of_contents_page หน้า '{s:s1}' ไม่มีอยู่"
"CompendiumPageError_SelIndex"	"ตัวเลือก '{s:s1}' ใน Compendium หน้า '{s:s2}' มีส่วน 'selection_index' หายไปหรือไม่ถูกต้อง"
"CompendiumPageError_SelUsed"	"ตัวเลือก '{s:s1}' ใน Compendium หน้า '{s:s2}' ไม่มี 'selection_index' ที่ไม่ซ้ำกัน"
"CompendiumPageError_SelVal"	"ตัวเลือก '{s:s1}' ใน Compendium หน้า '{s:s2}' ถูกเลือกด้วยค่าที่เหมือนกัน"
"CompendiumPageError_SelValInv"	"ตัวเลือก '{s:s1}' ใน Compendium หน้า '{s:s2}' เป็นตัวเลือกที่มีค่า <= 0 ค่าในการเลือกจะต้องมากกว่า 0"
"CompendiumPageError_SelTTVal"	"ตัวเลือก '{s:s1}' ใน Compendium หน้า '{s:s2}' มีการเข้าถึง tooltip_data ด้วยค่า ซึ่งมันไม่มีอยู่ในรายชื่อตัวเลือก"
"CompendiumPageError_NoAnswer"	"ตัวเลือก '{s:s1}' ใน Compendium หน้า '{s:s2}' ไม่มี 'answer' หรือ 'answers' ในส่วน 'result'"
"CompendiumPageError_MissAnswer"	"ตัวเลือก '{s:s1}' ใน Compendium หน้า '{s:s2}' มีข้อ 'answer' หรือ 'answers' ที่ไม่ตรงกับตัวเลือกใด ๆ เลย"
"CompendiumPageError_Timer"	"ตัวจับเวลา '{s:s1}' มีเวลายูนิกซ์ที่ไม่ถูกต้อง"
"CompendiumPageError_UnknownAction"	"วัตถุ '{s:s1}' อ้างอิงการกระทำที่ไม่รู้จัก '{s:s2}'"
"CompendiumPageError_SameElement"	"ระบบการมองเห็นได้พบส่วนประกอบจำนวนมากที่ชื่อ '{s:s1}' ในหน้า '{s:s2}'"
"CompendiumPageError_DupeKey"	"บล็อค Keyvalue '{s:s1}' มีจำนวนหลายปุ่มด้วยชื่อ '{s:s2}' เหมือนกัน"
"CompendiumError_Template"	"ไม่สามารถค้นหาชื่อแม่แบบ '{s:s1}' ได้"
"CompendiumError_DupeTemplate"	"พบแม่แบบชื่อ '{s:s1}' จำนวนมาก"
"CompendiumError_NoDefines"	"แม่แบบ '{s:s1}' ต้องถูกกำหนด แต่ตัวอย่าง '{s:s2}' ของแม่แบบไม่มีบล็อค 'defines'"
"CompendiumError_MissingDef"	"ตัวอย่าง '{s:s1}' ที่ได้มาไม่มีตัวกำหนดชื่อ '{s:s2}' แต่แม่แบบที่ใช้งานต้องมี"
"CompendiumError_BadDef"	"ตัวอย่าง '{s:s1}' ที่ได้มามีชื่อ '{s:s2}' ที่ต้องกำหนดที่ไม่ได้เริ่มต้นด้วย '%def' ซึ่งจำเป็นต้องมี"
"CompendiumError_FailedPanoramaGen"	"ล้มเหลวในการสร้างแผนผัง Panorama สำหรับหน้า '{s:s1}'"
"CompendiumError_FailedXMLWrite"	"ล้มเหลวในการเขียน XML สำหรับหน้า '{s:s1}' ให้กับไฟล์ชื่อ '{s:s2}'"
"CompendiumError_FailedCSSWrite"	"ล้มเหลวในการเขียน CSS สำหรับหน้า '{s:s1}' ให้กับไฟล์ชื่อ '{s:s2}'"
"DOTA_GlobalItems_Companions"	"คู่หู"
"DOTA_GlobalItems_Couriers"	"Courier"
"DOTA_GlobalItems_Pets"	"สัตว์เลี้ยง"
"DOTA_GlobalItems_World"	"โลก"
"DOTA_GlobalItems_Wards"	"Ward"
"DOTA_GlobalItems_Effigies"	"รูปสลัก"
"DOTA_GlobalItems_Weather"	"เอฟเฟกต์สภาพอากาศ"
"DOTA_GlobalItems_Interface"	"อินเตอร์เฟส"
"DOTA_GlobalItems_Emoticons"	"อีโมติคอน"
"DOTA_GlobalItems_LoadingScreens"	"หน้าจอโหลด"
"DOTA_GlobalItems_HUDs"	"HUD"
"DOTA_GlobalItems_Audio"	"เสียง"
"DOTA_GlobalItems_Announcers"	"แพ็คผู้ประกาศ"
"DOTA_GlobalItems_Music"	"ดนตรี"
"DOTA_Search"	"ค้นหา"
"DOTA_Start"	"เริ่ม"
"DOTA_PleaseWait"	"โปรดรอสักครู่..."
"DOTA_ProfileCard_HeroHover"	"แสดงเมื่อชี้:"
"DOTA_ChallengeGroup_2_Desc"	"ฝึกฝนกับฮีโร่ที่ถูกควบคุมโดย AI ในพื้นที่ฝึกที่ปราศจากความเครียด"
"DOTA_ChatTab_ToggleSounds"	"เปิดเสียงเตือนเมื่อได้รับข้อความจากแชนแนลนี้"
"dota_lobby_balanced_shuffle"	"สับเปลี่ยนให้สมดุล"
"dota_lobby_swap_teams"	"สลับทีม"
"dota_lobby_unassigned_players"	"ผู้เล่นที่ไม่ได้กำหนด"
"dota_lobby_settings"	"การตั้งค่าล็อบบี้"
"dota_lobby_settings_edit"	"แก้ไข"
"dota_lobby_leave"	"ออกจากล็อบบี้นี้"
"DOTA_Custom_Game_View_Lobby_List"	"ดูรายชื่อล็อบบี้"
"DOTA_Custom_Game_Lobby_List_Title"	"รายชื่อล็อบบี้"
"DOTA_Custom_Game_Browse_All"	"เปิดหาเกมทั้งหมด"
"DOTA_Custom_Game_Friends_Ready"	"เพื่อนที่พร้อมเล่น"
"DOTA_Custom_Game_Friends_Who_Play"	"เพื่อนที่เล่น"
"DOTA_Custom_Game_Friends_Playing_Now"	"เพื่อนที่กำลังเล่นในขณะนี้"
"DOTA_Custom_Game_Browse_Sort"	"จัดเรียง:"
"DOTA_Custom_Game_Sort_Popular_Today"	"อันดับสูงสุด (วันนี้)"
"DOTA_Custom_Game_Sort_Popular_Week"	"อันดับสูงสุด (สัปดาห์นี้)"
"DOTA_Custom_Game_Sort_Top_Rated"	"อันดับสูงสุด (ตลอดกาล)"
"DOTA_Custom_Game_Sort_Date"	"วันที่เผยแพร่"
"DOTA_WatchLive_WatchLabel"	"เข้าชม:"
"DOTA_WatchLive_ThirdParty"	"ภายนอก"
"DOTA_WatchLive_Steam"	"STEAM"
"DOTA_WatchLive_InGame"	"ในเกม"
"DOTA_WatchLive_Broadcaster0"	"เข้าชม {g:dota_persona:b:broadcaster_account_id_0}"
"DOTA_WatchLive_Broadcaster1"	"เข้าชม {g:dota_persona:b:broadcaster_account_id_1}"
"DOTA_WatchLive_Broadcaster2"	"เข้าชม {g:dota_persona:b:broadcaster_account_id_2}"
"DOTA_WatchLive_Broadcaster3"	"เข้าชม {g:dota_persona:b:broadcaster_account_id_3}"
"DOTA_WatchLive_Broadcaster4"	"เข้าชม {g:dota_persona:b:broadcaster_account_id_4}"
"DOTA_WatchLive_Broadcaster5"	"เข้าชม {g:dota_persona:b:broadcaster_account_id_5}"
"DOTA_WatchLive_Broadcaster6"	"เข้าชม {g:dota_persona:b:broadcaster_account_id_6}"
"DOTA_WatchLive_Broadcaster7"	"เข้าชม {g:dota_persona:b:broadcaster_account_id_7}"
"DOTA_WatchLive_Broadcaster8"	"เข้าชม {g:dota_persona:b:broadcaster_account_id_8}"
"DOTA_WatchLive_Broadcaster9"	"เข้าชม {g:dota_persona:b:broadcaster_account_id_9}"
"dota_matchmaking_region_title_confirm"	"ยืนยันภูมิภาคการค้นหาคู่ต่อสู้"
"dota_play_lobby_games"	"ดูล็อบบี้"
"dota_play_host_loading"	"โฮสต์กำลังโหลด..."
"dota_play_connecting_to_server"	"กำลังเชื่อมต่อ..."
"dota_reconnecting"	"กำลังเชื่อมต่ออีกครั้ง..."
"dota_matchmaking_regions_retry"	"ลองใหม่"
"dota_matchmaking_region_ping_calculating"	"ค่าปิง: กำลังคำนวณ..."
"dota_matchmaking_region_ping_failed"	"ค่าปิง: ล้มเหลว"
"dota_matchmaking_region_or"	"หรือ"
"dota_matchmaking_region_selected_offline"	"ภูมิภาคที่เลือกอย่างน้อยหนึ่งภูมิภาคกำลังออฟไลน์ชั่วคราว"
"dota_matchmaking_region_selected_unreachable"	"ไม่สามารถยืนยันการเชื่อมต่อเครือข่ายไปยังภูมิภาคที่เลือก"
"dota_matchmaking_region_all_unavailable"	"ไม่สามารถหาค่าปิงกับภูมิภาคได้ โปรดตรวจสอบการเชื่อมต่ออินเทอร์เน็ตของคุณ"
"dota_matchmaking_region_check_internet"	"ตรวจสอบการเชื่อมต่ออินเทอร์เน็ตของคุณ"
"dota_matchmaking_region_poor_choices"	"ตัวเลือกภูมิภาคปัจจุบันอาจผลให้การเชื่อมต่อไปยังเซิร์ฟเวอร์เกมช้า"
"dota_settings_hide_party_unless_open"	"ซ่อนสถานะปาร์ตี้ของฉัน เมื่อไม่ได้อยู่ในปาร์ตี้เปิด"
"dota_settings_open_party_manual_accept_invites"	"ปิดการยอมรับคำเชิญปาร์ตี้อัตโนมัติ ขณะอยู่ในปาร์ตี้เปิด"
"dota_settings_networkhud"	"แสดงข้อมูลเครือข่าย"
"dota_settings_fullscreenbrightness"	"ความสว่าง"
"dota_settings_dashboard_renderquality"	"แดชบอร์ดคุณภาพสูง"
"dota_settings_lowlatency_audio"	"ตรวจหาความล่าช้าเสียงอัตโนมัติ"
"dota_settings_quicktargetattack"	"โจมตีอย่างรวดเร็ว"
"dota_settings_chat_whispers"	"แสดงข้อความ Steam เป็นกระซิบ"
"dota_settings_no_mode_resolutions"	"ไม่มีความละเอียดที่สนับสนุน"
"DOTA_Settings_Tooltip_QuickTargetAttack"	"การกดปุ่มโจมตีจะโจมตีไปที่ตำแหน่งของเคอร์เซอร์เมาส์ทันที"
"dota_lobby_browser_header_name"	"ชื่อล็อบบี้"
"dota_lobby_browser_header_slots"	"ช่อง"
"dota_lobby_browser_header_game_mode"	"โหมดเกม"
"dota_lobby_browser_region"	"ภูมิภาค"
"dota_lobby_browser_lobby_name"	"ชื่อล็อบบี้"
"DOTA_Friend_Game_Mode_Self"	"คุณกำลังอยู่ในเกม {s:game_mode}"
"DOTA_Friend_Game_Mode_1_Friend"	"{s:player_name} กำลังเล่น {s:game_mode}"
"DOTA_Friend_Game_Mode_N_Friends"	"เพื่อน {d:num_friends} คนกำลังเล่น {s:game_mode}"
"custom_game_lobby_mismatch"	"ข้อมูลเกมแบบกำหนดเองที่เก็บไว้ไม่ตรงกับข้อมูลของหัวหน้าล็อบบี้"
"CompendiumError_XMLLoadFail"	"การโหลด XML สำหรับหน้า '{s:s1}' ในไฟล์ที่ชื่อ '{s:s2}' ล้มเหลว"
"CompendiumError_XMLParseFail"	"การแปลง XML สำหรับหน้า '{s:s1}' ในไฟล์ที่ชื่อ '{s:s2}' ล้มเหลว"
"Compendium_DefaultText_TimerTitle_Active"	"การเลือกจะสิ้นสุดลงในอีก"
"Compendium_DefaultText_TimerTitle_Expired"	"การเลือกได้สิ้นสุดลงแล้ว"
"Compendium_DefaultText_CD_Days"	"วัน"
"Compendium_DefaultText_CD_Hours"	"ชั่วโมง"
"Compendium_DefaultText_CD_Minutes"	"นาที"
"Compendium_DefaultText_CD_Seconds"	"วินาที"
"NetGraph_FPS"	"fps: {d:fps}"
"NetGraph_Ping"	"ค่าปิง: {d:ping}ms"
"NetGraph_Loss"	"ค่าสูญเสีย: {d:loss}%"
"DOTA_Credits"	"กิตติกรรมประกาศ"
"DOTA_ActorCredits_1_Name"	"Dee Bradley Baker"
"DOTA_ActorCredits_1_Heroes"	"Techies"
"DOTA_ActorCredits_2_Name"	"Dennis Bateman"
"DOTA_ActorCredits_2_Heroes"	"Invoker"
"DOTA_ActorCredits_3_Name"	"Tom Chantler"
"DOTA_ActorCredits_3_Heroes"	"Centaur,Lion,Obsidian Destroyer,Riki,Slark,Tusk,Witch Doctor"
"DOTA_ActorCredits_4_Name"	"Merle Dandridge"
"DOTA_ActorCredits_4_Heroes"	"Legion Commander,Winter Wyvern"
"DOTA_ActorCredits_5_Name"	"Barry Dennen"
"DOTA_ActorCredits_5_Heroes"	"Chaos Knight,Phantom Lancer,Rubick"
"DOTA_ActorCredits_6_Name"	"Dave Fennoy"
"DOTA_ActorCredits_6_Heroes"	"Batrider,Ember Spirit,Faceless Void,Jakiro,Venomancer,Skeleton King"
"DOTA_ActorCredits_7_Name"	"Jim French"
"DOTA_ActorCredits_7_Heroes"	"Elder Titan"
"DOTA_ActorCredits_8_Name"	"Michael Gregory"
"DOTA_ActorCredits_8_Heroes"	"Bounty Hunter,Clinkz,Silencer"
"DOTA_ActorCredits_9_Name"	"Gin Hammond"
"DOTA_ActorCredits_9_Heroes"	"Crystal Maiden,Drow Ranger,Enchantress,Mirana,Phantom Assassin,Spectre,Vengeful Spirit"
"DOTA_ActorCredits_10_Name"	"John Patrick Lowrie"
"DOTA_ActorCredits_10_Heroes"	"Ancient Apparition,Dark Seer,Doom Bringer,Earthshaker,Pudge,Nevermore,Storm Spirit"
"DOTA_ActorCredits_11_Name"	"Ellen McLain"
"DOTA_ActorCredits_11_Heroes"	"Broodmother,Death Prophet"
"DOTA_ActorCredits_12_Name"	"Bruce Miles"
"DOTA_ActorCredits_12_Heroes"	"Alchemist,Lifestealer,Omniknight"
"DOTA_ActorCredits_13_Name"	"Linda K. Morris"
"DOTA_ActorCredits_13_Heroes"	"Luna,Naga Siren,Queen of Pain,Templar Assassin"
"DOTA_ActorCredits_13_Extra"	"เสียงผู้ประกาศ"
"DOTA_ActorCredits_14_Name"	"Sam A. Mowry"
"DOTA_ActorCredits_14_Heroes"	"Antimage,Beastmaster,Rattletrap,Necrolyte,Slardar,Warlock"
"DOTA_ActorCredits_14_Extra"	"พ่อค้าร้านค้าลับ"
"DOTA_ActorCredits_15_Name"	"Eric Newsome"
"DOTA_ActorCredits_15_Heroes"	"Chen,Leshrac,Furion,Razor,Tidehunter,Tiny,Zeus"
"DOTA_ActorCredits_16_Name"	"Nolan North"
"DOTA_ActorCredits_16_Heroes"	"Brewmaster,Earth Spirit,Gyrocopter,Keeper of the Light,Lone Druid,Lycan,Meepo,Ogre Magi,Shadow Demon,Troll Warlord"
"DOTA_ActorCredits_17_Name"	"Dempsey Pappion"
"DOTA_ActorCredits_17_Heroes"	"Magnataur,Nyx Assassin,Visage"
"DOTA_ActorCredits_18_Name"	"TJ Ramini"
"DOTA_ActorCredits_18_Heroes"	"Abaddon,Bristleback,Skywrath Mage,Shredder"
"DOTA_ActorCredits_19_Name"	"Harry S. Robins"
"DOTA_ActorCredits_19_Heroes"	"Tinker"
"DOTA_ActorCredits_20_Name"	"Gary Schwartz"
"DOTA_ActorCredits_20_Heroes"	"Lich,Pugna"
"DOTA_ActorCredits_21_Name"	"David Scully"
"DOTA_ActorCredits_21_Heroes"	"Bane,Dazzle,Juggernaut,Morphling,Sand King,Sven,Weaver"
"DOTA_ActorCredits_22_Name"	"Mike Shapiro"
"DOTA_ActorCredits_22_Heroes"	"Oracle"
"DOTA_ActorCredits_23_Name"	"David Sobolov"
"DOTA_ActorCredits_23_Heroes"	"Terrorblade"
"DOTA_ActorCredits_24_Name"	"Jon St. John"
"DOTA_ActorCredits_24_Heroes"	"Axe,Bloodseeker,Enigma,Kunkka"
"DOTA_ActorCredits_25_Name"	"Fred Tatasciore"
"DOTA_ActorCredits_25_Heroes"	"Disruptor,Spirit Breaker,Treant,Undying,Ursa"
"DOTA_ActorCredits_25_Extra"	"Warlock's Golem"
"DOTA_ActorCredits_26_Name"	"Jen Taylor"
"DOTA_ActorCredits_26_Heroes"	"Lina,Medusa,Puck,Windranger"
"DOTA_ActorCredits_27_Name"	"Tony Todd"
"DOTA_ActorCredits_27_Heroes"	"Dragon Knight,Night Stalker,Viper"
"DOTA_ActorCredits_28_Name"	"
"
"DOTA_ActorCredits_28_Heroes"	"
"
"DOTA_PlayerContextMenu_Trade"	"เชิญเข้าร่วมการแลกเปลี่ยน"
"DOTA_Custom_Game_Finished_Vote_Title"	"ให้คะแนนเกมแบบกำหนดเอง"
"DOTA_Custom_Game_Finished_Vote_Question"	"คุณคิดว่าเกมแบบกำหนดเองเกมนี้เป็นอย่างไร?"
"DOTA_Custom_Game_Finished_Vote_Skip"	"ข้าม"
"DOTA_TabName_ModsLobbyList"	"รายชื่อล็อบบี้"
"DOTA_WatchLive_Fullscreen"	"เต็มจอ"
"DOTA_JoinChatChannel_ChannelName"	"ชื่อแชนแนล"
"DOTA_JoinChatChannel_ChannelMemberCount"	"สมาชิก"
"DOTA_Chat_ChannelMemberCount"	"{d:channel_member_count}"
"dota_settings_coop_fullscreen"	"โหมดเต็มหน้าจอ เหมาะสมกับเดสก์ทอป"
"DOTA_Trading_UI_Body_Outgoing"	"กำลังรอ {s:player_name} ตอบรับข้อเสนอของคุณ..."
"DOTA_GiftWrap_Item"	"ห่อของขวัญ {g:dota_item_name:gift_item_def}"
"DOTA_GiftWrap_ConfirmDedication_Title"	"ยืนยันการส่งของขวัญ"
"DOTA_GiftWrap_ConfirmDedication_Message"	"คุณแน่ใจหรือไม่ว่าต้องการอวยพรของขวัญด้วย '{s:gift_dedication}'?"
"DOTA_GiftWrap_Success_Header"	"สำเร็จ"
"DOTA_GiftWrap_Success"	"ของขวัญได้ถูกส่งไปแล้ว"
"DOTA_GiftWrap_Error_RateLimitedNormal"	"คุณสามารถส่งไอเท็มเป็นของขวัญได้ {d:gift_limit_count} ชิ้น ภายใน {d:gift_limit_hours} ชั่วโมง คุณได้ส่งของขวัญนี้มากเกินไปแล้ว โปรดรอสักครู่ก่อนที่จะส่งของขวัญนี้"
"DOTA_GiftWrap_Error_RateLimitedCharge"	"ที่เลเวล Battle Point ของคุณสามารถส่งของขวัญไอเท็มที่แลกเปลี่ยนไม่ได้ {d:gift_limit_count} ชิ้น ภายใน {d:gift_limit_hours} ชั่วโมง ของขวัญนี้ยังไม่สามารถถูกส่งได้ในขณะนี้"
"DOTA_GiftWrap_Error_RateLimitedChargeNone"	"ที่เลเวล Battle Point ของคุณไม่สามารถส่งของขวัญไอเท็มที่แลกเปลี่ยนไม่ได้ได้ ของขวัญนี้ยังไม่สามารถถูกส่งได้ในขณะนี้"
"DOTA_Custom_Game_Sort_Most_Played"	"ยอดนิยม (สัปดาห์นี้)"
"dota_settings_about"	"เกี่ยวกับ"
"DOTA_EquippedItem_AddToShuffle"	"เพิ่มในรายการสับเปลี่ยน"
"DOTA_EquippedItem_RemoveFromShuffle"	"ลบออกจากรายการสับเปลี่ยน"
"DOTA_EquippedItem_Unpack_And_AddToShuffle"	"แกะแล้วเพิ่มในรายการสับเปลี่ยน"
"DOTA_ClientVersion"	"เวอร์ชัน: <span class=\"VersionNumber\">{d:client_version_number}</span>"
"DOTA_GameplayVersion"	"เวอร์ชันเกมเพลย์: <span class=\"VersionNumber\">{s:gameplay_version_number}</span>"
"DOTA_Credits_LindaKMorris_Extra"	"& เสียงผู้ประกาศตั้งต้น"
"DOTA_Credits_SamAMowry_Extra"	"& Secret Shopkeeper"
"DOTA_Credits_FredTatasciore_Extra"	"& Golem ของ Warlock"
"DOTA_Recycling"	"รีไซเคิล"
"DOTA_Recycling_Action"	"รีไซเคิล"
"DOTA_Recycling_DragItems"	"ลากไอเท็มที่ไม่ต้องการมาที่นี่"
"DOTA_Recycling_Outputs"	"ได้รับ"
"DOTA_Recycling_Confirm"	"คุณแน่ใจหรือไม่ว่าต้องการรีไซเคิลไอเท็มเหล่านี้?"
"DOTA_RecyclingCharm_Name"	"Charm of the Crucible Jewel II"
"DOTA_RecyclingCharm_Bonus"	"+25 เหรียญ Compendium"
"custom_game_file_error"	"พบข้อผิดพลาดในการเข้าถึงไฟล์เกมแบบกำหนดเอง"
"DOTA_Previous"	"ก่อนหน้า"
"DOTA_PreviousShort"	"ก่อนหน้า"
"DOTA_Next"	"ถัดไป"
"DOTA_Friends_Add_Friend_Tooltip"	"เพิ่มเพื่อน"
"DOTA_Friends_Add_Friend_Entry_Placeholder"	"ป้อน ID เพิ่มเพื่อนที่จะค้นหา"
"DOTA_Friends_Add_Friend_Your_ID"	"ID เพิ่มเพื่อนของคุณคือ:"
"dota_settings_voice_always_sample_mic"	"กดเพื่อพูดแบบต่อเนื่อง"
"dota_settings_voice_always_sample_mic_tooltip"	"ทำให้อุปกรณ์บันทึกเสียงทำงานอยู่ตลอดเวลาเพื่อป้องกันตัวเกมค้างในฮาร์ดแวร์บางชนิด"
"DOTA_EconItemSet_Tooltip_MultipleTeams"	"มีรูปแบบที่แตกต่างกันสำหรับ Radiant และ Dire"
"DOTA_HeroLoadout_Shuffle_Count"	"ไอเท็มในรายการสับเปลี่ยน ({i:loadout_items_in_shuffle})"
"DOTA_HeroLoadout_Add_All_To_Shuffle"	"เพิ่มทั้งหมดในรายการสับเปลี่ยน"
"DOTA_HeroLoadout_Clear_Shuffle"	"ล้างรายการสับเปลี่ยน"
"DOTA_Armory_ActiveFilter"	"{s:filter_field} {s:filter_op} {s:filter_value}"
"DOTA_Treasure_Purchase"	"ซื้อสมบัติ"
"DOTA_Treasure_CharmPurchase"	"ซื้อเครื่องราง"
"DOTA_Treasure_SearchPlaceholder"	"ค้นหาสมบัติ"
"DOTA_Treasure_ViewAll"	"ดูสมบัติทั้งหมด"
"DOTA_Treasure_QuantityOption"	"จำนวน: {d:quantity}"
"DOTA_Treasure_Gift"	"ส่งเป็นของขวัญ"
"DOTA_Treasure_Open"	"เปิด"
"DOTA_Treasure_OpenQuantity"	"{d:owned_quantity}"
"DOTA_Treasure_Owned"	"มีอยู่"
"DOTA_Treasure_Received"	"ได้รับ"
"DOTA_Treasure_Autographed"	"ลายเซ็น:"
"DOTA_Treasure_AutographName"	"{s:treasure_autograph_name}"
"DOTA_OpenTreasureTooltip_NormalTitle"	"บรรจุไอเท็มดังต่อไปนี้:"
"DOTA_OpenTreasureTooltip_NoDupeDescription"	"คุณจะไม่ได้รับชิ้นเดิมซ้ำอีกจนกว่าคุณจะได้ทุกชิ้นครบ"
"DOTA_OpenTreasureTooltip_DupeDescription"	"คุณอาจได้รับชิ้นเดิมซ้ำอีกก่อนที่คุณจะได้ทุกชิ้นครบ"
"DOTA_OpenTreasureTooltip_RareTitle"	"พร้อมกับมีโอกาสที่จะได้รับไอเท็มพิเศษ"
"DOTA_OpenTreasureTooltip_UnitName"	"{g:dota_item_unit_name:item_def}"
"DOTA_OpenTreasureTooltip_ItemName"	" - {g:dota_item_name:item_def}"
"dota_profile_content_tab_official_info"	"ข้อมูลมืออาชีพ"
"dota_profile_oi_player_name"	"ชื่อที่แสดง"
"dota_profile_oi_player_name_sub"	"มันควรเป็นชื่อที่จดจำได้โดยไม่เกี่ยวข้องกับทีมและผู้สนับสนุนใด ๆ"
"dota_profile_oi_team"	"ทีม"
"dota_profile_oi_team_sub"	"ถ้าคุณเล่นให้กับทีม Dota ที่เป็นทีมทางการ โปรดเลือกทีม และแท็กของทีมนี้จะอยู่นำหน้าชื่อของคุณ"
"dota_profile_oi_sponsor"	"ผู้สนับสนุน"
"dota_profile_oi_sponsor_sub"	"ชื่อผู้สนับสนุนจะอยู่ต่อท้ายที่ชื่อของคุณ"
"dota_profile_oi_country"	"ประเทศ"
"dota_profile_oi_role"	"ตำแหน่ง"
"dota_profile_oi_role_sub"	"ถ้าคุณมีตำแหน่งที่เล่นโดยเฉพาะ โปรดเลือก ผู้เล่นหลักประกอบไปด้วยผู้เล่นที่เล่น Carry, Mid และ Off-lane"
"dota_profile_oi_preview"	"นี่คือตัวอย่างชื่อของคุณที่จะแสดงบนกระดานผู้นำและในเกมลีก:"
"dota_profile_oi_preview_warning"	"ข้อมูลนี้สามารถแก้ไขได้ครั้งเดียวในทุก ๆ สองสัปดาห์เท่านั้น ดังนั้นโปรดตรวจสอบให้แน่ใจว่ามันถูกต้องแล้ว ก่อนที่จะอัปเดต!"
"dota_profile_oi_submit_info"	"ส่ง"
"dota_profile_oi_submit_pending"	"กำลังส่ง..."
"dota_profile_oi_submit_success"	"สำเร็จ!"
"dota_profile_oi_submit_failure"	"ล้มเหลว - โปรดลองอีกครั้ง"
"dota_role_core"	"Core"
"dota_role_support"	"Support"
"Compendium_GenerateFail"	"ล้มเหลวในการสร้างไฟล์ทรัพยากร '{s:s1}'"
"Compendium_PreparePublish"	"กำลังเตรียมการเผยแพร่"
"Compendium_PublishError"	"ล้มเหลวในการคัดลอก '{s:s1}' ไปยังไดเรกทอรี Compendium ที่ '{s:s2}'"
"Compendium_PublishFinishedTitle"	"เผยแพร่สำเร็จ"
"DOTA_Treasure"	"สมบัติ"
"DOTA_Blog"	"มาใหม่ใน Dota 2"
"DOTA_SortBy"	"จัดเรียงตาม"
"DOTA_SortOption_Newest"	"ใหม่สุด"
"DOTA_SortOption_Owned"	"ที่ครอบครอง"
"DOTA_SortOption_Price"	"ราคา"
"DOTA_SortOption_Alphabetical"	"ตัวอักษร"
"Action_Use"	"ใช้"
"DOTA_BadgeLevel"	"{d:badge_level}"
"DOTA_AHC_CurrentHero"	"ฮีโร่ปัจจุบัน"
"DOTA_AHC_CurrentHeroName"	"{s:current_hero_name}"
"DOTA_AHC_InProgress"	"กำลังดำเนินการ"
"DOTA_AHC_CurrentHeroAttempts"	"เล่น {s:current_hero_attempts} ครั้ง"
"DOTA_AHC_CurrentHeroAverage"	"ค่าเฉลี่ยทั่วโลก"
"DOTA_AHC_CurrentHeroAverageAttempts"	"เล่น {s:current_hero_average_attempts} ครั้ง"
"DOTA_AHC_NextHero"	"ฮีโร่ถัดไป"
"DOTA_AHC_NextHeroName"	"{s:next_hero_name}"
"DOTA_AHC_ChallengeProgress"	"ความคืบหน้าการท้าทาย ({d:challenge_progress_percent}%)"
"DOTA_AHC_HeroesCompleted"	"ฮีโร่ที่เสร็จสมบูรณ์"
"DOTA_AHC_HeroesCompletedValue"	"{d:heroes_completed} / {d:heroes_total}"
"DOTA_AHC_TotalAttempts"	"จำนวนครั้งทั้งหมด"
"DOTA_AHC_TotalAttemptsValue"	"{d:challenge_total_attempts} เกม"
"DOTA_AHC_EquivalentWorldAverage"	"ค่าเฉลี่ยทั่วโลกเทียบเท่า"
"DOTA_AHC_EquivalentWorldAverageValue"	"{d:challenge_average_total_attempts} เกม"
"DOTA_AHC_LifetimeStats"	"สถิติการท้าทายตลอดชีวิต"
"DOTA_AHC_FullChallengesCompleted"	"สำเร็จการท้าทายครบถ้วน"
"DOTA_AHC_FullChallengesCompletedValue"	"{d:full_challenges_completed}"
"DOTA_AHC_BestFullChallenge"	"การท้าทายครบถ้วนดีที่สุด"
"DOTA_AHC_BestFullChallengeValueNone"	"ไม่มี"
"DOTA_AHC_BestFullChallengeValue"	"{d:best_full_challenge} เกม"
"DOTA_AHC_FullChallengeAverage"	"ค่าเฉลี่ยการท้าทายครบถ้วนทั่วโลก"
"DOTA_AHC_FullChallengeAverageValue"	"{s:full_challenge_average} เกม"
"DOTA_AHC_ChallengeReward"	"รางวัลการท้าทาย"
"DOTA_AHC_ChallengeTrophyName"	"{s:challenge_trophy_name}"
"DOTA_AHC_ChallengeTrophyLevel"	"ระดับ {d:challenge_trophy_level}"
"DOTA_Trophies_ViewEarned"	"สำเร็จแล้ว"
"DOTA_Party_Add_Friends"	"เพิ่มเพื่อนเพื่อสร้างปาร์ตี้"
"DOTA_ItemSet_Count_text"	"{d:item_current_group} / {d:item_group_count}"
"DOTA_Custom_Game_Map_AnyNumbered"	"อะไรก็ได้ ({d:map_choices})"
"dota_settings_enable_console"	"เปิดการใช้งานคอนโซล"
"dota_settings_enable_console_tooltip"	"หากคุณมีตัวเลือกการเริ่มเช่น -dev หรือ -console ซึ่งเปิดการใช้งานคอนโซล มันจะถูกเรียกใช้งานทับการตั้งค่านี้"
"dota_settings_binding_options"	"ตัวเลือกการกำหนดปุ่ม"
"dota_settings_allow_gui_key_to_bind"	"อนุญาตให้ปุ่ม Windows / Command ถูกกำหนดได้"
"DOTA_HeroLoadout_Loadout"	"ชุดปรับแต่ง"
"DOTA_HeroLoadout_About"	"เกี่ยวกับ"
"DOTA_HeroLoadout_Guides"	"คู่มือ"
"DOTA_HeroLoadout_Roles"	"หน้าที่"
"DOTA_HeroLoadout_Biography"	"ชีวประวัติ"
"DOTA_Feed_Say_Something"	"บอกบางอย่างบนฟีดของคุณ..."
"DOTA_Armory_ClearFilter"	"ล้างตัวกรอง"
"DOTA_Armory_ContextMenu_Tags"	"แท็ก..."
"DOTA_Armory_ContextMenu_EffigyPose"	"ท่าทาง..."
"DOTA_Armory_ContextMenu_EffigyReforge"	"หลอมสร้างใหม่..."
"DOTA_EffigyEditor_CreateEffigy"	"สร้างรูปสลัก"
"DOTA_EffigyEditor_PoseEffigy"	"ท่าทางรูปสลัก"
"DOTA_EffigyEditor_ReforgeEffigy"	"หลอมสร้างรูปสลักใหม่"
"DOTA_EffigyEditor_Model"	"ฮีโร่"
"DOTA_EffigyEditor_Loadout"	"ไปยังหน้าชุดปรับแต่ง"
"DOTA_EffigyEditor_Inscription"	"คำจารึก:"
"DOTA_EffigyEditor_Animation"	"แอนิเมชัน:"
"DOTA_EffigyEditor_Frame"	"เลือกเฟรม:"
"DOTA_EffigyEditor"	"เครื่องมือแก้ไขรูปสลัก"
"DOTA_EffigyEditor_ConfirmCreate"	"การสร้างรูปสลักฮีโร่จะใช้ก้อนสำหรับแกะสลัก หลังจากการสร้าง มันจะสามารถปรับเปลี่ยนได้โดยการใช้ตัวหลอมสร้างรูปสลักใหม่เท่านั้น คุณแน่ใจหรือไม่ว่าต้องการดำเนินการต่อ?"
"DOTA_EffigyEditor_ConfirmReforge"	"การหลอมสร้างรูปสลักฮีโร่ใหม่จะใช้ตัวหลอมสร้างรูปสลักใหม่ คุณแน่ใจหรือไม่ว่าต้องการดำเนินการต่อ?"
"DOTA_EffigyEditor_Error"	"ล้มเหลวในการสร้างรูปสลักฮีโร่"
"DOTA_EffigyEditor_ErrorReforge"	"ล้มเหลวในการหลอมสร้างรูปสลักฮีโร่"
"DOTA_EffigyEditor_ErrorPose"	"ล้มเหลวในการโพสท่ารูปสลักฮีโร่แห่งเกียรติยศ"
"DOTA_EffigyEditor_Success"	"รูปสลักฮีโร่ของคุณได้ถูกสร้างอย่างเสร็จสมบูรณ์แล้ว"
"DOTA_EffigyEditor_SuccessReforge"	"รูปสลักฮีโร่ของคุณได้ถูกหลอมสร้างใหม่อย่างเสร็จสมบูรณ์แล้ว"
"DOTA_EffigyEditor_SuccessPose"	"รูปสลักฮีโร่ของคุณได้โพสท่าอย่างเสร็จสมบูรณ์แล้ว"
"dota_profile_content_tab_all_hero_challenge"	"การท้าทายฮีโร่ทุกตัว"
"DOTA_tooltip_econ_item_delete_restriction"	"ลบไม่ได้"
"DOTA_tooltip_econ_item_modifiers"	"ตัวเปลี่ยนแปลง"
"DOTA_tooltip_econ_item_modifier_animation"	"แอนิเมชัน"
"DOTA_tooltip_econ_item_modifier_announcer"	"เสียงผู้ประกาศ"
"DOTA_tooltip_econ_item_modifier_HUD"	"HUD"
"DOTA_tooltip_econ_item_modifier_health_bar"	"แถบพลังชีวิต"
"DOTA_tooltip_econ_item_modifier_ability_name"	"ชื่อสกิล"
"DOTA_tooltip_econ_item_modifier_loading_screen"	"หน้าจอโหลด"
"DOTA_tooltip_econ_item_modifier_cursor_pack"	"แพ็คเคอร์เซอร์"
"DOTA_tooltip_econ_item_modifier_portrait"	"ภาพฮีโร่"
"DOTA_tooltip_econ_item_modifier_ambient_effects"	"เอฟเฟกต์รอบตัว"
"DOTA_tooltip_econ_item_modifier_kill_effects"	"เอฟเฟกต์การสังหาร"
"DOTA_tooltip_econ_item_modifier_spell_effects"	"เอฟเฟกต์สกิล"
"DOTA_tooltip_econ_item_modifier_model"	"โมเดล"
"DOTA_tooltip_econ_item_modifier_scale"	"ขนาด"
"DOTA_tooltip_econ_item_modifier_wearable"	"สวมใส่ได้"
"DOTA_tooltip_econ_item_modifier_courier"	"Courier"
"DOTA_tooltip_econ_item_modifier_pet"	"สัตว์เลี้ยง"
"DOTA_tooltip_econ_item_modifier_weather"	"สภาพอากาศ"
"DOTA_tooltip_econ_item_modifier_sound"	"เสียง"
"DOTA_tooltip_econ_item_modifier_soundscape"	"เสียงสภาพแวดล้อม"
"DOTA_tooltip_econ_item_modifier_voice"	"เสียงพากย์"
"DOTA_tooltip_econ_item_modifier_icon"	"ไอคอน"
"DOTA_econ_item_details_style_label"	"รูปแบบ:"
"DOTA_econ_item_details_gift_label"	"ของขวัญจาก:"
"Compendium_Downloading"	"กำลังดาวน์โหลด Compendium..."
"Compendium_DLFailed"	"การดาวน์โหลดล้มเหลว"
"Compendium_DLFailed_Desc"	"ไม่สามารถดาวน์โหลด Compendium\n\nโปรดลองใหม่อีกครั้งในภายหลัง"
"Compendium_Error"	"ข้อผิดพลาด Compendium"
"Compendium_Error_Desc"	"มีปัญหาเกิดขึ้นกับ Compendium เรากำลังแก้ไขอยู่ในขณะนี้\n\nโปรดลองใหม่อีกครั้งในภายหลัง"
"Compendium_Retry"	"ลองใหม่"
"Compendium_preview_mode"	"โหมดดูตัวอย่างเท่านั้น"
"Compendium_level"	"ระดับ"
"Compendium_to_next_level"	"สู่ระดับถัดไป"
"Compendium_LevelupPts_Singular"	"1 แต้ม"
"Compendium_LevelupPts_Plural"	"{d:next_comp_level} แต้ม"
"DOTA_GlobalItems_MegaKill"	"แพ็ค Mega-Kill"
"DOTA_Treasure_BonusReward"	"รางวัลพิเศษ"
"DOTA_OpenTreasureTooltip_ExtraItems"	"... และอีก {d:extra_items_count} รายการ!"
"DOTA_AASystem_Green"	"รวมเวลาสะสมออนไลน์ในเกม: {s:playtime} ขณะนี้คุณกำลังเล่นในช่วงที่ยังปลอดภัยต่อสุขภาพ ขอให้เล่นเกมให้สนุก!"
"DOTA_AASystem_Yellow"	"รวมเวลาสะสมออนไลน์ในเกม: {s:playtime} ขณะนี้คุณได้เล่นเลยช่วงเวลาที่ปลอดภัยต่อสุขภาพแล้ว กรุณาไปพักผ่อนได้แล้ว!"
"DOTA_AASystem_Red"	"รวมเวลาสะสมออนไลน์ในเกม: {s:playtime} ขณะนี้คุณได้เล่นเลยช่วงเวลาที่ปลอดภัยต่อสุขภาพแล้ว ขอแนะนำให้คุณออกจากเกมแล้วไปพักผ่อนซะเถอะ!"
"DOTA_AntiAddiction_Initial_With_ID_18Plus"	"ออนไลน์ครั้งล่าสุด: %s1\nไอพีแอดเดรสล่าสุด: %s2"
"DOTA_AntiAddiction_Initial_With_ID_Under_18"	"คุณมีอายุต่ำกว่า 18 ปี ระบบป้องกันการเสพติดกำลังทำงาน\nออนไลน์ครั้งล่าสุด: %s1\nไอพีแอดเดรสล่าสุด: %s2"
"DOTA_AntiAddiction_Initial_No_ID"	"บัญชีของคุณยังไม่ได้ลงทะเบียน\nออนไลน์ครั้งล่าสุด: %s1\nไอพีแอดเดรสล่าสุด: %s2"
"DOTA_AntiAddiction_Blocked_Time_Exceeded"	"เกินเวลาที่อนุญาตของระบบป้องกันการเสพติด เกมกำลังปิดตัวลง"
"DOTA_AntiAddiction_Initial_No_ID_Popup"	"บัญชีของคุณไม่ได้ลงทะเบียนอย่างสมบูรณ์ คุณต้องการที่จะกรอกข้อมูลของคุณในขณะนี้หรือไม่?"
"DOTA_AntiAddiction_CompleteInfoNow"	"กรอกข้อมูล"
"DOTA_AntiAddiction_CompleteInfoNotNow"	"ไม่ใช่ตอนนี้"
"DOTA_AntiAddiction_Label_Green"	"เวลาเล่นเกม: {s:playtime} ( พอดีต่อสุขภาพ )"
"DOTA_AntiAddiction_Label_Yellow"	"เวลาเล่นเกม: {s:playtime} ( เสียสุขภาพ )"
"DOTA_AntiAddiction_Label_Red"	"เวลาเล่นเกม: {s:playtime} ( นานเกินไป )"
"DOTA_Workshop_Browse"	"เปิดหา"
"DOTA_Workshop_TextureName_color"	"สี"
"DOTA_Workshop_Model"	"โมเดล"
"DOTA_Workshop_Animations"	"แอนิเมชัน"
"DOTA_Workshop_Optional"	"ตัวเลือก"
"DOTA_Workshop_NotRequired_Geometry"	"(จำนวนสามเหลี่ยมสูงสุด: %s1)"
"DOTA_Workshop_NotRequired_Texture"	"(พื้นผิวจะถูกปรับขนาดเป็น: %s1)"
"DOTA_Workshop_LOD1Title"	"รูปทรงในเกม"
"DOTA_Workshop_LOD1Title_Ward"	"รูปทรงในเกม"
"DOTA_Workshop_Animation_Die"	"ตาย"
"DOTA_Workshop_Animation_Die2"	"การตายอีกแบบ"
"DOTA_Workshop_Animation_Attack"	"โจมตี"
"DOTA_Workshop_Animation_AttackB"	"การโจมตีอีกแบบ"
"DOTA_Filter_Field_Category"	"แท็ก"
"DOTA_Armory_Tags_Popup_Title"	"กำหนดแท็ก"
"DOTA_Event_Level"	"ระดับ"
"DOTA_Skip"	"ข้าม"
"DOTA_Done"	"เสร็จสิ้น"
"DOTA_TabName_Featured"	"โดดเด่น"
"DOTA_TabName_Heroes"	"ฮีโร่"
"DOTA_Friends_ID"	"ไอดีเพื่อน:"
"DOTA_Profile_Edit"	"แก้ไขโปรไฟล์"
"DOTA_Profile_LifetimeStats"	"สถิติตลอดกาล"
"DOTA_Profile_ViewSteamProfile"	"ดูโปรไฟล์ Steam"
"DOTA_Profile_SendMessage"	"ส่งข้อความ"
"DOTA_Trophies_ViewAvailable"	"สามารถรับได้"
"DOTA_TrophyXPProgress"	"{d:trophy_xp} / {d:total_trophy_xp}<span class=\"TrophyPointTextSmall\">TP</span>"
"DOTA_TrophyDetails_XP"	"{d:trophy_details_xp}<span class=\"TrophyPointTitleSmall\">TP</span>"
"DOTA_Trophy_Upgraded"	"ถ้วยรางวัลอัปเกรดแล้ว"
"DOTA_Trophy_Achieved"	"ได้รับถ้วยรางวัลแล้ว"
"DOTA_TrophyPlusProfileXP"	"+{d:trophy_xp} แต้มถ้วยรางวัล"
"DOTA_ProfileBadge_Upgraded"	"เหรียญตราโปรไฟล์อัปเกรดแล้ว"
"DOTA_Lobby_Settings_Tournament_None"	"ไม่มี"
"DOTA_Lobby_Settings_Tournament"	"ลีก"
"DOTA_WatchReplaysConextMenu_Watch"	"เข้าชม"
"DOTA_WatchReplaysConextMenu_DownloadWatch"	"ดาวน์โหลดและเข้าชมเดี๋ยวนี้"
"DOTA_WatchReplaysConextMenu_DownloadWatchLater"	"ดาวน์โหลดและเข้าชมภายหลัง"
"DOTA_WatchReplaysConextMenu_WatchLater"	"เข้าชมภายหลัง"
"DOTA_WatchReplaysConextMenu_WatchLaterClear"	"ล้างจากรายการเข้าชมภายหลัง"
"DOTA_WatchReplays_Game1"	"เกมที่ 1"
"DOTA_WatchReplays_Game2"	"เกมที่ 2"
"DOTA_WatchReplays_Game3"	"เกมที่ 3"
"DOTA_WatchReplays_Game4"	"เกมที่ 4"
"DOTA_WatchReplays_Game5"	"เกมที่ 5"
"DOTA_WatchReplayError"	"ข้อผิดพลาดในการเข้าชมรีเพลย์"
"DOTA_WatchReplayError_Incompatible"	"รีเพลย์นี้ไม่รองรับการทำงานกับ Dota เวอร์ชันนี้"
"DOTA_WatchReplayError_DoesNotExist"	"แมตช์นี้ไม่มีอยู่"
"DOTA_ShuffledItem_Label"	"ในรายการสับเปลี่ยน"
"DOTA_Armory_ContextMenu_AddShuffle"	"เพิ่มไปยังรายการสับเปลี่ยน"
"DOTA_Armory_ContextMenu_RemoveShuffle"	"ลบออกจากรายการสับเปลี่ยน"
"DOTA_Armory_Filter_HasSockets"	"มีช่องซ็อกเก็ต"
"DOTA_Popup_Item_Received_Header_Unknown"	"คุณได้รับไอเท็ม!"
"DOTA_Popup_Item_Received_Header_Dropped"	"คุณได้รับไอเท็ม!"
"DOTA_Popup_Item_Received_Header_Crafted"	"คุณได้ประดิษฐ์ไอเท็ม!"
"DOTA_Popup_Item_Received_Header_Traded"	"คุณได้แลกเปลี่ยนไอเท็ม!"
"DOTA_Popup_Item_Received_Header_Purchased"	"คุณได้ซื้อไอเท็ม!"
"DOTA_Popup_Item_Received_Header_FoundInCrate"	"คุณได้รับไอเท็ม!"
"DOTA_Popup_Item_Received_Header_Gifted"	"คุณได้รับของขวัญ!"
"DOTA_Popup_Item_Received_Header_Support"	"ฝ่ายสนับสนุนลูกค้าได้มอบไอเท็มให้กับคุณ!"
"DOTA_Popup_Item_Received_Header_Promotion"	"คุณได้รับไอเท็มโปรโมชันของร้านค้า!"
"DOTA_Popup_Item_Received_Header_Earned"	"คุณได้รับไอเท็ม!"
"DOTA_Popup_Item_Received_Header_Refunded"	"คุณได้ขอคืนเงินไอเท็มแล้ว!"
"DOTA_Popup_Item_Received_Header_GiftWrapped"	"คุณได้แกะไอเท็มจากกล่องของขวัญ!"
"DOTA_Popup_Item_Received_Header_Foreign"	"คุณได้รับไอเท็มในเกมอื่น!"
"DOTA_Popup_Item_Received_Header_CollectionReward"	"คุณได้แลกของรางวัลสะสม!"
"DOTA_Popup_Item_Received_Header_PreviewItem"	"คุณกำลังทดสอบไอเท็มใหม่!"
"DOTA_Popup_Item_Received_Header_PreviewItemPurchased"	"คุณได้ซื้อไอเท็ม!"
"DOTA_Popup_Item_Received_Header_PeriodicScoreReward"	"คุณได้รับไอเท็ม!"
"DOTA_Popup_Item_Received_Header_Recycling"	"คุณได้ประดิษฐ์ไอเท็ม!"
"DOTA_Popup_Item_Received_Header_TournamentDrop"	"คุณได้รับไอเท็มจากการชมทัวร์นาเมนต์!"
"DOTA_Popup_Item_Received_Header_RecipeOutput"	"คุณได้ประดิษฐ์ไอเท็ม!"
"DOTA_Popup_Item_Received_Header_CommunityMarketPurchase"	"คุณได้ซื้อไอเท็ม!"
"DOTA_Popup_Item_Received_Header_GemExtract"	"คุณได้แยกไอเท็ม!"
"DOTA_Popup_Item_Received_Header_CompendiumReward"	"คุณได้รับไอเท็มของรางวัล Compendium!"
"DOTA_Popup_Item_Received_Header_CompendiumDrop"	"คุณได้รับไอเท็มจากการดรอปของ Compendium!"
"DOTA_Popup_Item_Received_Label_IOfN"	"{d:item_i} ของ {d:item_n}"
"DOTA_Popup_Item_Received_Button_Accept"	"ยอมรับ"
"DOTA_Popup_Item_Received_Button_AcceptAll"	"ยอมรับทั้งหมด ({d:item_n})"
"DOTA_TrophyDetails_PointsPerInterval"	"ได้รับ {d:trophy_points_per_level} แต้มถ้วยรางวัลทุก {d:trophy_points_interval_size} ระดับ"
"dota_casters"	"ผู้พากย์"
"LobbySetting_League"	"ลีก"
"LobbySetting_League_Value"	"{s:lobbysetting_league}"
"DOTA_WatchLive_Purchase"	"ซื้อตั๋ว {g:dota_item_price:ticket_itemdef}"
"DOTA_WatchLive_Activate"	"เปิดใช้ตั๋ว"
"DOTA_WatchLive_LoadMore"	"โหลดเพิ่มเติม"
"DOTA_WatchReplays_Pending"	"กำลังดำเนินการ..."
"DOTA_WatchReplays_Downloading"	"กำลังดาวน์โหลด...{i:download_pct}%"
"DOTA_WatchReplays_Decompressing"	"กำลังคลายข้อมูล...{i:decompress_pct}%"
"LoadingScreenCastersInfo"	"ผู้พากย์: {i:casters_loaded}/{i:casters_total}"
"DOTA_Armory_ContextMenu_EquipSet"	"สวมใส่ชุดเซ็ต"
"DOTA_Armory_Tag1_Default"	"แท็ก 1"
"DOTA_Armory_Tag2_Default"	"แท็ก 2"
"DOTA_Armory_Tag3_Default"	"แท็ก 3"
"DOTA_Armory_Tag4_Default"	"แท็ก 4"
"DOTA_Armory_Tag5_Default"	"แท็ก 5"
"DOTA_Armory_Tag6_Default"	"แท็ก 6"
"DOTA_Armory_Tag7_Default"	"แท็ก 7"
"DOTA_Armory_Tag8_Default"	"แท็ก 8"
"dota_page_match_details_replay_existence_decompressing"	"กำลังคลายข้อมูล..."
"DOTA_Workshop_TextureName_trans"	"ความโปร่งใส"
"DOTA_Workshop_TextureName_normal"	"ปานกลาง"
"DOTA_Workshop_TextureDetails_normal"	"นอร์มอลแมพ"
"DOTA_Workshop_Ward_Model"	"โมเดล Ward"
"DOTA_Workshop_CreateNewItem"	"สร้างไอเท็มใหม่"
"DOTA_PreviewSounds_ExampleSounds"	"เสียงตัวอย่าง"
"DOTA_econ_item_details_sockets_header"	"ซ็อกเก็ต"
"DOTA_econ_item_details_tooltip_lock_reason_title"	"ข้อกำหนดการปลดล็อค:"
"DOTA_econ_item_details_tooltip_lock_reason"	"{s:style_lock_reason}"
"DOTA_econ_item_details_description_header"	"คำอธิบาย"
"DOTA_econ_item_details_description_reset"	"รีเซ็ต"
"Dota_Test_Build"	"ตัวทดสอบ"
"LoadingScreenMatchID"	"ไอดีแมตช์: {s:match_id}"
"DOTA_econ_item_details_rare_sockets_header"	"ซ็อกเก็ตหายาก"
}
