"dota"
{
"DOTA_Accept"	"Acceptă"
"DOTA_Cancel"	"Anulează"
"DOTA_Console"	"Consolă"
"DOTA_Create"	"Creează"
"DOTA_Decline"	"Refuză"
"DOTA_Error"	"Eroare"
"DOTA_New"	"Nou"
"DOTA_Ok"	"OK"
"DOTA_Sale"	"Ofertă"
"DOTA_Close"	"Închide"
"DOTA_Continue"	"Continuă"
"DOTA_Add"	"Adaugă"
"DOTA_Edit"	"Modifică"
"DOTA_Enable"	"Activează"
"DOTA_Disable"	"Dezactivează"
"DOTA_Refresh"	"Reîmprospătează"
"DOTA_Loading"	"Se încarcă"
"DOTA_Customize"	"Personalizează"
"dota_team_radiant"	"Radiant"
"dota_team_dire"	"Dire"
"Unknown"	"Necunoscut"
"UI_Yes"	"Da"
"UI_No"	"Nu"
"UI_File_Filter_Any"	"Toate fişierele (*.*)"
"DOTA_MainMenu_Heroes"	"Eroi"
"DOTA_MainMenu_Watch"	"Urmărește"
"DOTA_MainMenu_Learn"	"Învaţă"
"DOTA_MainMenu_Mods"	"Jocuri Personalizate"
"DOTA_TabName_Armory"	"Arsenal"
"DOTA_InvalidPersonaName"	"[necunoscut]"
"DOTA_Friends_WindowTitle"	"PRIETENI"
"DOTA_FriendsCategory_PlayingDota"	"În Dota <font color='#ACEBA9'>({d:friend_count})</font>"
"DOTA_FriendsMenu_Tooltip_NoneReady"	"Prieteni"
"DOTA_ProfileCard_StatTitle_SoloRank"	"MMR Individual"
"DOTA_ProfileCard_StatTitle_PartyRank"	"MMR Echipă"
"DOTA_ProfileCard_StatTitle_Commends"	"Recomandări"
"DOTA_ProfileCard_StatTitle_GamesPlayed"	"Meciuri"
"DOTA_ProfileCard_StatTitle_FirstMatchDate"	"Primul Meci"
"DOTA_ProfileCard_SlotTab_Trophies"	"Trofee"
"DOTA_ProfileCard_SlotTab_Items"	"Arsenal"
"DOTA_ProfileCard_SlotTab_Heroes"	"Eroi"
"DOTA_ProfileCard_SlotTab_Emoticons"	"Emoticon-uri"
"DOTA_ProfileCard_ItemSearchPlaceholder"	"Obiecte după nume"
"DOTA_Wins_Singular"	"1 victorie"
"DOTA_Losses_Singular"	"1 înfrângere"
"DOTA_Profile_VictoryCount"	"Victorii"
"DOTA_Profile_ProfilePage"	"Profil"
"DOTA_Profile_RecentGamesPage"	"Jocuri Recente"
"DOTA_Profile_HeroPage"	"Eroi"
"DOTA_Profile_Versatility"	"Versatilitate"
"DOTA_Profile_Versatility_TooltipTitle"	"Versatilitate"
"DOTA_Profile_Self"	"Eu"
"DOTA_Profile_CourierKills"	"Curieri ucişi"
"DOTA_RecentGames_Title"	"Jocuri Recente"
"DOTA_RecentGames_GameLength"	"Durată"
"DOTA_RecentGames_Team"	"Echipă"
"DOTA_RecentGames_GameType"	"Tip"
"DOTA_RecentGames_Items"	"Obiecte"
"DOTA_TrophyCount_NoNum"	"Trofeu"
"DOTA_TrophiesCount_NoNum"	"Trofee"
"DOTA_Trophies_ViewAll"	"Afişează-le pe toate"
"DOTA_NewPlayerQuestion_Title"	"BUN VENIT ÎN DOTA 2"
"DOTA_OtherGames_DOTA"	"DotA 1"
"DOTA_OtherGames_HON"	"Heroes of Newerth"
"DOTA_OtherGames_Smite"	"Smite"
"DOTA_OtherGames_Other"	"Alt joc"
"DOTA_PlayerOriginQuestion_ConfirmationButton"	"SĂ JUCĂM"
"DOTA_PlayerOriginQuestion_ConfirmationTutorial"	"Ca jucător începător de Dota, s-ar putea să fii interesat de tutorialele din secțiunea Antrenament din meniul Joacă. Sunt un foarte bun prim pas în direcția dominării jucătorilor de pe tot globul."
"DOTA_Tutorial_QuestDetailsLearn"	"Vei învăţa:"
"DOTA_Challenges_Title"	"Învaţă"
"DOTA_ChallengeGroup_0_Title"	"Mecanici"
"DOTA_GuidedBotMatches_0_Title"	"Luna"
"DOTA_GuidedBotMatches_1_Title"	"Sven"
"DOTA_GuidedBotMatches_2_Title"	"Lina"
"DOTA_LearnBotMatches_Title"	"Meciuri cu boţi"
"FileOpenDialog_Open"	"Deschide"
"FileOpenDialog_Save"	"Salvează"
"FileOpenDialog_Select"	"Alege"
"DOTA_FindMatch"	"Găseşte meci"
"DOTA_FindMatchTime"	"{s:find_match_time}"
"DOTA_LobbyStartGame"	"Pornește Joc"
"DOTA_FindGameModesMany"	"Moduri de joc: "
"DOTA_ImmediatePurchase_Success_Title"	"Succes"
"DOTA_ImmediatePurchase_Cancelled_Title"	"Anulat"
"StoreCheckout_Error_Title"	"Eroare"
"StoreCheckout_TooManyItems"	"Ai prea multe obiecte în coşul tău de cumpărături!"
"StoreCheckout_Loading"	"Finalizare..."
"StoreCheckout_TransactionCancelled"	"Tranzacţie anulată. Nu ai fost taxat."
"StoreCheckout_ContactSupport_Dialog_Title"	"Avertisment"
"StoreCheckout_ContactSupport_Dialog_Btn"	"Contact"
"StoreCheckout_LimitedQuantityItemsUnavailable"	"Un obiect pe care intenționezi să-l cumperi nu mai este în stoc sau este indisponibil momentan."
"StoreCheckout_Nexon_InsufficientFunds"	"Nu ai suficiente fonduri pentru a finaliza achiziția."
"DOTA_ChatMessage_Default"	"<span class=\"{s:target_class}\"><span class=\"ChatTarget\">(<a href=\"{s:target_link}\">{s:target}</a>)</span> <span class=\"ChatPersona\">[{s:persona}]</span>: {s:message}</span>"
"DOTA_ChatMessage_WhisperTo"	"<span class=\"{s:target_class}\">Către <span class=\"ChatPersona\">[{s:persona}]</span>: {s:message}</span>"
"DOTA_ChatMessage_WhisperFrom"	"<span class=\"{s:target_class}\">De la <span class=\"ChatPersona\">[{s:persona}]</span>: {s:message}</span>"
"DOTA_ChatMessage_System"	"<span class=\"{s:target_class}\"><span class=\"ChatTarget\">({s:target})</span>: {s:message}</span>"
"DOTA_ChatCommand_Party"	"p"
"DOTA_ChatCommand_Party_Name"	"Grup"
"DOTA_LobbyKicked_Message"	"Ai fost dat afară din lobby-ul jocului de către liderul lobby-ului."
"DOTA_ConfirmLANLobby_title"	"LOBBY LOCAL"
"DOTA_Lobby_Settings_Game_Mode"	"MODUL DE JOC"
"DOTA_Lobby_Settings_Game_Name"	"NUMELE JOCULUI"
"LobbySetting_GameMode_Value"	"{s:lobbysetting_gamemode}"
"LobbySetting_Bots_Value"	"{s:lobbysetting_bots}"
"LobbySetting_Password_Value"	"{s:lobbysetting_password}"
"LobbySetting_Server_Value"	"{s:lobbysetting_server}"
"LobbySetting_Cheats_Value"	"{s:lobbysetting_cheats}"
"LobbySetting_Spectators_Value"	"{s:lobbysetting_spectators}"
"LobbySetting_Visibility"	"Vizibilitate"
"LobbySetting_Visibility_Value"	"{s:lobbysetting_visibility}"
"dota_lobby_coaches_none"	"Antrenori: Niciunul"
"dota_lobby_coaches"	"Antrenori:"
"DOTA_Custom_Game"	"Joc personalizat"
"DOTA_Custom_Game_View_Details"	"Vezi detaliile jocului"
"DOTA_Custom_Game_Find_Lobby"	"Găsește lobby"
"DOTA_Custom_Game_Create_Lobby"	"Creează lobby"
"DOTA_Custom_Game_Game_Page"	"Pagina jocului"
"DOTA_Custom_Game_Downloading"	"Descărcare..."
"DOTA_Custom_Game_Play"	"Joacă {s:game_mode_name}"
"DOTA_Custom_Game_FileSize"	"{d:file_size} MB"
"DOTA_Custom_Game_Name"	"{s:game_mode_name}"
"DOTA_Custom_Game_Subscription"	"{s:subscriptions_count} Abonament"
"DOTA_Custom_Game_Subscriptions"	"{s:subscriptions_count} Abonamente"
"DOTA_Custom_Game_Ratings_Count"	"({d:ratings_count})"
"DOTA_Custom_Game_Description"	"{s:game_description}"
"DOTA_Custom_Game_Update_Note_Title"	"{s:timestamp}"
"DOTA_Custom_Game_Map_Any"	"Oricare"
"DOTA_Custom_Game_Update"	"Actualizare"
"DOTA_Custom_Game_Spectate"	"Vizionează"
"DOTA_Custom_Game_Invite_Friend"	"Invită un prieten"
"DOTA_Custom_Game_Suggested_Title"	"Jocuri sugerate"
"DOTA_Custom_Lobby_Join_Failed_Reason"	"{s:join_error}"
"DOTA_Custom_Lobby_Create_Private_Button"	"Creează lobby privat"
"DOTA_Custom_Lobby_Find_Private_Button"	"Caută lobby privat"
"DOTA_Custom_Lobby_Find_Private_Title"	"Caută lobby privat"
"DOTA_Custom_Lobby_List_Game_Header"	"Joc"
"DOTA_Custom_Lobby_List_Players_Header"	"Jucători"
"DOTA_Custom_Lobby_List_Game"	"{s:lobby_game}"
"DOTA_Custom_Lobby_List_Lobby_Name"	"{s:lobby_name}"
"DOTA_Custom_Lobby_List_Players"	"{s:lobby_players} / {s:lobby_max_players}"
"DOTA_Custom_Lobby_List_Map"	"{s:lobby_map}"
"DOTA_Watch_LobbyNotFound"	"Lobby-ul nu a fost găsit."
"dota_abandon_dialog_confirm"	"Eşti sigur că vrei să abandonezi acest joc?"
"dota_abandon_dialog_yes"	"Da, abandonează jocul."
"dota_leave_dialog_title"	"PĂRĂSEȘTE JOCUL"
"dota_leave_dialog_confirm"	"Ești sigur că vrei să părăsești acest joc?"
"dota_match_connecting"	"Se conectează la joc..."
"dota_match_in_progress"	"Joc în desfăşurare"
"dota_leaver_consequence_CreditWithAbandon"	"Vei primi o abandonare."
"dota_leaver_consequence_ForcedLossForLeaver"	"Vei primi o înfrângere."
"DOTA_VAC_Verification_Button1"	"Mai multe informaţii"
"DOTA_VAC_Verification_Button2"	"Închide"
"dota_region_automatic"	"Regiune: Automat"
"dota_chatwheel_label_Ok"	"Ok"
"dota_chatwheel_label_Care"	"Grijă"
"dota_chatwheel_label_GetBack"	"Întoarce-te"
"dota_chatwheel_label_Help"	"Ajutor"
"dota_chatwheel_label_GoodJob"	"Bine Jucat"
"dota_chatwheel_label_Mana"	"Mana"
"dota_chatwheel_label_OOM"	"Nu mai am mana"
"dota_chatwheel_label_Roshan"	"Roshan"
"dota_chatwheel_label_Affirmative"	"Afirmativ"
"dota_chatwheel_label_Wait"	"Aşteaptă"
"dota_chatwheel_label_Pause"	"Pauză"
"dota_chatwheel_label_GLHF"	"Noroc"
"dota_chatwheel_label_Nice"	"Frumos"
"dota_chatwheel_label_Thanks"	"Merci"
"dota_chatwheel_label_Sorry"	"Scuze"
"dota_chatwheel_label_No_Give_Up"	"Nu renunţaţi"
"dota_chatwheel_label_Relax"	"Relaxează-te"
"dota_chatwheel_label_GG"	"GG"
"dota_chatwheel_label_GGWP"	"GGWP"
"dota_chatwheel_label_All_GG"	"(Toți) GG"
"dota_chatwheel_label_All_GGWP"	"(Toți) GGWP"
"dota_chatwheel_label_What_To_Buy"	"Ce să cumpăr?"
"dota_chatwheel_label_Im_Retreating"	"Mă retrag"
"dota_chatwheel_header_status"	"Stare"
"dota_chatwheel_header_enemy"	"Inamic"
"dota_chatwheel_header_items"	"Obiecte"
"dota_chatwheel_header_neutrals"	"Neutral-i"
"dota_chatwheel_message_Ok"	"Bine."
"dota_chatwheel_message_NeedWards"	"Avem nevoie de ward-uri."
"dota_chatwheel_message_Help"	"Ajutor!"
"dota_chatwheel_message_Push"	"Avansați acum"
"dota_chatwheel_message_Follow"	"Veniți după mine"
"dota_chatwheel_message_Mana"	"Mana"
"dota_chatwheel_message_OOM"	"Nu mai am mana"
"dota_chatwheel_message_Wait"	"Aşteaptă"
"dota_chatwheel_message_Nice"	"Frumos"
"dota_chatwheel_message_Sorry"	"Scuze"
"dota_chatwheel_message_No_Give_Up"	"Nu renunțați!"
"dota_chatwheel_message_New_Meta"	"Noul meta"
"dota_chatwheel_message_My_Bad"	"Greșeala mea"
"dota_chatwheel_message_GG"	"Bun joc"
"dota_chatwheel_message_GGWP"	"Bun joc, bine jucat"
"dota_chatwheel_message_All_GG"	"Bun joc"
"dota_chatwheel_message_All_GGWP"	"Bun joc, bine jucat"
"dota_chatwheel_message_What_To_Buy"	"Ce ar trebui să cumpăr?"
"dota_chatwheel_message_Im_Retreating"	"Mă retrag"
"dota_chatwheel_message_Whoops"	"Uups"
"dota_settings_audio"	"AUDIO"
"dota_settings_video"	"VIDEO"
"dota_settings_items"	"Obiecte"
"dota_settings_camera"	"Cameră"
"dota_settings_cameraactions"	"Acțiuni Cameră"
"dota_settings_cameraup"	"Camera în față"
"dota_settings_cameradown"	"Camera în spate"
"dota_settings_cameraleft"	"Camera spre stânga"
"dota_settings_cameraright"	"Camera spre dreapta"
"dota_settings_cameragrip"	"Controlul Camerei"
"dota_settings_chat"	"Chat"
"dota_settings_chatwheel_page"	"Roata cu replici"
"dota_settings_chatteam"	"Discuție Echipă"
"dota_settings_chatvoice_party"	"Voce (grup)"
"dota_settings_chatvoice_team"	"Voce (echipă)"
"dota_settings_chatwheel_show"	"Roatăcureplici"
"dota_settings_pause"	"Pauză"
"dota_settings_group1"	"Grup 1"
"dota_settings_group2"	"Grup 2"
"dota_settings_group3"	"Grup 3"
"dota_settings_group4"	"Grup 4"
"dota_settings_group5"	"Grup 5"
"dota_settings_group6"	"Grup 6"
"dota_settings_group7"	"Grup 7"
"dota_settings_group9"	"Grup 9"
"dota_settings_group10"	"Grup 10"
"dota_settings_advancedpanel_goto"	"Avansat"
"dota_settings_or"	"Sau"
"dota_settings_apply"	"Aplică"
"dota_settings_game"	"Joc"
"dota_settings_cameradecel"	"Decelerare Cameră"
"dota_settings_cameraspeed"	"Viteză Cameră"
"dota_settings_camerareversegrip"	"Controlul Camerei Inversat"
"dota_settings_cameraedgepan"	"Mișcare la Margine"
"dota_settings_camerascreenshake"	"Activează scuturăturile de ecran"
"dota_settings_cameraresetonspawn"	"Mută Camera după Reînviere"
"dota_settings_cameradeadcolorshift"	"Schimbare a culorilor camerei în timpul morții"
"dota_settings_profile"	"Profil"
"dota_settings_trade_friends"	"Doar prieteni"
"dota_settings_network"	"Reţea"
"dota_settings_aspectratio43"	"4:3"
"dota_settings_aspectratio169"	"16:9"
"dota_settings_aspectratio1610"	"16:10"
"dota_settings_voicevolume"	"Voce"
"dota_settings_defaultaudio"	"Implicit"
"dota_settings_chatsounds"	"Sunet mesaj discuție"
"dota_settings_unitspeech_events"	"Evenimente"
"DOTA_Keybind_LOL"	"League of Legends"
"DOTA_Keybind_HON"	"Heroes of Newerth"
"DOTA_Keybind_SMITE"	"Smite"
"DOTA_Hotkeys_Tooltip_CourierSelect"	"Alege curierul."
"DOTA_Lobby_BotDifficulty_easy"	"Ușor"
"DOTA_Lobby_BotDifficulty_medium"	"Mediu"
"DOTA_Lobby_BotDifficulty_hard"	"Greu"
"DOTA_Lobby_BotTeam"	"Alege echipa"
"DOTA_create_bot_practice_solo"	"Solo"
"dota_lobby_title"	"{s:lobby_name}"
"dota_lobby_title_local_game"	"Lobby local"
"dota_lobby_title_default"	"Lobby"
"dota_lobby_browser_refresh"	"Reîmprospătează"
"DOTA_Items_SetEquipped_Label"	"Echipat"
"DOTA_EquippedItem_Label"	"Echipat"
"DOTA_EquippedItem_Equip"	"Echipează"
"DOTA_EquippedItem_Purchase_Button"	"Achiziționează"
"DOTA_EquippedItem_ItemSet"	"Set"
"DOTA_EquippedItem_Item"	"Obiect"
"DOTA_HeroRole_Initiator"	"Initiator"
"DOTA_HeroGrid_OptionCategory_Role"	"Roluri:"
"DOTA_HeroCustomize_DefaultItemName"	"Obiect implicit"
"GC_Wait_Time_Unknown"	"Necunoscut"
"DOTA_practice_vs_bots_team_radiant"	"Radiant"
"DOTA_practice_vs_bots_team_dire"	"Dire"
"DOTA_Search_NoResults"	"Niciun rezultat"
"join_error_already_in_game"	"Nu te poți alătura lobby-ului de exercițiu, deoarece ești deja într-un joc."
"join_error_incorrect_password"	"Parolă incorectă."
"join_error_access_denied"	"Acces interzis."
"DOTA_Friend_In_Match"	"În meci"
"DOTA_Friend_Watch"	"Urmărește"
"dota_lobby_type_practice_game_mode_custom"	"Joc Personalizat"
"dota_lobby_type_tournament"	"Turneu"
"dota_lobby_type_casual_1v1"	"Meci 1v1"
"dota_match_result_none"	"???"
"DOTA_LoadingPlayerUnknown"	"-"
"custom_end_screen_legend_hero"	"Erou"
"custom_end_screen_legend_kills"	"K"
"custom_end_screen_legend_deaths"	"D"
"custom_end_screen_legend_assists"	"A"
"custom_end_screen_legend_items"	"Obiecte"
"custom_end_screen_legend_gold"	"Aur"
"CustomEndScreenClose"	"Închide"
"DOTA_Armory_Category_Heroes"	"Eroi"
"DOTA_Armory_Category_Couriers"	"Curieri"
"DOTA_Armory_Category_Wards"	"Warduri"
"DOTA_Armory_Category_Interface"	"Interfață"
"DOTA_Armory_Category_Emoticons"	"Emoticon-uri"
"DOTA_Armory_Category_Music"	"Muzică"
"DOTA_Armory_SortBy"	"Sortează după:"
"DOTA_Armory_ContextMenu_Equip"	"Echipează"
"dota_page_match_details_legend_level"	"Nivel"
"dota_page_match_details_legend_hero"	"Erou"
"dota_page_match_details_legend_kills"	"K"
"dota_page_match_details_legend_deaths"	"D"
"dota_page_match_details_legend_assists"	"A"
"dota_page_match_details_legend_gold"	"Aur"
"dota_page_match_details_legend_xp_per_min"	"XPM"
"dota_page_match_details_header_duration"	"Durată"
"dota_page_match_details_comment_placeholder"	"Scrie un comentariu..."
"dota_page_match_details_comment_loading_comments"	"Se încarcă comentariile..."
"dota_page_match_details_replay_existence_cdn_found"	"Descarcă reluarea"
"dota_page_match_details_replay_existence_disk_found_replay"	"Vezi reluarea"
"dota_profile_recent_game_header_type"	"Tip"
"dota_profile_recent_game_result_win"	"Victorie"
"dota_profile_recent_game_result_abandon"	"Abandonează"
"dota_profile_recent_game_icon_source1"	"S1"
"DOTA_tooltip_econ_item_rarity_label"	"Raritate: "
"custom_game_team_select_auto_start"	"Pornește Automat"
"custom_game_team_select_join"	"Alătură-te"
"DOTA_GlobalItems_Couriers"	"Curieri"
"DOTA_GlobalItems_World"	"Global"
"DOTA_GlobalItems_Wards"	"Warduri"
"DOTA_GlobalItems_Interface"	"Interfață"
"DOTA_GlobalItems_Emoticons"	"Emoticon-uri"
"DOTA_GlobalItems_Audio"	"Audio"
"DOTA_GlobalItems_Music"	"Muzică"
"DOTA_WatchLive_Fullscreen"	"ECRAN ÎNTREG"
"DOTA_JoinChatChannel_ChannelMemberCount"	"Membri"
"DOTA_Chat_ChannelMemberCount"	"{d:channel_member_count}"
"DOTA_GiftWrap_Success_Header"	"Succes"
"DOTA_GiftWrap_Success"	"Cadoul tău a fost trimis."
}
