"dota"
{
"DOTA_Accept"	"Accepter"
"DOTA_Cancel"	"Annuler"
"DOTA_Console"	"Console"
"DOTA_Create"	"Créer"
"DOTA_Decline"	"Refuser"
"DOTA_Error"	"Erreur"
"DOTA_Join"	"Rejoindre"
"DOTA_Leave"	"Quitter"
"DOTA_New"	"Nouveau"
"DOTA_Ok"	"OK"
"DOTA_Sale"	"Vente"
"DOTA_Close"	"Fermer"
"DOTA_Continue"	"Continuer"
"DOTA_Add"	"Ajouter"
"DOTA_Edit"	"Modifier"
"DOTA_Enable"	"Activer"
"DOTA_Disable"	"Désactiver"
"DOTA_Refresh"	"Rafraichir"
"DOTA_Loading"	"Charger"
"DOTA_None"	"Aucun"
"DOTA_Customize"	"Personnaliser"
"DOTA_AcceptChanges"	"Accepter les modifications"
"dota_team_radiant"	"Radiant"
"dota_team_dire"	"Dire"
"Unknown"	"Inconnu"
"UI_Yes"	"Oui"
"UI_No"	"Non"
"UI_File_Filter_Any"	"Tous les fichiers (*.*)"
"DOTA_MainMenu_Heroes"	"Héros"
"DOTA_MainMenu_Watch"	"Regarder"
"DOTA_MainMenu_Learn"	"Apprendre"
"DOTA_MainMenu_Mods"	"Jeux custom"
"DOTA_TabName_GlobalItems"	"Objets globaux"
"DOTA_TabName_Treasury"	"Trésor"
"DOTA_TabName_Armory"	"Armurerie"
"DOTA_ConfirmQuit"	"Confirmer l'arrêt ?"
"DOTA_ConfirmQuitDesc"	"Voulez-vous vraiment quitter Dota 2 ?"
"DOTA_ConfirmQuitDescUnsafe"	"Quitter une partie avant la fin peut ruiner la partie pour les autres joueurs. Voulez-vous vraiment quitter Dota 2 ?"
"DOTA_InvalidPersonaName"	"[inconnu]"
"DOTA_Friends_WindowTitle"	"AMIS"
"DOTA_FriendsCategory_ReadyToPlay"	"Dans les jeux ouverts <font color='#63C290'><b></b>({d:friend_count})</font>"
"DOTA_FriendsCategory_PlayingDota"	"Dans Dota <font color='#ACEBA9'>({d:friend_count})</font>"
"DOTA_FriendsCategory_Online"	"En ligne <font color='#6a9dcc'>({d:friend_count})</font>"
"DOTA_FriendsCategory_Pending"	"En attente <font color='#eeee82'>({d:friend_count})</font>"
"DOTA_FriendsCategory_Offline"	"Hors ligne <font color='#676666'>({d:friend_count})</font>"
"DOTA_Friends_Empty"	"Votre liste d'amis est actuellement vide"
"DOTA_FriendsMenu_Tooltip_NoneReady"	"Amis"
"DOTA_UserName"	"{g:dota_persona:user_account_id}"
"DOTA_UserNamePro"	"{g:dota_persona_pro:user_account_id}"
"DOTA_UserNickname"	"{g:dota_persona_nickname:user_account_id}"
"DOTA_UserRichPresence"	"{s:user_rich_presence}"
"DOTA_ProfileCard_StatTitle_SoloRank"	"Solo MMR"
"DOTA_ProfileCard_StatTitle_PartyRank"	"MMR de groupe"
"DOTA_ProfileCard_StatTitle_Wins"	"Victoires"
"DOTA_ProfileCard_StatTitle_Commends"	"Recommandations"
"DOTA_ProfileCard_StatTitle_GamesPlayed"	"Parties"
"DOTA_ProfileCard_StatTitle_FirstMatchDate"	"Première partie"
"DOTA_ProfileCard_StatValue_Int"	"{d:stat_value}"
"DOTA_ProfileCard_StatValue_Date"	"{t:s:stat_value}"
"DOTA_ProfileCard_StatValue_String"	"{s:stat_value}"
"DOTA_ProfileCard_SlotTab_Trophies"	"Trophées"
"DOTA_ProfileCard_SlotTab_Items"	"Armurerie"
"DOTA_ProfileCard_SlotTab_Heroes"	"Héros"
"DOTA_ProfileCard_SlotTab_Emoticons"	"Émoticônes"
"DOTA_ProfileCard_NoTrophies"	"Aucun trophée n'est disponible."
"DOTA_ProfileCard_NoItems"	"Aucun objet n'est disponible."
"DOTA_ProfileCard_HeroOnly"	"Héros seulement"
"DOTA_ProfileCard_HeroShowWins"	"Afficher les victoires"
"DOTA_ProfileCard_HeroShowWinsAndLosses"	"Afficher victoires et défaites"
"DOTA_ProfileCard_ItemSearchPrefix"	"Rechercher :"
"DOTA_ProfileCard_ItemSearchPlaceholder"	"Objets par nom"
"DOTA_ProfileCard_ItemArmoryLink"	"Voir l'armurerie complète"
"DOTA_HeroTooltip_HeroName"	"{s:hero_name}"
"DOTA_HeroTooltip_HeroRecord"	"{s:hero_wins_string}, {s:hero_losses_string}"
"DOTA_ProfileCard_HeroSearchPlaceholder"	"Rechercher le nom du héros"
"DOTA_Wins_Singular"	"1 Victoire"
"DOTA_Wins_Plural"	"{d:hero_wins} Victoires"
"DOTA_Losses_Singular"	"1 Défaite"
"DOTA_Losses_Plural"	"{d:hero_losses} Défaites"
"DOTA_Profile_TotalGames"	"Parties totales"
"DOTA_Profile_Solo_MMR"	"Solo MMR"
"DOTA_Profile_Team_MMR"	"MMR d'équipe"
"DOTA_Profile_Party_MMR"	"MMR de groupe"
"DOTA_Profile_VictoryCount"	"Victoires"
"DOTA_Profile_ProfilePage"	"Profil"
"DOTA_Profile_TrophyPage"	"Trophées"
"DOTA_Profile_RecentGamesPage"	"Parties récentes"
"DOTA_Profile_HeroPage"	"Héros"
"DOTA_Profile_PlayStyle"	"Style de jeu"
"DOTA_Profile_MostRecent"	"Match(s) {s:num_style_games} le(s) plus récent(s)"
"DOTA_Profile_RecentActivity"	"Activité récente"
"DOTA_Profile_Fighting"	"Combat"
"DOTA_Profile_Fighting_TooltipTitle"	"Combat"
"DOTA_Profile_Fighting_Tooltip"	"Joueurs qui affrontent les héros ennemis."
"DOTA_Profile_Farming"	"Farming"
"DOTA_Profile_Farming_TooltipTitle"	"Farming"
"DOTA_Profile_Farming_Tooltip"	"Joueurs qui farment de l'or en tuant des créatures."
"DOTA_Profile_Supporting"	"Support"
"DOTA_Profile_Supporting_TooltipTitle"	"Support"
"DOTA_Profile_Supporting_Tooltip"	"Joueurs qui soutiennent leurs équipes avec des soins, des wards et des objets."
"DOTA_Profile_Pushing"	"Pushing"
"DOTA_Profile_Pushing_TooltipTitle"	"Pushing"
"DOTA_Profile_Versatility"	"Polyvalence"
"DOTA_Profile_Versatility_TooltipTitle"	"Polyvalence"
"DOTA_Profile_Versatility_Tooltip"	"Joueurs versatiles jouant plusieurs héros différents."
"DOTA_Profile_Tooltip_Value"	"{s:CurrentStatValue}"
"DOTA_Profile_Tooltip_Comparison"	"{s:CurrentComparisonValue}"
"DOTA_Profile_StatsCompare"	"Comparer mes stats"
"DOTA_Profile_Self"	"Moi"
"DOTA_Profile_GPM"	"Moyenne OPM"
"DOTA_Profile_XPM"	"Moyenne d'XPM"
"DOTA_Profile_LH"	"Moyenne de Last Hits"
"DOTA_Profile_Rampages"	"Rampages"
"DOTA_Profile_TripleKills"	"Triple Kills"
"DOTA_Profile_FirstBlood"	"First Blood"
"DOTA_Profile_FirstBled"	"First Bled"
"DOTA_Profile_CourierKills"	"Coursiers tués"
"DOTA_Profile_Aegises"	"Aegis volés"
"DOTA_Profile_CheeseEaten"	"Fromages mangés"
"DOTA_Profile_CreepStack"	"Camps cumulés"
"DOTA_Profile_GPMValue"	"{s:GPM}"
"DOTA_Profile_XPMValue"	"{s:XPM}"
"DOTA_Profile_LHValue"	"{s:LH}"
"DOTA_Profile_RampagesValue"	"{d:Rampages}"
"DOTA_Profile_TripleKillsValue"	"{d:TripleKills}"
"DOTA_Profile_FirstBloodValue"	"{d:FirstBlood}"
"DOTA_Profile_FirstBledValue"	"{d:FirstBled}"
"DOTA_Profile_CourierKillsValue"	"{d:CourierKills}"
"DOTA_Profile_AegisesValue"	"{d:Aegises}"
"DOTA_Profile_CheeseEatenValue"	"{d:CheeseEaten}"
"DOTA_Profile_CreepStackValue"	"{d:CreepStack}"
"DOTA_Profile_GPMLocalValue"	"{s:GPMLocal}"
"DOTA_Profile_XPMLocalValue"	"{s:XPMLocal}"
"DOTA_Profile_LHLocalValue"	"{s:LHLocal}"
"DOTA_Profile_RampagesLocalValue"	"{d:RampagesLocal}"
"DOTA_Profile_TripleKillsLocalValue"	"{d:TripleKillsLocal}"
"DOTA_Profile_FirstBloodLocalValue"	"{d:FirstBloodLocal}"
"DOTA_Profile_FirstBledLocalValue"	"{d:FirstBledLocal}"
"DOTA_Profile_CourierKillsLocalValue"	"{d:CourierKillsLocal}"
"DOTA_Profile_AegisesLocalValue"	"{d:AegisesLocal}"
"DOTA_Profile_CheeseEatenLocalValue"	"{d:CheeseEatenLocal}"
"DOTA_Profile_CreepStackLocalValue"	"{d:CreepStackLocal}"
"DOTA_RecentGames_Title"	"Parties récentes"
"DOTA_RecentGames_TimeStamp"	"Date/Heure"
"DOTA_RecentGames_HeroSelection"	"Héros joué"
"DOTA_RecentGames_GameResult"	"Résultat"
"DOTA_RecentGames_GameLength"	"Durée"
"DOTA_RecentGames_Team"	"Équipe"
"DOTA_RecentGames_GameType"	"Type"
"DOTA_RecentGames_Items"	"Objets"
"DOTA_RecentGame_Timestamp_Entry"	"{t:s:timestamp} {t:t:timestamp}"
"DOTA_RecentGame_Duration"	"{t:d:duration}"
"DOTA_RecentGame_Downloading"	"{s:DownloadPercent} Downloading"
"DOTA_RecentGame_Watch"	"Regarder la rediffuision"
"DOTA_RecentGame_NoReplay"	"Aucune rediffusion"
"DOTA_RecentGame_Expired"	"Rediffusion expirée"
"DOTA_RecentGame_Finding"	"Recherche en cours..."
"DOTA_RecentGame_Download"	"Télécharger le match"
"DOTA_RecentGame_Pending"	"En attente de la rediffusion"
"DOTA_RecentGame_Unavailable"	"Rediffusion indisponible"
"DOTA_RecentGame_MatchID"	"ID du match : #{s:match_id}"
"DOTA_No_Team_Name"	"--"
"DOTA_TrophyCount"	"{d:trophy_count} Trophée"
"DOTA_TrophiesCount"	"{d:trophy_count} Trophées"
"DOTA_TrophyCount_Number"	"{d:trophy_count}"
"DOTA_TrophyCount_NoNum"	"Trophée"
"DOTA_TrophiesCount_NoNum"	"Trophées"
"DOTA_Trophies_ViewAll"	"Tous"
"DOTA_TrophyName"	"{s:trophy_name}"
"DOTA_TrophyCategory"	"{s:trophy_category}"
"DOTA_TrophyDescription"	"{s:trophy_description}"
"DOTA_TrophyXP"	"{d:trophy_xp}<span class=\"TrophyPointTextSmall\">TP</span>"
"DOTA_NextTrophy"	"Prochaine récompense"
"DOTA_NewPlayerQuestion_Title"	"BIENVENUE SUR DOTA 2"
"DOTA_PlayerOriginQuestion_Question"	"Pour améliorer votre expérience de jeu, veuillez partager votre familiarité avec Dota 2 et des jeux similaires :"
"DOTA_PlayerOriginQuestion_BeginnerButton"	"Je suis un débutant."
"DOTA_PlayerOriginQuestion_RTSButton"	"J'ai joué à des RTS."
"DOTA_PlayerOriginQuestion_MOBAButton"	"J'ai joué à des MOBA."
"DOTA_PlayerOriginQuestion_Dota2Button"	"J'ai joué à Dota 2."
"DOTA_PlayerOriginQuestion_MOBAExplanation"	"Sélectionnez le jeu avec lequel vous êtes le plus confortable :"
"DOTA_OtherGames_LOL"	"League of Legends"
"DOTA_OtherGames_DOTA"	"DotA 1"
"DOTA_OtherGames_HON"	"Heroes of Newerth"
"DOTA_OtherGames_Smite"	"Smite"
"DOTA_OtherGames_Other"	"Un autre jeu"
"DOTA_PlayerOriginQuestion_ConfirmationButton"	"JOUONS"
"DOTA_PlayerOriginQuestion_ConfirmationTutorial"	"Comme nouveau joueur de Dota, vous pouvez être intéressé par les tutoriels sous Jouer > Entrainement. Ce sont les premières étapes vers la domination des autres joueurs du monde entier."
"DOTA_PlayerOriginQuestion_ConfirmationSettings"	"Vos raccourcis claviers et options sont maintenant réglés suivant la configuration la plus répandue chez les joueurs de votre niveau. Vous pouvez les personnaliser à tout moment en cliquant sur l\\'icône d\\'options."
"DOTA_Tutorial_SkipButton"	"Passer le tutoriel"
"DOTA_ConfirmSkip"	"Passer l'introduction de Dota 2"
"DOTA_ConfirmSkipDesc"	"Êtes-vous certain de vouloir passer les tutoriels de Dota 2"
"DOTA_Tutorial_Start_Quest"	"DÉMARRER LA QUÊTE"
"DOTA_Tutorial_Quest0_Title"	"QUÊTE 1"
"DOTA_Tutorial_Quest0_TitleDesc"	"HÉROS À DISTANCE"
"DOTA_Tutorial_Quest0DetailsDesc"	"Vous aurez besoin d'approximativement\n10 minutes pour compléter cette quête."
"DOTA_Tutorial_QuestDetailsLearn"	"Vous apprendrez :"
"DOTA_Tutorial_Quest0DetailsLesson"	"Déplacements de héros\nNiveaux de héros\nUtilisations de capacités\nUtilisations d'objets\nBases du combat\nLast Hits"
"DOTA_Tutorial_Quest1_Title"	"QUÊTE 2"
"DOTA_Tutorial_Quest1_TitleDesc"	"COMBAT EN LANE"
"DOTA_Tutorial_Quest1DetailsDesc"	"Vous aurez besoin d'approximativement\n10 minutes pour compléter cette quête."
"DOTA_Tutorial_Quest1DetailsLesson"	"Combats à distance \n Capacités à zone d'effet (Area of Effect) \n Fonctions de la mini-carte \n Tours \n Coursiers et réserve \n Téléportation"
"DOTA_Tutorial_Quest2_Title"	"QUÊTE 3"
"DOTA_Tutorial_Quest2_TitleDesc"	"COMBAT EN LANE"
"DOTA_Tutorial_Quest2DetailsDesc"	"Vous aurez besoin d'approximativement\n10 à 15 minutes pour compléter cette quête."
"DOTA_Tutorial_Quest2DetailsLesson"	"Combats en lane \n Défendre et attaquer les tours \n Objets de base"
"DOTA_Challenges_Title"	"Apprendre"
"DOTA_ChallengeGroup_0_Title"	"Mécaniques"
"DOTA_ChallengeGroup_1_Title"	"Parties guidées avec bots"
"DOTA_ChallengeGroup_1_Desc"	"Démarrer ici !"
"DOTA_ChallengeGroup_2_Title"	"Matchs contre des bots"
"DOTA_ChallengeGroup_More"	"Plus à venir"
"DOTA_ChallengeGroup_Locked"	"Verrouillé"
"DOTA_LearnMechanics_Title"	"Mécaniques"
"DOTA_LearnMechanics_SubTitle"	"Ces tutoriels vont vous apprendre les bases de Dota. Il n'est pas recommandé de commencer à apprendre Dota en jouant à ce mode. Commencez plutôt par une partie guidée avec bots, et revenez ici si vous vous retrouvez bloqué."
"DOTA_Mechanics_0_Title"	"Mécaniques 1"
"DOTA_Mechanics_0_Desc"	"Déplacements de héros\nNiveau de héros\nUtilisations de capacités\nUtilisations d'objets\nBases du combat\nLast Hits"
"DOTA_Mechanics_1_Title"	"Mécaniques 2"
"DOTA_Mechanics_1_Desc"	"Combats à distance\nCapacités à zone d'effet (Area of Effect)\nFonctions de la mini-carte\nTours\nCoursiers et réserve\nParchemins de téléportation"
"DOTA_LearnGuidedBotMatches_Title"	"Parties guidées avec bots"
"DOTA_LearnGuidedBotMatches_SubTitle"	"Affrontez des héros contrôlés par l'IA pour vous apprendre à jouer à Dota. Nous vous guiderons pas-à-pas à travers chaque phase d'un match pour que votre héros devienne surpuissant."
"DOTA_GuidedBotMatches_0_Title"	"Luna"
"DOTA_GuidedBotMatches_0_Desc"	"Attaque à courte portée\nDégâts d'attaque élevés\nMouvements rapides\nMoyennement fragile\nUtilise la stat Agilité"
"DOTA_GuidedBotMatches_1_Title"	"Sven"
"DOTA_GuidedBotMatches_1_Desc"	"Attaque au corps-à-corps\nDégâts d'attaque burst\nGrande durabilité\nVulnérable lorsque ralenti\nUtilisé la stat Force"
"DOTA_GuidedBotMatches_2_Title"	"Luna"
"DOTA_LearnBotMatches_Title"	"Parties avec bots"
"DOTA_LearnBotMatches_SubTitle"	"Entraînez vous avec et contre des héros contrôlés par l'IA dans un espace d'entrainement dénué de stress."
"DOTA_BotMatches_0_Title"	"Bots faciles"
"DOTA_BotMatches_0_Desc"	"Apprenez un nouveau héros"
"DOTA_BotMatches_1_Title"	"Bots moyens"
"DOTA_BotMatches_1_Desc"	"Mettez-vous à l'aise."
"DOTA_BotMatches_2_Title"	"Bots difficiles"
"DOTA_BotMatches_2_Desc"	"Relevez le défi."
"DOTA_BotMatches_3_Title"	"Bots experts"
"DOTA_BotMatches_3_Desc"	"Blessez-vous."
"FileOpenDialog_Open"	"Ouvrir"
"FileOpenDialog_Save"	"Sauvegarder"
"FileOpenDialog_Select"	"Sélectionner"
"FileOpenDialog_FileType_Folder"	"Dossier"
"DOTA_FindMatch"	"Chercher une partie"
"DOTA_FindingMatch"	"Recherche de match en cours ( {s:find_match_time} )"
"DOTA_FindMatchTime"	"{s:find_match_time}"
"DOTA_Searching"	"Recherche"
"DOTA_StartSoloBotMatch"	"Démarrer la partie avec bots"
"DOTA_Create_Lobby"	"CRÉER UNE SALLE"
"DOTA_Join_Lobby"	"Rejoindre la salle d'attente"
"DOTA_LobbyStartGame"	"Démarrer la partie"
"DOTA_ReturnToLobby"	"Retour au lobby"
"DOTA_FindMatchStatus"	"{s:searching_matchtype} / {s:searching_gamemodes} / {s:searching_region}"
"DOTA_FindGameModesMany"	"Modes de jeux :"
"DOTA_FindRegionsMany"	"Régions :"
"DOTA_GameMode_AllPick"	"All Pick"
"DOTA_GameMode_SingleDraft"	"Single Draft"
"DOTA_GameMode_CaptainsMode"	"Captains Mode"
"DOTA_GameMode_RandomDraft"	"Random Draft"
"DOTA_GameMode_AbilityDraft"	"Ability Draft"
"DOTA_GameMode_LeastPlayed"	"Least Played"
"DOTA_GameMode_AllRandom"	"All Random"
"DOTA_GameMode_LimitedHeroes"	"Limited Heroes"
"DOTA_GameMode_CaptainsDraft"	"Captains Draft"
"DOTA_GameMode_AllRandomDeathMatch"	"All Random Deathmatch"
"DOTA_ImmediatePurchase_SendFailed"	"Échec de l'envoi de la requête d'achat. Il est possible que les serveurs Dota soient hors ligne. Vous devriez réitérer votre achat plus tard."
"DOTA_ImmediatePurchase_Timeout"	"Expiration du délai d'attente d'une réponse à la requête d'achat. Veuillez réessayer plus tard."
"DOTA_ImmediatePurchase_InsufficientFundsPW"	"Le solde de votre compte Perfect World est insuffisant pour procéder à l'achat. Veuillez recharger votre compte et réessayer."
"DOTA_ImmediatePurchase_Success_Title"	"Succès"
"DOTA_ImmediatePurchase_Success_Text"	"Achat effectué avec succès ! Vos objets apparaîtront dans votre armurerie sous peu."
"DOTA_ImmediatePurchase_Cancelled_Title"	"Annulé"
"DOTA_ImmediatePurchase_UnbundleTimeout"	"Expiration du délai d'attente d'une réponse à la requête de déballage. Veuillez réessayer plus tard."
"DOTA_ImmediatePurchase_UnbundleFailure"	"Impossible de déballer votre bundle. Veuillez réessayer plus tard."
"DOTA_ImmediatePurchase_LateCancel"	"L'achat a déjà été annulé. Vous n'avez pas été encaissé."
"DOTA_ConfirmPurchaseTitle"	"Confirmer l'achat"
"DOTA_ConfirmPurchaseText"	"Voulez-vous acheter cet objet ?"
"DOTA_PurchaseInProgress_Title"	"Achat en cours"
"DOTA_PurchaseInProgress_Text"	"Votre achat est en cours."
"DOTA_UnbundleInProgress_Title"	"Déballage en cours"
"DOTA_UnbundleInProgress_Text"	"Votre paquet est cours de déballage."
"DOTA_ConfirmUnbundleTitle"	"Confirmer le déballage"
"DOTA_ConfirmUnbundleText"	"Vous devez déballer ce bundle afin de vous équiper des objets. Souhaitez-vous poursuivre ?"
"DOTA_RequestingBalance_Title"	"Solde restant"
"DOTA_RequestingBalance_Text"	"Obtention du solde de votre compte Perfect World..."
"DOTA_PartnerPurchaseRecharge_Title"	"Recharger le solde"
"DOTA_PartnerPurchaseRecharge_Text"	"Changement pour recharger le solde de votre compte..."
"DOTA_PartnerPurchase_Purchase"	"{g:dota_item_price:item_def}"
"DOTA_PartnerPurchase_Recharge"	"Recharger le compte"
"DOTA_PartnerPurchase_Balance"	"Solde : {m:balance}"
"DOTA_PartnerRecharge_Close"	"Retourner à l'achat"
"RequestBalanceBadAccount"	"Impossible d'obtenir le solde du compte : Compte introuvable."
"RequestBalanceAccountNotLinked"	"Impossible d'obtenir le solde de votre compte : votre compte n'est pas lié à Perfect World."
"RequestBalanceUnsupportedPartner"	"Impossible d'obtenir le solde du compte : votre compte n'est pas lié à un partenaire reconnu"
"StoreCheckout_Error_Title"	"Erreur"
"StoreCheckout_NoItems"	"Votre panier est vide !"
"StoreCheckout_TooManyItems"	"Vous avez placé un trop grand nombre d'objets dans votre panier !"
"StoreCheckout_Loading"	"Validation..."
"StoreCheckout_Unavailable"	"La caisse est momentanément indisponible."
"StoreCheckout_Cancelling"	"Annulation..."
"StoreCheckout_Fail"	"Le magasin est actuellement fermé."
"StoreCheckout_InvalidParam"	"Un programmeur s'est planté ! Un paramètre non valide a été transmis au coordinateur du jeu. Merci de renouveler votre achat."
"StoreCheckout_InternalError"	"Une erreur est survenue lors de l'initialisation ou la mise à jour de votre transaction. Veuillez patienter une minute, puis réessayez ou contactez le support client pour plus d'informations."
"StoreCheckout_ContactSupport"	"Une erreur est survenue pendant la transaction. Veuillez contacter le support client pour plus d'informations."
"StoreCheckout_NotApproved"	"Le coordinateur du jeu n'a pas pu approuver votre transaction auprès de Steam. Merci de renouveler votre achat ultérieurement."
"StoreCheckout_NotLoggedin"	"Vous devez être connecté à Steam pour effectuer un achat."
"StoreCheckout_WrongCurrency"	"La devise choisie pour cette transaction ne correspond pas à la devise de votre porte-monnaie."
"StoreCheckout_NoAccount"	"Votre compte Steam n'est pas disponible actuellement. Merci de renouveler votre achat ultérieurement."
"StoreCheckout_InsufficientFunds"	"Vous ne disposez pas du montant nécessaire à cet achat."
"StoreCheckout_TimedOut"	"Le délai d'exécution de cette transaction a expiré. Merci de renouveler votre achat."
"StoreCheckout_SteamAccountDisabled"	"Vous ne pouvez pas effectuer d'achat car votre compte Steam est désactivé."
"StoreCheckout_SteamAccountNoPurchase"	"Les transactions à l'aide du porte-monnaie Steam sont désactivées pour ce compte."
"StoreCheckout_OldPriceSheet"	"La liste des produits enregistrée sur votre ordinateur est obsolète. Demande de mise à jour en cours."
"StoreCheckout_TransactionNotFound"	"Le coordinateur du jeu n'a pas trouvé ce numéro de transaction. Veuillez renouveler votre achat."
"StoreCheckout_TransactionCancelled"	"Transaction annulée. Vous n'avez pas été débité."
"StoreCheckout_TransactionCompleted"	"Transaction effectuée.\nAmusez-vous bien !"
"StoreCheckout_CompleteButUnfinalized"	"Impossible de confirmer la réussite de la transaction. Le cas échéant, les objets vous seront fournis ultérieurement."
"StoreCheckout_NotEnoughRoom"	"Le nombre d'emplacements disponibles de votre armurerie ne permet pas l'achat d'autant d'objets."
"StoreCheckout_ContactSupport_Dialog_Title"	"Avertissement"
"StoreCheckout_ContactSupport_Dialog_Btn"	"Contacter"
"StoreCheckout_LimitedQuantityItemsUnavailable"	"Un objet que vous essayez d'acheter est épuisé ou est actuellement indisponible."
"StoreCheckout_Nexon_InsufficientFunds"	"Vous ne disposez pas du montant nécessaire à cet achat."
"StoreCheckout_Nexon_FundsLocked"	"Le verrouillage Nexon Cash est activé."
"npc_dota_hero_abaddon_hype"	"Capable de transformer les attaques ennemies en soins pour lui-même, Abaddon peut survivre à n'importe quel assaut. Renforçant ses alliés et lançant sa spirale à double tranchant, il est toujours prêt pour charger au cœur de la bataille."
"npc_dota_hero_ancient_apparition_hype"	"Capable de lancer une puissante explosion de glace à travers le champ de bataille, Ancient Apparition menace de briser les ennemis affaiblis où qu'ils soient. Ralenti les ennemis autant qu'il améliore l'efficacité de ses alliés dans la bataille, il constitue une menace permanente pour ses ennemis."
"DOTA_AbilityTooltip_Name"	"{s:name}"
"DOTA_AbilityTooltip_Level"	"Niveau {s:level}"
"DOTA_AbilityTooltip_TargetType"	"EFFETS : {s:targettype}"
"DOTA_AbilityTooltip_CastType"	"CAPACITÉ : {s:casttype}"
"DOTA_AbilityTooltip_DamageType"	"TYPE DE DÉGATS : {s:damagetype}"
"DOTA_AbilityTooltip_SpellImmunityType"	"IMMUNITÉ AUX SORTS : {s:spellimmunity}"
"DOTA_AbilityTooltip_Description"	"{s:description}"
"DOTA_AbilityTooltip_ScepterDescription"	"{s:scepterdescription}"
"DOTA_AbilityTooltip_ExtraDescription"	"{s:extradescription}"
"DOTA_AbilityTooltip_Attributes"	"{s:attributes}"
"DOTA_AbilityTooltip_Cooldown"	"{s:cooldown}"
"DOTA_AbilityTooltip_ManaCost"	"{s:manacost}"
"DOTA_AbilityTooltip_Lore"	"{s:lore}"
"DOTA_AbilityTooltip_UpgradeLevel"	"Prochaine amélioration possible au niveau {d:upgradelevel}"
"DOTA_AbilityTooltip_BuildHeader"	"Guide de capacité"
"DOTA_AbilityTooltip_BuildComment"	"{s:buildcomment}"
"DOTA_PersonaTooltip_Title"	"{g:dota_persona:account_id}"
"DOTA_PersonaTooltip_TitlePro"	"{g:dota_persona_pro:account_id}"
"DOTA_PendingInvites"	"Invitations de groupe"
"DOTA_PendingInvitesTooltip_None"	"Aucune invitation en attente"
"DOTA_PendingInvitesTooltip_1"	"1 invitation en attente"
"DOTA_PendingInvitesTooltip_N"	"{d:pending_invite_count} invitations en attente"
"DOTA_PendingInvitesTooltip_Leader"	"Cliquez ici pour gérer vos invitations."
"DOTA_PendingInvitesTooltip_NonLeader"	"Cliquez ici pour voir toutes les invitations."
"DOTA_PendingInvitesCancelAll"	"Annuler toutes les invitations"
"DOTA_PendingInvitesNotPartyLeader"	"Seul le leader du groupe peut gérer les invitations"
"DOTA_ChatTab_NotInChannelMessage"	"Personne ne peut vous entendre."
"DOTA_ChatTab_ToggleGlobal"	"Montrer les messages de ce canal dans tous les onglets."
"DOTA_ChatTab_Close"	"Fermer cette fenêtre"
"DOTA_ChatTab_Leave"	"Quitter ce canal."
"DOTA_JoinChatChannel_Title"	"Rejoindre le canal"
"DOTA_JoinChatChannel_Description"	"Créer ou rejoindre un canal."
"DOTA_JoinChatChannel_AddToCurrentTab"	"Ajouter à la section actuelle '{s:current_tab_name}'"
"DOTA_JoinChatChannel_CreateNewTab"	"Créer une nouvelle section :"
"DOTA_Chat_ChannelName"	"{s:channel_name}"
"DOTA_Chat_ChannelMemberCount_Singular"	"1 membre"
"DOTA_Chat_ChannelMemberCount_Plural"	"{d:channel_member_count} membres"
"DOTA_EditChatTab_Title"	"Modifier la fenêtre du t'chat"
"DOTA_EditChatTab_Description"	"Sélectionnez les messages qui devraient être affichés dans cet onglet."
"DOTA_EditChatTab_AddNewChannel"	"Ajouter un nouveau canal..."
"DOTA_EditChatTab_TabName"	"Nom de la section :"
"DOTA_EditChatTab_ChannelToggleDisabled"	"{s:target} doit toujours se trouver dans au moins un onglet."
"DOTA_EditChatTab_Target"	"{s:target}"
"DOTA_Chat_TimestampFormat"	"{t:t:timestamp}"
"DOTA_Chat_Autocomplete_Title"	"{s:autocomplete_title}"
"DOTA_Chat_Autocomplete_NoMatches"	"Pas de résultat"
"DOTA_Chat_Autocomplete_WhisperFriends"	"Chuchoter à un ami"
"DOTA_Chat_Autocomplete_InviteFriends"	"Inviter un ami"
"DOTA_Chat_Autocomplete_Channels"	"Canaux"
"DOTA_Chat_Autocomplete_Commands"	"Recommandations"
"DOTA_Chat_Autocomplete_CommandName"	"/{s:command_name}"
"DOTA_Chat_Autocomplete_CommandDescription"	"{s:command_description}"
"dota_suggest_invite_format"	"Veuillez inviter {s:invite_persona} au groupe."
"dota_suggest_invite_format_leader"	"S'il vous plaît, invitez {s:invite_persona} dans le  groupe ( <a href=\"event:DOTAInviteToParty({s:invite_persona_steamid})\" class=\"InviteButton\">Envoyer les invitations</a> )"
"dota_suggest_invite_format_lobby"	"S'il vous plaît, invitez {s:invite_persona} dans le lobby."
"dota_suggest_invite_format_lobby_leader"	"Veuillez inviter {s:invite_persona} dans le lobby. ( <a href=\"event:DOTAInviteToLobby({s:invite_persona_steamid})\" class=\"InviteButton\">Envoyer invitation</a> )"
"DOTA_ChatMessage_Default"	"<span class=\"{s:target_class}\"><span class=\"ChatTarget\">(<a href=\"{s:target_link}\">{s:target}</a>)</span> <span class=\"ChatPersona\">[{s:event_crest}{s:persona}]</span> : {g:dota_filtered_string:message}</span>"
"DOTA_ChatMessage_WhisperTo"	"<span class=\"{s:target_class}\">À <span class=\"ChatPersona\">[{s:event_crest}{s:persona}]</span> : {g:dota_filtered_string:message}</span>"
"DOTA_ChatMessage_WhisperFrom"	"<span class=\"{s:target_class}\">De <span class=\"ChatPersona\">[{s:event_crest}{s:persona}]</span> : {g:dota_filtered_string:message}</span>"
"DOTA_ChatMessage_System"	"<span class=\"{s:target_class}\"><span class=\"ChatTarget\">({s:target})</span> : {g:dota_filtered_string:message}</span>"
"DOTA_ChatTarget_Format_Default"	"{s:target}"
"DOTA_ChatTarget_Prompt_Default"	"À ({s:target}) :"
"DOTA_ChatTarget_Format_Whisper"	"{s:persona}"
"DOTA_ChatTarget_Prompt_Whisper"	"À [{s:persona}] :"
"DOTA_ChatTarget_Party"	"Groupe"
"DOTA_ChatTarget_Lobby"	"Lobby"
"DOTA_ChatTarget_Team"	"Équipe"
"DOTA_ChatTarget_Guild"	"Guilde"
"DOTA_ChatTarget_Fantasy"	"Fantasy"
"DOTA_ChatTarget_Console"	"Console"
"DOTA_ChatTarget_Whisper"	"Chuchotement"
"DOTA_ChatTarget_Invalid"	"Aucun canal"
"DOTA_ChatTarget_GameAll"	"Tous"
"DOTA_ChatTarget_GameAllies"	"Alliés"
"DOTA_ChatTarget_GameCoaching"	"Coaching"
"DOTA_ChatTarget_GameSpectator"	"Spectateur"
"DOTA_ChatTargetMenu_Title"	"{s:target}"
"DOTA_ChatTargetMenu_ToggleEnabled"	"{s:toggle_enabled}"
"DOTA_ChatTargetMenu_NotActive"	"(Inactif)"
"DOTA_Chat_Placeholder"	"Écrivez ici pour discuter. Utilisez '/' pour afficher la liste des commandes."
"DOTA_Chat_MissedMessages"	"{s:missed_message_count}"
"DOTA_ChatCommand_Party"	"p"
"DOTA_ChatCommand_Party_Name"	"Groupe"
"DOTA_ChatCommand_Party_Description"	"Discuter dans votre groupe actuel."
"DOTA_ChatCommand_Lobby"	"l"
"DOTA_ChatCommand_Lobby_Name"	"Lobby"
"DOTA_ChatCommand_Lobby_Description"	"Discuter avec votre lobby actuel."
"DOTA_ChatCommand_Channel"	"c"
"DOTA_ChatCommand_Channel_Name"	"Canal"
"DOTA_ChatCommand_Channel_Description"	"Discuter dans un canal de chat spécifique."
"DOTA_ChatCommand_Whisper"	"w"
"DOTA_ChatCommand_Whisper_Name"	"Chuchotement"
"DOTA_ChatCommand_Whisper_Description"	"Chuchoter en privé avec un ami."
"DOTA_ChatCommand_Reply"	"r"
"DOTA_ChatCommand_Reply_Name"	"Réponse"
"DOTA_ChatCommand_Reply_Description"	"Répondre au message privé envoyé par un ami."
"DOTA_ChatCommand_Help"	"?"
"DOTA_ChatCommand_Help_Name"	"Aide"
"DOTA_ChatCommand_Help_Description"	"Afficher l'aide pour les commandes de discussion."
"DOTA_ChatCommand_InviteToParty"	"invitationaugroupe"
"DOTA_ChatCommand_InviteToParty_Name"	"Inviter au groupe"
"DOTA_ChatCommand_InviteToParty_Description"	"Inviter un ami à rejoindre votre groupe actuel."
"DOTA_ChatCommand_LeaveParty"	"quittergroupe"
"DOTA_ChatCommand_LeaveParty_Name"	"Quitter le groupe"
"DOTA_ChatCommand_LeaveParty_Description"	"Quitter le groupe actuel."
"DOTA_ChatCommand_JoinChannel"	"rejoindrecanal"
"DOTA_ChatCommand_JoinChannel_Name"	"Rejoindre le canal"
"DOTA_ChatCommand_JoinChannel_Description"	"Rejoindre ou créer un canal de t'chat."
"DOTA_ChatCommand_LeaveChannel"	"quittercanal"
"DOTA_ChatCommand_LeaveChannel_Name"	"Quitter le canal"
"DOTA_ChatCommand_LeaveChannel_Description"	"Quitter un canal de t'chat spécifique."
"DOTA_ChatCommand_GameAll"	"tous"
"DOTA_ChatCommand_GameAll_Name"	"Tous"
"DOTA_ChatCommand_GameAll_Description"	"Discuter avec tous les joueurs dans la partie."
"DOTA_ChatCommand_GameAllies"	"alliés"
"DOTA_ChatCommand_GameAllies_Name"	"Alliés"
"DOTA_ChatCommand_GameAllies_Description"	"Discuter avec vos alliés."
"DOTA_ChatCommand_GameCoaching"	"coacher"
"DOTA_ChatCommand_GameCoaching_Name"	"Coaching"
"DOTA_ChatCommand_GameCoaching_Description"	"Discuter avec votre élève ou votre coach."
"DOTA_ChatCommand_GameSpectator"	"spectateur"
"DOTA_ChatCommand_GameSpectator_Name"	"Spectateur"
"DOTA_ChatCommand_GameSpectator_Description"	"Discuter avec les autres spectateurs."
"DOTA_ChatCommand_Clear"	"nettoyer"
"DOTA_ChatCommand_Clear_Name"	"Nettoyer"
"DOTA_ChatCommand_Clear_Description"	"Nettoyer le t'chat visible dans la section."
"DOTA_Chat_UnknownCommandMessage"	"Commande de t'chat inconnue '{s:chat_command}'"
"DOTA_ChatHelp_Targets"	"Cibles"
"DOTA_ChatHelp_Commands"	"Commandes"
"DOTA_ChatHelp_NameFormat"	"{s:command_name} :"
"DOTA_ChatHelp_CommandFormat"	"/{s:command}"
"DOTA_Chat_JoinedParty"	"Groupe rejoint : {s:party_members}"
"DOTA_Chat_LeftParty"	"Groupe dissous"
"DOTA_Chat_MemberJoinedParty"	"Un joueur a rejoint le groupe : {s:party_members}"
"DOTA_Chat_InvitedToJoinParty"	"Invité : {s:party_members}"
"DOTA_Chat_RequestedToJoinParty"	"Requête pour rejoindre : {s:party_members}"
"DOTA_Chat_PartyMemberSeparator"	", "
"DOTA_Feature_Under_Construction_Title"	"En construction"
"DOTA_Feature_Under_Construction_Text"	"Cette fonctionnalité est en cours de développement et n'est pas encore disponible."
"DOTA_Treasure_Purchase_Under_Construction_Text"	"L'achat des trésors n'est pas encore disponible. Cependant, l'achat à partir du magasin Dota est possible. Consultez la liste des items sur la gauche des ensembles d'items disponibles."
"DOTA_PartyJoinRequest_Title"	"Demande de rejoindre le groupe"
"DOTA_PartyMergeRequest_Title"	"Requête de fusion de groupes"
"DOTA_PartyInvite_Title"	"Invitation au groupe"
"DOTA_Invite_IOfN"	"{d:received_invite_index} de {d:received_invite_count}"
"DOTA_PartyInvite_Description"	"{g:dota_persona:b:inviter} vous a invité à un groupe."
"DOTA_PartyInvite_LowPriority_Title"	"Invitation de groupe pour jeu basse priorité"
"DOTA_PartyInvite_LowPriority_Description"	"{g:dota_persona:b:inviter} vous a invité dans un groupe  pour un jeu en basse priorité."
"DOTA_LobbyInvite_BlockInviter"	"Bloquer toutes les communications de ce joueur"
"DOTA_PartyInvite_BlockNonFriendInvites"	"Bloquer les invitations des joueurs qui ne sont pas dans votre liste d'amis"
"DOTA_PartyInvite_Coach"	"Coach :"
"DOTA_PartyVisTooltip_TitleOpen"	"Recherche de joueurs pour former un groupe"
"DOTA_PartyVisTooltip_TitleNotOpen"	"Pas de recherche de joueurs pour le groupe"
"DOTA_PartyVisTooltip_SoloNotOpen"	"Cliquez pour changer votre statut."
"DOTA_PartyVisTooltip_SoloOpen"	"Les amis peuvent demander à vous rejoindre<br/>Cliquez pour changer votre statut."
"DOTA_PartySettings"	"Paramètres du groupe"
"DOTA_PartySettings_OpenParty"	"Ouvrir le groupe pour autoriser les requêtes pour rejoindre"
"DOTA_PartySettings_BroadcastToFriends"	"Permettre à mes amis de voir lorsque je suis dans un groupe"
"DOTA_LobbyInvite_Title"	"Invitation au lobby"
"DOTA_LobbyInvite_Description"	"{g:dota_persona:inviter} vous a invité à rejoindre un lobby."
"DOTA_PartyJoinedLobby_Title"	"A rejoint le lobby"
"DOTA_PartyJoinedLobby_Generic"	"{s:party_leader} vous a déplacé dans un lobby."
"DOTA_PartyLeader"	"Leader du groupe"
"DOTA_LobbyKicked_Header"	"Exclu de la salle d'attente"
"DOTA_LobbyKicked_Message"	"Vous avez été exclu de la salle d'attente par son leader."
"DOTA_PlayerContextMenu_ViewProfile"	"Voir profil"
"DOTA_PlayerContextMenu_ChatWithPlayer"	"Envoyer un message dans le t'chat"
"DOTA_PlayerContextMenu_InviteToParty"	"Inviter au groupe"
"DOTA_PlayerContextMenu_SuggestInviteToParty"	"Suggérer une invitation au groupe"
"DOTA_PlayerContextMenu_KickFromParty"	"Expulsé du groupe"
"DOTA_PlayerContextMenu_SetPartyLeader"	"Choisir un leader de groupe"
"DOTA_PlayerContextMenu_LeaveParty"	"Quitter le groupe"
"DOTA_PlayerContextMenu_CoachParty"	"Coacher le groupe"
"DOTA_PlayerContextMenu_StopCoachingParty"	"Arrêter le coaching de ce groupe"
"DOTA_PlayerContextMenu_AddFriend"	"Ajouter un ami"
"DOTA_PlayerContextMenu_RemoveFriend"	"Supprimer un ami"
"DOTA_PlayerContextMenu_AcceptFriendRequest"	"Accepter demande d'ami"
"DOTA_PlayerContextMenu_IgnoreFriendRequest"	"Ignorer demande d'ami"
"DOTA_PlayerContextMenu_Spectate"	"Regarder partie"
"DOTA_PlayerContextMenu_InviteToLobby"	"Inviter au lobby"
"DOTA_PlayerContextMenu_SuggestInviteToLobby"	"Suggérer une invitation au lobby"
"DOTA_PlayerContextMenu_KickFromLobby"	"Exclure du lobby"
"DOTA_PlayerContextMenu_KickFromLobbyTeam"	"Exclure du lobby de l'équipe"
"DOTA_FeaturedHero_UnableToLoad"	"Incapable de charger les héros sélectionnés."
"DOTA_FeaturedHero_ViewGrid"	"Voir la grille"
"DOTA_FeaturedHero_HeroName"	"{s:hero_name}"
"DOTA_FeaturedHero_ItemName"	"{g:dota_item_name:item_def}"
"DOTA_FeaturedHeroReason_NewHero"	"Héros récemment ajouté"
"DOTA_FeaturedHeroReason_NewItem"	"Nouveau {s:item_rarity}"
"DOTA_FeaturedHeroReason_FrequentlyPlayedHero"	"Parce que vous avez joué"
"DOTA_FeaturedHeroReason_FeaturedItem"	"Item à l'affiche"
"DOTA_FeaturedHeroReason_PopularItem"	"Meilleur vendeur"
"DOTA_FeaturedHeroReason_SaleItem"	"En vente dès maintenant"
"DOTA_HeroSelectorCategory_Default"	"Tous les héros"
"DOTA_HeroSelectorCategory_NewItems"	"Nouveaux objets"
"DOTA_HeroSelectorCategory_Favorites"	"Favoris"
"DOTA_HeroSelectorCategory_MostPlayed"	"Mes plus joués"
"DOTA_HeroSelectorCategory_LeastPlayed"	"Mes moins joués"
"DOTA_HeroSelectorCategory_HaveItems"	"J'ai les objets pour"
"DOTA_HeroSelectorCategory_PrimaryAttribute_Strength"	"Force"
"DOTA_HeroSelectorCategory_PrimaryAttribute_Agility"	"Agilité"
"DOTA_HeroSelectorCategory_PrimaryAttribute_Intelligence"	"Intelligence"
"DOTA_HeroSelectorCategory_AttackRange_Melee"	"Mêlée"
"DOTA_HeroSelectorCategory_AttackRange_Ranged"	"A distance"
"DOTA_HeroSelector_SelectHero_Label"	"Choisir"
"DOTA_HeroSelector_ClearFilters"	"Supprimer les filtres"
"DOTA_OwnedItemSet_Selector_Title"	"Possédé"
"DOTA_EquippedItemSet_Selector_Title"	"Équipé"
"DOTA_OwnedItemSet_Available_Title"	"Disponible"
"DOTA_FeaturedItemSet_Selector_Title"	"Affiché"
"DOTA_AllItemSet_Selector_Title"	"Tous"
"DOTA_ConfirmLANLobby_title"	"SALLE LOCALE"
"DOTA_ConfirmLANLobby_desc"	"Une partie locale est hébergée sur votre machine. La configuration système requise est plus exigeante lorsque vous hébergez une partie locale."
"DOTA_ConfirmLANLobbyDisconnect_title"	"Quitter le lobby local ?"
"DOTA_ConfirmLANLobbyDisconnect_desc"	"Le lobby de cette partie est hébergée sur une machine, une déconnexion achèvera la partie de tous les joueurs, souhaitez-vous continuer ?"
"DOTA_ConfirmLANLobbyDisconnect_ok"	"Oui, se déconnecter"
"DOTA_Lobby_Settings_General"	"PARAMÈTRES GÉNÉRAUX DU LOBBY"
"DOTA_Lobby_Settings_Required"	"REQUIS"
"DOTA_Lobby_Settings_Confirm"	"{s:lobby_confirm_label}"
"DOTA_Lobby_Settings_Game_Mode"	"MODE DE JEU"
"DOTA_Lobby_Settings_Region"	"LOCALISATION DU SERVEUR"
"DOTA_Lobby_Settings_Password"	"MOT DE PASSE DU LOBBY"
"DOTA_Lobby_Settings_Game_Name"	"NOM DE LA PARTIE"
"DOTA_Lobby_Settings_Advanced"	"PARAMÈTRES AVANCÉS DU LOBBY"
"DOTA_Lobby_Settings_Competitive"	"COMPÉTITIF"
"DOTA_Lobby_Settings_Starting_Team"	"ÉQUIPE DE DÉPART"
"DOTA_Lobby_Settings_Starting_Team_Random"	"ALÉATOIRE"
"DOTA_Lobby_Settings_Starting_Team_Radiant"	"RADIANT"
"DOTA_Lobby_Settings_Starting_Team_Dire"	"DIRE"
"DOTA_Lobby_Settings_Penalty_Radiant"	"PÉNALITÉ - RADIANT"
"DOTA_Lobby_Settings_Penalty_Dire"	"PÉNALITÉ - DIRE"
"DOTA_Lobby_Settings_Penalty_Level_0"	"Aucune pénalité"
"DOTA_Lobby_Settings_Penalty_Level_1"	"-30 sec de phase de ban"
"DOTA_Lobby_Settings_Penalty_Level_2"	"-70 sec de phase de ban"
"DOTA_Lobby_Settings_Penalty_Level_3"	"-110 sec de phase de ban"
"DOTA_Lobby_Settings_Penalty_Tooltip"	"Lorsque vous êtes en Captain's Mode, cela réduit le nombre de secondes pour la phase de ban pour cette équipe."
"DOTA_Lobby_Settings_Series_Type"	"TYPE DE SÉRIES"
"DOTA_Lobby_Settings_No_Series"	"PAS DE SÉRIES"
"DOTA_Lobby_Settings_Series_Best_of_3"	"MEILLEUR DES 3"
"DOTA_Lobby_Settings_Series_Best_of_5"	"MEILLEUR DES 5"
"DOTA_Lobby_Settings_Gameplay_Rules"	"PARAMÈTRES DU GAMEPLAY"
"DOTA_Lobby_Settings_Enable_Cheats"	"ACTIVER LES CHEATS"
"DOTA_Lobby_Settings_All_Chat"	"CHAT GLOBAL"
"DOTA_Lobby_Settings_Fill_Bots"	"REMPLIR LES EMPLACEMENTS VIDES AVEC DES BOTS"
"DOTA_Lobby_Settings_Bot_Difficulty"	"DIFFICULTÉ DES BOTS"
"DOTA_Lobby_Settings_Bot_Difficulty_Passive"	"PASSIF"
"DOTA_Lobby_Settings_Bot_Difficulty_Easy"	"FACILE"
"DOTA_Lobby_Settings_Bot_Difficulty_Medium"	"MOYEN"
"DOTA_Lobby_Settings_Bot_Difficulty_Hard"	"DIFFICILE"
"DOTA_Lobby_Settings_Bot_Difficulty_Unfair"	"PAS JUSTE"
"DOTA_Lobby_Settings_Version"	"VERSION"
"DOTA_Lobby_Settings_Version_Latest"	"LE PLUS RÉCENT"
"DOTA_Lobby_Settings_Version_Tournament"	"TOURNOI"
"DOTA_Lobby_Settings_Spectator_Section"	"SPECTATEUR"
"DOTA_Lobby_Settings_Dota_TV_Delay"	"DOTA TV DELAY"
"DOTA_Lobby_Settings_Dota_TV_Delay_2_Minutes"	"2 minutes"
"DOTA_Lobby_Settings_Dota_TV_Delay_5_Minutes"	"5 minutes"
"DOTA_Lobby_Settings_Dota_TV_Delay_10_Seconds"	"10 secondes"
"DOTA_Lobby_Settings_Spectators"	"SPECTATEURS"
"DOTA_Lobby_Settings_Spectators_Enabled"	"ACTIVÉ"
"DOTA_Lobby_Settings_Spectators_Disabled"	"DÉSACTIVÉ"
"dota_lobby_settings_hide_password"	"Cacher le mot de passe"
"dota_lobby_settings_local_host"	"Hôte local"
"DOTA_Lobby_Settings_Visibility"	"Visibilité du lobby"
"DOTA_Lobby_Settings_Visibility_Public"	"Public"
"DOTA_Lobby_Settings_Visibility_Friends"	"Amis"
"DOTA_Lobby_Settings_Visibility_Unlisted"	"Non listé"
"DOTA_Lobby_Settings_Visibility_Tooltip"	"Contrôlez où vos lobbies peuvent être visibles. Les lobbies publiques sont visibles dans le navigateur de lobby, et dans la liste d'amis. Les lobbies amis sont visibles uniquement par les amis, à moins qu'un autre joueur ne soit invité. Les lobbies non listés ne sont ni visibles dans le navigateur, ni dans la liste d'amis."
"DOTA_TeamUnsetHeader"	"Équipe non sélectionnée"
"DOTA_TeamUnsetMessage"	"Au moins une des équipes n'a pas définie de nom d'équipe/logo. Lancer le match quand même ?"
"DOTA_LeagueUnsetHeader"	"Ligue non sélectionnée"
"DOTA_LeagueUnsetMessage"	"Aucune ligue n'est définie pour cette salle, vous pouvez toutefois en définir une. Souhaitez-vous vraiment lancer la partie ?"
"DOTA_LobbyAllowSpectatingHeader"	"Impossible de démarrer le lobby du match"
"DOTA_LobbyAllowSpectatingMessage"	"La partie doit être réglée sur observable tant qu'il y a des spectateurs dans le groupe. Activez le mode spectateur dans les Paramètres."
"dota_radiant"	"Le Radiant"
"dota_dire"	"Le Dire"
"dota_lobby_team_name_radiant"	"{s:team_name_good_guys}"
"dota_lobby_team_name_dire"	"{s:team_name_bad_guys}"
"dota_lobby_no_team"	"Pas d'équipe"
"dota_lobby_broadcast_default_channel_name"	"Nom du canal"
"dota_lobby_broadcast_join"	"Rejoindre"
"dota_lobby_broadcast_leave"	"Quitter"
"dota_lobby_broadcast_create"	"Créer un nouveau canal"
"dota_lobby_broadcast_no_channels"	"Aucun canal de diffusion n'a été créé"
"dota_popup_broadcast_channel_edit_title"	"Personnaliser le canal du diffuseur"
"dota_lobby_broadcast_default_channel_name_custom"	"{s:custom_title}"
"dota_popup_broadcast_channel_edit_channel_name"	"Titre de la chaine"
"dota_popup_broadcast_channel_edit_country"	"Pays"
"dota_popup_broadcast_channel_edit_language"	"Langue"
"dota_popup_broadcast_channel_edit_save"	"Sauvegarder en tant que paramètres par défaut et appliquer aux canaux vides lorsque vous rejoignez"
"DOTA_Lobby_Broadcaster_Channel_Other_Language"	"Autres langues"
"lobby_slot_error_header"	"Changement d'emplacement impossible"
"generic_gc_timeout"	"Le message a expiré."
"lobby_slot_success_header"	"Succès"
"lobby_slot_denied"	"Vous n'avez pas l'autorisation de rejoindre cet emplacement."
"lobby_slot_cameramanalready"	"Les canaux de commentateurs ne peuvent avoir qu'un seul caméraman."
"lobby_slot_cameramanon"	"Vous êtes maintenant signalé comme caméraman."
"lobby_slot_cameramanoff"	"Vous n'êtes plus caméraman."
"lobby_slot_error"	"Changement d'emplacement de salle non réussi."
"lobby_create_timeout"	"Échec de création de lobby"
"find_match_error"	"Matchmaking indisponible pour l'instant."
"DOTA_DialogVariableTest1"	"Simple : {s:var}"
"DOTA_DialogVariableTest2"	"Valeur de l'argent : {m:money}"
"DOTA_DialogVariableTest3"	"Lien de l'objet : {g:dota_item_link:item_def}"
"DOTA_DialogVariableTest4"	"Prix de l'objet : {g:dota_item_price:item_def}"
"DOTA_DialogVariableTest5"	"Nom d'identifiant de compte : {g:dota_persona:account_id}, nom pro : {g:g:dota_persona:pro:account_id}"
"DOTA_DialogVariableTest6"	"Simple avec span : <span class=\"TextSpan\">{s:var}</span>"
"LobbySetting_GameMode"	"Mode de jeu"
"LobbySetting_GameMode_Value"	"{s:lobbysetting_gamemode}"
"LobbySetting_Bots"	"Bots"
"LobbySetting_Bots_Value"	"{s:lobbysetting_bots}"
"LobbySetting_Password"	"Mot de passe"
"LobbySetting_Password_Value"	"{s:lobbysetting_password}"
"LobbySetting_Server"	"Serveur"
"LobbySetting_Server_Value"	"{s:lobbysetting_server}"
"LobbySetting_Cheats"	"Cheats"
"LobbySetting_Cheats_Value"	"{s:lobbysetting_cheats}"
"LobbySetting_Spectators"	"Spectateurs"
"LobbySetting_Spectators_Value"	"{s:lobbysetting_spectators}"
"LobbySetting_Visibility"	"Visibilité"
"LobbySetting_Visibility_Value"	"{s:lobbysetting_visibility}"
"dota_lobby_lan_title"	"Serveur local"
"dota_lobby_coaches_none"	"Coaches : Aucun"
"dota_lobby_coaches"	"Coaches :"
"DOTA_Custom_Game"	"Jeu custom"
"DOTA_Custom_Game_Info"	"Information"
"DOTA_Custom_Game_View_Details"	"Voir les détails de la partie"
"DOTA_Custom_Game_Author"	"par {g:dota_persona:author}"
"DOTA_Custom_Game_Lobby_Count"	"{d:lobby_count} lobby"
"DOTA_Custom_Game_Lobby_Count_Plural"	"{d:lobby_count} lobbies"
"DOTA_Custom_Game_Friend_Lobbies_Alert"	"Vous avez {d:friend_count} amis avec un lobby ouvert."
"DOTA_Custom_Game_Friend_Lobbies_Alert_Plural"	"Vous avez {d:friend_count} amis avec des lobbies ouverts."
"DOTA_Custom_Game_Quick_Join"	"Partie rapide"
"DOTA_Custom_Game_View_Lobbies"	"Voir les lobbys"
"DOTA_Custom_Game_Find_Lobby"	"Chercher un lobby"
"DOTA_Custom_Game_Create_Lobby"	"Créer un lobby"
"DOTA_Custom_Game_Game_Page"	"Page du jeu"
"DOTA_Custom_Game_Workshop_Page"	"Page du workshop"
"DOTA_Custom_Game_Download_Queued"	"Téléchargement en attente"
"DOTA_Custom_Game_Downloading"	"Téléchargement..."
"DOTA_Custom_Game_Downloading_Percent"	"Téléchargement - {d:lobby_download_percent}%"
"DOTA_Custom_Game_Needs_Update"	"Mise à jour nécessaire"
"DOTA_Custom_Game_Play"	"Jouer {s:game_mode_name}"
"DOTA_Custom_Game_Uninstall"	"Désinstaller"
"DOTA_Custom_Game_Install"	"Installer"
"DOTA_Custom_Game_Installed"	"Installé"
"DOTA_Custom_Game_Not_Installed"	"Non installé"
"DOTA_Custom_Game_Connect"	"Rejoindre le lobby"
"DOTA_Custom_Game_FileSize"	"{d:file_size} Mo"
"DOTA_Custom_Game_Name"	"{s:game_mode_name}"
"DOTA_Custom_Game_Released_By"	"Publié le {s:release_date}</b> Par <b>{g:dota_persona:author}</b>"
"DOTA_Custom_Game_Subscription"	"{s:subscriptions_count} Abonnements"
"DOTA_Custom_Game_Subscriptions"	"{s:subscriptions_count} Abonnés"
"DOTA_Custom_Game_Rating"	"Évaluation"
"DOTA_Custom_Game_Release_Date"	"Publié le"
"DOTA_Custom_Game_Playing_Now"	"{s:player_count} En cours de jeu"
"DOTA_Custom_Game_Ratings_Count"	"({d:ratings_count})"
"DOTA_Custom_Game_Description"	"{s:game_description}"
"DOTA_Custom_Game_Last_Updated"	"Mis à jour le {s:last_updated_date}"
"DOTA_Custom_Game_Update_Note_Title"	"{s:timestamp}"
"DOTA_Custom_Game_Screenshots"	"Captures d'écran"
"DOTA_Custom_Game_Map_Label"	"Carte"
"DOTA_Custom_Game_Map_Any"	"Tous"
"DOTA_Custom_Game_Update"	"Mettre à jour"
"DOTA_Custom_Game_Spectate"	"Spectateur"
"DOTA_Custom_Game_Already_In_Lobby"	"Terminez votre partie actuelle pour commencer ce mode de jeu."
"DOTA_Custom_Game_Friends_Playing"	"Amis dans des jeux customs"
"DOTA_Custom_Game_Friends_In_Lobbies"	"{d:friends_in_open_lobbies} dans des lobbies ouverts"
"DOTA_Custom_Game_Friends_In_Game"	"{d:friends_in_game} amis dans des jeux custom"
"DOTA_Custom_Games_Friends_Play"	"Jeux custom auquels vos amis ont joué"
"DOTA_Custom_Game_Invite_Friend"	"Inviter un ami"
"DOTA_Custom_Game_Tooltip_Subscribers"	"{d:subscriber_count} abonnés"
"DOTA_Custom_Game_Tooltip_Subscriber"	"{d:subscriber_count} abonné"
"DOTA_Custom_Game_Most_Popular"	"Les plus populaires"
"DOTA_Custom_Game_Installed_Games"	"Jeux installés"
"DOTA_Custom_Game_Favorite_Games"	"Montrer les favoris uniquement"
"DOTA_Custom_Game_Add_Favorite"	"Favoris"
"DOTA_Custom_Game_VotePrompt"	"Devrions-nous mettre ce jeu en avant ?"
"DOTA_Custom_Game_DetailsPrompt"	"Visitez la page du jeu pour en savoir plus, installer et jouer."
"DOTA_Custom_Game_Vote_Box_Title"	"Vote du Workshop"
"DOTA_Custom_Game_Vote_Box_Desc"	"Aidez les jeux inconnus à se faire connaître."
"DOTA_Custom_Game_Vote_Start"	"Commencer à voter"
"DOTA_Custom_Game_VoteThanks"	"Merci d'avoir voté !"
"DOTA_Custom_Game_Vote_PrevLabel"	"Partie précédente"
"DOTA_Custom_Game_Vote_NextLabel"	"Partie suivante"
"DOTA_Custom_Game_Vote_ControlsLabel"	"Vote du Workshop"
"DOTA_Custom_Game_Vote_YesLabel"	"Oui, faire la promotion !"
"DOTA_Custom_Game_Vote_NoLabel"	"Non, nécessite du travail."
"DOTA_Custom_Game_Vote_SkipLabel"	"Passer ce jeu, je n'ai rien eu."
"DOTA_Custom_Game_Vote_Up"	"Bien joué"
"DOTA_Custom_Game_Vote_Down"	"Nécessite du travail"
"Video_Support_Coming_Soon"	"Support vidéo prochainement disponible"
"DOTA_Custom_Game_Leave_Lobby"	"Quitter ce lobby"
"DOTA_Custom_Game_Suggested_Title"	"Parties suggérées"
"DOTA_Custom_Game_Search"	"Rechercher des parties customs"
"DOTA_Custom_Lobby_Create_Button"	"Créer un lobby personnalisé"
"DOTA_Custom_Lobby_Settings_Title"	"Créer un lobby"
"DOTA_Custom_Lobby_Settings_Mode"	"Mode de jeu"
"DOTA_Custom_Lobby_Settings_Map"	"Carte"
"DOTA_Custom_Lobby_LobbyName"	"Description optionnelle"
"DOTA_Custom_Lobby_List_Desc"	"Une liste de lobbies privés (protégés par un mot de passe) et de jeux customs actifs non-filtrés"
"DOTA_Custom_Lobby_Public"	"Public"
"DOTA_Custom_Lobby_Passworded"	"Les joueurs ne peuvent rejoindre ce lobby que grâce à une invitation ou en filtrant la liste des lobbies par mot de passe."
"DOTA_Custom_Lobby_Join_Failed_Title"	"Impossible de rejoindre"
"DOTA_Custom_Lobby_Join_Failed_Reason"	"{s:join_error}"
"DOTA_Custom_Lobby_Join_Failed_Prompt"	"Voulez-vous rechercher un lobby ouvert de {s:game_name} maintenant ?"
"DOTA_Lobby_Failed_Pings"	"Impossible de récupérer les informations sur le ping. Veuillez vérifier que votre connexion internet fonctionne et que les serveurs de Dota 2 sont en ligne."
"DOTA_Custom_Lobby_Create_Private_Button"	"Créer un lobby privé"
"DOTA_Custom_Lobby_Find_Private_Button"	"Rechercher un lobby privé"
"DOTA_Custom_Lobby_Find_Private_Title"	"Rechercher un lobby privé"
"DOTA_Custom_Lobby_Find_Private_Desc"	"Entrer un mot de passe pour retrouver un lobby privé"
"DOTA_Custom_Lobby_List_Game_Header"	"Partie"
"DOTA_Custom_Lobby_List_Name_Header"	"Description"
"DOTA_Custom_Lobby_List_Players_Header"	"Joueurs"
"DOTA_Custom_Lobby_List_Map_Header"	"Carte"
"DOTA_Custom_Lobby_List_Region_Header"	"Région"
"DOTA_Custom_Lobby_List_Connection_Header"	"Connexion"
"DOTA_Custom_Lobby_List_Status_Header"	"État local"
"DOTA_Custom_Lobby_List_Game"	"{s:lobby_game}"
"DOTA_Custom_Lobby_List_Lobby_Name"	"{s:lobby_name}"
"DOTA_Custom_Lobby_List_Players"	"{s:lobby_players} / {s:lobby_max_players}"
"DOTA_Custom_Lobby_List_Map"	"{s:lobby_map}"
"DOTA_Custom_Lobby_List_Region"	"{s:lobby_region}"
"DOTA_Custom_Lobby_List_Connection"	"..."
"DOTA_Custom_Lobby_List_Status"	"{s:lobby_status}"
"DOTA_Custom_Lobby_List_Connect"	"{s:connect_button_text}"
"DOTA_Custom_Lobby_Game_Name"	"{s:game_name}"
"DOTA_Custom_Lobby_Map_Name"	"Carte : {s:map_name}"
"DOTA_Custom_Lobby_Player_Count"	"Joueurs : {d:player_count} / {d:max_player_count}"
"DOTA_Custom_Lobby_Player_Count_Short"	"{d:player_count} / {d:max_player_count}"
"DOTA_Custom_Lobby_Visibility"	"Visibilité du lobby"
"DOTA_Custom_Join_Chat"	"Rejoindre le chat"
"DOTA_Custom_Join_Chat_Member_Count"	"({d:ChatMemberCount})"
"DOTA_Custom_Leave_Chat"	"Quitter le chat"
"DOTA_Custom_Game_Vote_Up_Tooltip"	"Cliquez pour voter pour ce jeu sur le Steam Workshop."
"DOTA_Page_Number"	"Page : {d:current_page} / {d:num_pages}"
"DOTA_TabName_ModsOverview"	"Vue d'ensemble"
"DOTA_TabName_ModsSubscribed"	"Bibliothèque"
"DOTA_TabName_ModsWorkshop"	"Workshop"
"DOTA_TabName_ModsBrowse"	"Parcourir"
"DOTA_WatchTabName_Live"	"En direct"
"DOTA_WatchTabName_Featured"	"Populaires"
"DOTA_WatchTabName_Replays"	"Rediffusions"
"DOTA_WatchTabName_Tournaments"	"Tournois"
"DOTA_WatchTabName_Downloads"	"Téléchargements"
"DOTA_WatchLive_Search"	"Rechercher des héros à regarder"
"DOTA_WatchLive_DataPending"	"Recherche de parties en direct ..."
"DOTA_WatchLive_DataError"	"Impossible de charger les parties en direct"
"DOTA_WatchLive_NoGames"	"Aucune partie en direct n'est en cours"
"DOTA_WatchLive_Connecting"	"En attente des données de la partie..."
"DOTA_WatchLive_HeroFilter"	"Filtre : {s:hero_filter_name}"
"DOTA_WatchLive_CountSpec"	"{i:num_spectating} spectateurs"
"DOTA_WatchLive_CountSpecFriend"	"{i:num_friends_spectating} ami et {i:num_spectating} spectateur"
"DOTA_WatchLive_CountSpecFriends"	"{i:num_friends_spectating} amis et {i:num_spectating} spectateurs"
"DOTA_WatchLive_CountFriends"	"{i:num_friends_playing} ami(s) en jeu"
"DOTA_WatchLive_ParticipantsVs"	"{s:team_1} vs {s:team_2}"
"DOTA_WatchLive_ParticipantsMMR"	"{i:mmr} MMR moyen"
"DOTA_WatchLive_ParticipantsUnranked"	"Non classé"
"DOTA_WatchLive_Participants1"	"{s:friend_1}"
"DOTA_WatchLive_Participants2"	"{s:friend_1} et {s:friend_2}"
"DOTA_WatchLive_Participants3"	"{s:friend_1}, {s:friend_2} et {s:friend_3}"
"DOTA_WatchLive_Participants4Plus"	"{s:friend_1}, {s:friend_2}, {s:friend_3}, et {i:friend_count_over_3} plus ..."
"DOTA_WatchLive_MatchType_MM_Kills"	"{s:game_mode}"
"DOTA_WatchLive_MatchType_MM"	"{s:game_mode}"
"DOTA_WatchLiveDotaTV"	"Regarder sur la DotaTV"
"DOTA_WatchLivePurchase"	"Obtenir un pass tournoi {g:dota_item_price:ticket_itemdef}"
"DOTA_WatchLiveSpectatorFriends1"	"{g:dota_persona:spectator_friend_1} regardent"
"DOTA_WatchLiveSpectatorFriends2"	"{g:dota_persona:spectator_friend_1} et {g:dota_persona:spectator_friend_2} regardent"
"DOTA_WatchLiveSpectatorFriends3"	"{g:dota_persona:spectator_friend_1}, {g:dota_persona:spectator_friend_2}, et {g:dota_persona:spectator_friend_3} regardent"
"DOTA_WatchLiveSpectatorFriends4Plus"	"{g:dota_persona:spectator_friend_1}, {g:dota_persona:spectator_friend_2}, {g:dota_persona:spectator_friend_3}, et {i:spectator_friend_count_over_3} autres amis regardent"
"DOTA_WatchLiveSpectatorCount"	"{i:spectator_count} regardent"
"DOTA_WatchLivePreGame"	"Avant-match"
"DOTA_WatchLive_ElapsedTime"	"Temps écoulé :"
"DOTA_WatchLive_Spectating"	"Spectateur :"
"DOTA_WatchReplays_TournamentsHeader"	"MATCHS POPULAIRES DE TOURNOI"
"DOTA_WatchReplays_FriendsHeader"	"MATCHS D'AMIS"
"DOTA_WatchReplays_Popular"	"MATCHS POPULAIRES"
"DOTA_WatchReplays_SavedForLater"	"SAUVEGARDÉ POUR VOIR PLUS TARD"
"DOTA_WatchReplays_ParticipantsVs"	"{s:team_1} vs {s:team_2}"
"DOTA_WatchReplays_MatchType_League"	"{s:league_name}"
"DOTA_WatchReplays_MatchType_Public"	"Match {s:match_id} - {s:game_mode}"
"DOTA_WatchReplays_Recommendations"	"{i:recommendations}"
"DOTA_WatchReplays_Recommendations1"	"{g:dota_persona:friend_1} + {i:recommendations}"
"DOTA_WatchReplays_Recommendations2"	"{g:dota_persona:friend_1}, {g:dota_persona:friend_2} + {i:recommendations}"
"DOTA_WatchReplays_Recommendations3Plus"	"{g:dota_persona:friend_1} + {i:friend_count_over_1} autres amis + {i:recommendations}"
"DOTA_WatchReplays_Friends1"	"{g:dota_persona:b:friend_1} a joué"
"DOTA_WatchReplays_Friends2"	"{g:dota_persona:b:friend_1} et {g:dota_persona:friend_2} ont joué"
"DOTA_WatchReplays_Friends3Plus"	"{g:dota_persona:b:friend_1}, {g:dota_persona:b:friend_2} et {i:friend_count_over_2} autres amis"
"DOTA_WatchReplays_Views"	"{i:views} vues"
"DOTA_WatchReplays_Price"	"{s:price}"
"DOTA_WatchReplays_SharedMatch"	"{g:dota_persona:shared_by} a partagé - '{s:shared_text}'"
"DOTA_WatchReplays_SharedHighlight"	"{g:dota_persona:shared_by} a partagé un moment fort"
"DOTA_WatchReplays_Duration"	"{s:minutes}:{s:seconds}"
"DOTA_WatchReplays_Tag"	"\"{s:recommendation_text}\""
"DOTA_WatchTournaments_FeaturedTitle"	"{s:tournament_featured_title}"
"DOTA_WatchTournaments_FeaturedDates"	"{s:tournament_featured_start} - {s:tournament_featured_end}"
"DOTA_WatchTournaments_FeaturedDescription"	"{s:tournament_featured_description}"
"DOTA_WatchTournaments_FeaturedTeams"	"Équipes"
"DOTA_WatchTournaments_PrizePool"	"Prize pool :"
"DOTA_WatchTournaments_PrizePoolAmt"	"{s:tournament_featured_prize_pool}"
"DOTA_WatchTournaments_Purchase"	"Pass tournoi - {s:tournament_featured_price}"
"DOTA_WatchTournament_TournamentName"	"{s:tournament_name}"
"DOTA_WatchTournament_Price"	"{s:price}"
"DOTA_Replays_Search"	"Rechercher des IDs de match"
"DOTA_Watch_GameStatus"	"Statut de la partie observée"
"DOTA_Watch_Pending"	"En attente pour regarder la partie..."
"DOTA_Watch_GameServerNotFound"	"Le serveur de jeu hébergeant cette partie n'a pas été trouvé."
"DOTA_Watch_Unavailable"	"Impossible de visionner la partie en ce moment."
"DOTA_Watch_LobbyNotFound"	"Salle non trouvée."
"DOTA_Watch_MissingLeagueSubscription"	"Cette partie est un match de ligue qui nécessite un abonnement pour être regardé."
"vs"	"VS"
"dota_matchmaking_language_title"	"Sélectionnez la langue du matchmaking"
"dota_matchmaking_language_primary_label"	"Votre langue principale de matchmaking est :"
"dota_matchmaking_language_primary"	"{s:environment_language}"
"dota_matchmaking_language_primary_invalid"	"Votre langue, {s:environment_language}, n'est pas disponible comme langue de matchmaking dans Dota 2."
"dota_matchmaking_language_select_secondary"	"Si vous le souhaitez, vous pouvez choisir une langue secondaire :"
"dota_matchmaking_language_select_primary"	"Veuillez sélectionner une langue de matchmaking :"
"dota_matchmaking_language_no_selection"	"Aucune sélection"
"dota_matchmaking_language_english"	"Anglais"
"dota_matchmaking_language_russian"	"Russe"
"dota_matchmaking_language_chinese"	"Chinois"
"dota_matchmaking_language_schinese"	"Chinois"
"dota_matchmaking_language_korean"	"Coréen"
"dota_matchmaking_language_koreana"	"Coréen"
"dota_matchmaking_language_spanish"	"Espagnol"
"dota_matchmaking_language_portuguese"	"Portugais"
"GameUI_Language_English"	"Anglais"
"GameUI_Language_German"	"Allemand"
"GameUI_Language_French"	"Français"
"GameUI_Language_Italian"	"Italien"
"GameUI_Language_Korean"	"Coréen"
"GameUI_Language_Spanish"	"Espagnol"
"GameUI_Language_Simplified_Chinese"	"Chinois simplifié"
"GameUI_Language_Traditional_Chinese"	"Chinois traditionnel"
"GameUI_Language_Russian"	"Russe"
"GameUI_Language_Thai"	"Thaï"
"GameUI_Language_Japanese"	"Japonais"
"GameUI_Language_Portuguese"	"Portugais"
"GameUI_Language_Polish"	"Polonais"
"GameUI_Language_Danish"	"Danois"
"GameUI_Language_Dutch"	"Néerlandais"
"GameUI_Language_Finnish"	"Finlandais"
"GameUI_Language_Norwegian"	"Norvégien"
"GameUI_Language_Swedish"	"Suédois"
"GameUI_Language_Hungarian"	"Hongrois"
"GameUI_Language_Czech"	"Tchèque"
"GameUI_Language_Romanian"	"Roumain"
"GameUI_Language_Turkish"	"Turc"
"GameUI_Language_Brazilian"	"Portugais du Brésil"
"GameUI_Language_Bulgarian"	"Bulgare"
"GameUI_Language_Greek"	"Grec"
"GameUI_Language_Ukrainian"	"Ukrainien"
"client_version_out_of_date_title"	"Mise à jour requise"
"client_version_out_of_date"	"Le client du jeu n'est pas à jour. Veuillez fermer puis relancer Dota 2 pour obtenir la dernière version."
"dota_matchmaking_region_title"	"Régions du matchmaking"
"dota_matchmaking_region_auto"	"Choix automatique de la meilleure région selon ma localisation."
"dota_matchmaking_region_select"	"Choisissez jusqu'à 3 régions de matchmaking. Sélectionnez uniquement les régions les plus proches de vous pour un meilleur confort de jeu."
"limited_heroes_abandon_header"	"Mode Limited Heroes"
"limited_heroes_abandon_explanation"	"Abandonner un match en mode Limited Heroes n'entraîne pas de pénalité car votre héros sera remplacé par un bot. Abandonner un autres modes de jeu peut conduire à une sanction résultant à un placement dans la file d'attente basse priorité."
"dota_abandon_dialog_title"	"Abandonner la partie"
"dota_abandon_dialog_confirm"	"Voulez-vous vraiment abandonner cette partie ?"
"dota_abandon_dialog_yes"	"Oui, abandonner la partie."
"dota_leave_dialog_title"	"Quitter la partie"
"dota_leave_dialog_confirm"	"Êtes-vous sûr de vouloir quitter cette partie ?"
"dota_leave_dialog_yes"	"Oui, quitter la partie."
"dota_accept_match_title"	"Votre partie est prête"
"dota_accept_match_readyup_title"	"En attente de joueurs"
"dota_accept_match_accept"	"Accepter"
"dota_accept_match_accept_low_pri"	"Accepter les matchs basse priorité"
"dota_accept_match_accept_button"	"{s:accept}"
"dota_accept_match_decline"	"Refuser"
"dota_accept_match_subtitle"	"{s:subtitle}"
"dota_finding_match_players"	"(%s1 recherches)"
"dota_finding_match_time"	"Temps d'attente estimé : {s:find_match_time}"
"dota_finding_match_accept_count"	"Match accepté : {s:match_num_accepted} / {s:match_num_total}"
"dota_finding_match_generic"	"Partie normale"
"dota_finding_match_ranked"	"Partie classée"
"dota_finding_match_bot"	"Partie avec des Bots"
"dota_finding_match_bot_passive"	"Match avec bots (passifs)"
"dota_finding_match_bot_easy"	"Match avec bots (faciles)"
"dota_finding_match_bot_medium"	"Match avec bots (moyens)"
"dota_finding_match_bot_hard"	"Match avec bots (difficiles)"
"dota_finding_match_bot_unfair"	"Match avec bots (injustes)"
"dota_finding_match_team"	"Partie avec classement d'équipe"
"dota_finding_1v1_match_casual"	"Match 1v1"
"dota_finding_match_practice_lobby"	"Lobby du match"
"dota_safe_to_abandon_inline"	"La partie peut être quittée sans risque"
"dota_match_connected"	"Connecté à la partie"
"dota_match_local_game"	"Connecté à une partie locale"
"dota_match_connecting"	"En cours de connexion à la partie..."
"dota_match_in_progress"	"Partie en cours"
"dota_match_finished"	"La partie est terminée"
"matchmaking_waiting_for_players"	"En attente des autres joueurs"
"matchmaking_player_declined"	"Un joueur a refusé le match"
"dota_match_wait_for_host"	"En attente de l'hôte"
"dota_match_find_server"	"Recherche de serveur"
"ranked_disabled"	"Le matchmaking classé est temporairement désactivé."
"ranked_mmr"	"Votre rang de matchmaking"
"ranked_mmr_solo_label"	"Solo"
"ranked_mmr_solo_value"	"{i:solo_mmr}"
"ranked_mmr_solo_calibrating"	"AD - {i:solo_calibrating_games} parties restantes"
"ranked_mmr_solo_no_data"	"{i:solo_calibrating_required_games} parties nécessaires pour la calibration"
"ranked_mmr_party_label"	"Groupe"
"ranked_mmr_party_value"	"{i:party_mmr}"
"ranked_mmr_party_calibrating"	"AD - {i:party_calibrating_games} parties restantes"
"ranked_mmr_party_no_data"	"{i:party_calibrating_required_games} parties nécessaires pour la calibration"
"matchmaking_account_disabled"	"Vous avez été trop perturbateur et ne serez pas autorisés à utiliser le chat ou à rejoindre le matchmaking. Temps restant : {t:r:match_denied_time}"
"matchmaking_match_disabled_party"	"{s:match_denied_player_name} empêchera la recherche d'un match car il ou elle a abandonné(e) ou n'a pas été prêt(e) à temps lors de sa dernière partie. Temps restant : {t:r:match_denied_time}"
"matchmaking_low_priority_party"	"{s:match_denied_player_name}  n'a accès qu'au matchmaking basse priorité à cause de parties abandonnées ou d'un nombre excessif de signalements. Temps restant : {d:match_denied_games}"
"matchmaking_match_disabled_local"	"Vous ne pouvez pas participer à un match car vous avez abandonné ou n'avez pas été prêt à temps lors de votre dernière partie. Temps restant : {t:r:match_denied_time}"
"matchmaking_low_priority_local"	"Vous n'aurez accès qu'au matchmaking basse priorité à cause de parties abandonnées ou d'un nombre excessif de signalements. Temps restant : {d:match_denied_games}"
"dota_ready_up_count"	"{s:ready_up_ready} / {s:ready_up_lobby_members}"
"dota_play_normal_match"	"Match normal"
"dota_play_ranked_match"	"Match classé"
"dota_play_practice_1v1"	"Entrainement 1v1"
"dota_play_practice_with_bots"	"Entraînement avec des bots"
"dota_play_practice_1v1_playtab"	"ENTRAINEMENT 1v1"
"dota_play_1v1_desc"	"Entraînez-vous à jouer en position midlane contre un autre joueur. 
L'entrainement prend fin quand un joueur meurt deux fois ou perd une tour."
"dota_play_practice_1v1_party_warning"	"Les groupes ne sont pas autorisés en matchmaking 1v1"
"dota_play_button_label"	"{s:play_button_label}"
"dota_play"	"Jouer à Dota"
"dota_play_searching"	"Recherche de match"
"dota_play_connecting"	"Chargement de l'hôte..."
"dota_play_lobby_find_server"	"Recherche de serveur"
"dota_play_find_match_label"	"{s:find_match_label}"
"dota_reconnect"	"Reconnexion"
"dota_abandon_game"	"Abandon"
"dota_safe_leave_game"	"Quitter la partie"
"dota_disconnect"	"Se déconnecter"
"dota_play_unavailable"	"Indisponible"
"dota_leaver_consequence_tooltip_header"	"Conséquences"
"dota_leaver_consequences"	"{s:leaver_consequences}"
"dota_leaver_consequences_details"	"{s:leaver_consequences_details}"
"dota_leaver_view_tooltip"	"Voir les détails"
"dota_leaver_consequence_header_failure_to_reconnect"	"Ne pas se reconnecter entraînera les conséquences suivantes :"
"dota_leaver_consequence_header_leave_match"	"Quitter ce match entraînera des conséquences négatives"
"dota_leaver_consequence_LetDownTeammates"	"Vos coéquipiers joueront avec un désavantage."
"dota_leaver_consequence_SmallMatchmakingCooldown"	"Vous perdrez accès au matchmaking pendant un certain temps."
"dota_leaver_consequence_CreditWithAbandon"	"Vous recevrez un abandon."
"dota_leaver_consequence_ForcedLossForLeaver"	"Vous recevrez une défaite."
"dota_leaver_consequence_ForcedLossForLeaversParty"	"Tous les membres de votre groupe recevront une défaite."
"dota_leaver_consequence_ForcedLossForLeaversTeam"	"<b>Votre équipe</b>, %s1, va recevoir une défaite."
"dota_leaver_consequence_MMRLossForLeaver"	"Votre MMR diminuera."
"dota_leaver_consequence_MMRLossForLeaversParty"	"Le MMR de tous les membres de votre groupe diminuera."
"dota_leaver_consequence_MMRLossForLeaversTeam"	"Le MMR de votre équipe, %s1, diminuera."
"dota_leaver_consequence_MatchDiscardedForOtherPlayers"	"Le match ne comptera pas pour les autres joueurs."
"dota_leaver_consequence_NotDecrementLowPriGamesRemaining"	"Vous ne serez pas crédité comme ayant terminé le match."
"dota_reconnect_popup_title"	"Se reconnecter ?"
"dota_matchmaking_regions_refresh"	"Rafraichir les pings"
"dota_matchmaking_region_ping"	"{s:region_ping}"
"dota_matchmaking_region_offline"	"Hors-ligne, maintenance en cours"
"dota_matchmaking_region_unknown_ping"	"Ping : Inconnu"
"dota_matchmaking_region_ping_time"	"Ping : {i:ping_ms}ms"
"DOTA_VAC_Verification_Header"	"Valve Anti-triche (VAC)"
"DOTA_VAC_Verification_Header_Solo"	"Impossible de rejoindre le matchmaking car un problème lié à votre ordinateur bloque le système VAC. Veuillez vous assurer que vous n'utilisez aucun programme pouvant interférer avec VAC et vérifier que Steam est correctement installé."
"DOTA_VAC_Verification_Header_Party"	"Impossible de rejoindre le matchmaking car un problème lié à votre ordinateur bloque le système VAC, pour un ou plus des membre de groupe. Veuillez vous assurer que vous n'utilisez aucun programme pouvant interférer avec VAC et vérifier que Steam est correctement installé."
"DOTA_VAC_Verification_Button1"	"Plus d'infos"
"DOTA_VAC_Verification_Button2"	"Fermer"
"dota_matchmaking_regions_button"	"{s:regions_selected}"
"dota_region_automatic"	"Région : Auto"
"dota_regions_selected"	"Régions : "
"dota_lobby_region_invalid"	"Aucunes"
"dota_play_no_language_selected"	"SÉLECTIONNER LA LANGUE"
"dota_play_language"	"{s:match_language}"
"dota_play_language_many"	"LANGUES : {i:match_language_count}"
"dota_ready_fail"	"ÉCHEC DE PRÉSENCE"
"dota_ready_fail_desc"	"Votre match était prêt, mais vous n'avez pas répondu et avez été retiré de la sélection."
"dota_all_chat_label"	"[TOUS]"
"dota_chatwheel_label_Ok"	"OK"
"dota_chatwheel_label_Care"	"Attention"
"dota_chatwheel_label_GetBack"	"Repliez-vous"
"dota_chatwheel_label_NeedWards"	"Besoin de Wards"
"dota_chatwheel_label_Stun"	"Stun"
"dota_chatwheel_label_Help"	"À l'aide"
"dota_chatwheel_label_Push"	"Push"
"dota_chatwheel_label_GoodJob"	"Bien joué"
"dota_chatwheel_label_Missing"	"Absence (ss)"
"dota_chatwheel_label_Missing_Top"	"Absence haut (ss top)"
"dota_chatwheel_label_Missing_Mid"	"Absence milieu (ss mid)"
"dota_chatwheel_label_Missing_Bottom"	"Absence bas (ss bot)"
"dota_chatwheel_label_Go"	"Go !"
"dota_chatwheel_label_Initiate"	"Engagez !"
"dota_chatwheel_label_Follow"	"Suivez-moi"
"dota_chatwheel_label_Group_Up"	"Rassemblement !"
"dota_chatwheel_label_Spread_Out"	"Dispersion !"
"dota_chatwheel_label_Split_Farm"	"Split farm"
"dota_chatwheel_label_Attack"	"Attaquez !"
"dota_chatwheel_label_BRB"	"Je reviens"
"dota_chatwheel_label_Dive"	"Attaquez-les sous leur tour !"
"dota_chatwheel_label_OMW"	"J'arrive"
"dota_chatwheel_label_Get_Ready"	"Préparez-vous"
"dota_chatwheel_label_Bait"	"Appât (Bait)"
"dota_chatwheel_label_Heal"	"Soin"
"dota_chatwheel_label_Mana"	"Mana"
"dota_chatwheel_label_OOM"	"Mana insuffisant"
"dota_chatwheel_label_Skill_Cooldown"	"Cooldown"
"dota_chatwheel_label_Ulti_Ready"	"Ulti prêt"
"dota_chatwheel_label_Enemy_Returned"	"Ennemi revenu"
"dota_chatwheel_label_All_Missing"	"Tous absents"
"dota_chatwheel_label_Enemy_Incoming"	"L'ennemi arrive"
"dota_chatwheel_label_Invis_Enemy"	"Ennemi invisible"
"dota_chatwheel_label_Enemy_Had_Rune"	"L'ennemi a la rune"
"dota_chatwheel_label_Split_Push"	"Split push"
"dota_chatwheel_label_Coming_To_Gank"	"J'arrive pour gank"
"dota_chatwheel_label_Request_Gank"	"Demande de gank"
"dota_chatwheel_label_Fight_Under_Tower"	"Combat sous la tour"
"dota_chatwheel_label_Deny_Tower"	"Deny la tour"
"dota_chatwheel_label_Buy_Courier"	"Achat coursier"
"dota_chatwheel_label_Upgrade_Courier"	"Amélioration coursier"
"dota_chatwheel_label_Need_Detection"	"Besoin de détection"
"dota_chatwheel_label_They_Have_Detection"	"Ils ont des moyens de détection"
"dota_chatwheel_label_Buy_TP"	"Achetez un TP"
"dota_chatwheel_label_Reuse_Courier"	"Réutilisation du coursier"
"dota_chatwheel_label_Deward"	"Détruisez leurs Wards"
"dota_chatwheel_label_Building_Mek"	"Je fabrique un Mek"
"dota_chatwheel_label_Building_Pipe"	"Je fabrique une Pipe"
"dota_chatwheel_label_Stack_And_Pull"	"Stack et pull"
"dota_chatwheel_label_Pull"	"Pull les creeps"
"dota_chatwheel_label_Pulling"	"Je pull les creeps"
"dota_chatwheel_label_Stack"	"Stack les neutres"
"dota_chatwheel_label_Jungling"	"Jungle"
"dota_chatwheel_label_Roshan"	"Roshan"
"dota_chatwheel_label_Affirmative"	"Affirmatif"
"dota_chatwheel_label_Wait"	"Attendez"
"dota_chatwheel_label_Pause"	"Pause"
"dota_chatwheel_label_Current_Time"	"Temps actuel"
"dota_chatwheel_label_Check_Runes"	"Vérifiez les runes"
"dota_chatwheel_label_Smoke_Gank"	"Smoke gank !"
"dota_chatwheel_label_GLHF"	"GLHF"
"dota_chatwheel_label_Nice"	"Génial"
"dota_chatwheel_label_Thanks"	"Merci"
"dota_chatwheel_label_Sorry"	"Désolé"
"dota_chatwheel_label_No_Give_Up"	"N'abandonnez pas"
"dota_chatwheel_label_Just_Happened"	"Ça vient juste d'arriver"
"dota_chatwheel_label_Game_Is_Hard"	"Partie difficile"
"dota_chatwheel_label_New_Meta"	"Nouvelle méta"
"dota_chatwheel_label_My_Bad"	"C'est ma faute"
"dota_chatwheel_label_Regret"	"Regret"
"dota_chatwheel_label_Relax"	"Du calme"
"dota_chatwheel_label_GG"	"GG"
"dota_chatwheel_label_GGWP"	"GGWP"
"dota_chatwheel_label_All_GG"	"(Tous) GG"
"dota_chatwheel_label_All_GGWP"	"(Tous) GGWP"
"dota_chatwheel_label_What_To_Buy"	"Que faudrait-il acheter ?"
"dota_chatwheel_label_Im_Retreating"	"Je me replie"
"dota_chatwheel_label_Space_Created"	"Espace créé"
"dota_chatwheel_label_Whoops"	"Oups"
"dota_chatwheel_label_Tower_then_Back"	"Tour puis repli"
"dota_chatwheel_label_Barracks_then_Back"	"Casernes puis repli"
"dota_chatwheel_label_Ward_Bottom_Rune"	"Ward rune du bas"
"dota_chatwheel_label_Ward_Top_Rune"	"Ward rune du haut"
"dota_chatwheel_label_Zeus_Ult"	"Ult de Zeus"
"dota_chatwheel_header_positioning"	"Placement"
"dota_chatwheel_header_status"	"État"
"dota_chatwheel_header_enemy"	"Ennemi"
"dota_chatwheel_header_lane"	"Lane"
"dota_chatwheel_header_items"	"Objets"
"dota_chatwheel_header_neutrals"	"Neutres"
"dota_chatwheel_header_misc"	"Divers"
"dota_chatwheel_header_flavor"	"Ambiance"
"dota_chatwheel_message_Ok"	"OK."
"dota_chatwheel_message_Care"	"Attention !"
"dota_chatwheel_message_GetBack"	"Repliez-vous !"
"dota_chatwheel_message_NeedWards"	"Il nous faut des wards."
"dota_chatwheel_message_Stun"	"Stun-le !"
"dota_chatwheel_message_Help"	"À l'aide !"
"dota_chatwheel_message_Push"	"Push maintenant !"
"dota_chatwheel_message_GoodJob"	"Bien joué !"
"dota_chatwheel_message_Missing"	"Héros absent ! (ss)"
"dota_chatwheel_message_Missing_Top"	"Héros absent du haut ! (ss top)"
"dota_chatwheel_message_Missing_Mid"	"Héros absent du milieu ! (ss mid)"
"dota_chatwheel_message_Missing_Bottom"	"Héros absent du bas ! (ss bot)"
"dota_chatwheel_message_Go"	"Go !"
"dota_chatwheel_message_Initiate"	"Engagez le combat !"
"dota_chatwheel_message_Follow"	"Suivez-moi"
"dota_chatwheel_message_Group_Up"	"Rassemblons-nous"
"dota_chatwheel_message_Spread_Out"	"Dispersons-nous"
"dota_chatwheel_message_Split_Farm"	"Séparons-nous et farmons"
"dota_chatwheel_message_Attack"	"Attaquez !"
"dota_chatwheel_message_BRB"	"Je reviens dans un instant"
"dota_chatwheel_message_Dive"	"Attaquez-les sous leur tour !"
"dota_chatwheel_message_OMW"	"J'arrive"
"dota_chatwheel_message_Get_Ready"	"Préparez-vous"
"dota_chatwheel_message_Bait"	"Appâtez-le(s)"
"dota_chatwheel_message_Heal"	"Soignez-moi"
"dota_chatwheel_message_Mana"	"Mana"
"dota_chatwheel_message_OOM"	"Je suis à court de mana"
"dota_chatwheel_message_Skill_Cooldown"	"Mes capacités en cooldown"
"dota_chatwheel_message_Ulti_Ready"	"Mon sort Ultime est prêt"
"dota_chatwheel_message_Enemy_Returned"	"L'ennemi est revenu"
"dota_chatwheel_message_All_Missing"	"Tous les héros ennemis sont absents !"
"dota_chatwheel_message_Enemy_Incoming"	"Ennemi en approche !"
"dota_chatwheel_message_Invis_Enemy"	"Ennemi invisible à proximité !"
"dota_chatwheel_message_Enemy_Had_Rune"	"L'ennemi a la Rune"
"dota_chatwheel_message_Split_Push"	"Séparons-nous pour push"
"dota_chatwheel_message_Coming_To_Gank"	"J'arrive pour tendre une embuscade"
"dota_chatwheel_message_Request_Gank"	"Besoin d'un gank"
"dota_chatwheel_message_Fight_Under_Tower"	"Combattez sous la tour"
"dota_chatwheel_message_Deny_Tower"	"Deny la tour !"
"dota_chatwheel_message_Buy_Courier"	"Achetez un coursier svp"
"dota_chatwheel_message_Upgrade_Courier"	"Pouvez-vous augmenter la capacité du coursier ?"
"dota_chatwheel_message_Need_Detection"	"Nous avons besoin de moyen de détection"
"dota_chatwheel_message_They_Have_Detection"	"Ils ont des moyens de détection"
"dota_chatwheel_message_Buy_TP"	"Achetez un Teleport Scroll"
"dota_chatwheel_message_Reuse_Courier"	"Réutilisez le coursier"
"dota_chatwheel_message_Deward"	"Détruisez leurs Wards svp"
"dota_chatwheel_message_Building_Mek"	"Je fabrique un Mekansm"
"dota_chatwheel_message_Building_Pipe"	"Je fabrique une Pipe of Insight"
"dota_chatwheel_message_Stack_And_Pull"	"Stack et pull svp"
"dota_chatwheel_message_Pull"	"Pull les creeps svp"
"dota_chatwheel_message_Pulling"	"Je pull les creeps"
"dota_chatwheel_message_Stack"	"Stack les neutres"
"dota_chatwheel_message_Jungling"	"Jungle"
"dota_chatwheel_message_Roshan"	"Roshan"
"dota_chatwheel_message_Affirmative"	"Affirmatif"
"dota_chatwheel_message_Wait"	"Attendez"
"dota_chatwheel_message_Pause"	"Pause svp !"
"dota_chatwheel_message_Current_Time"	"Temps actuel de la partie"
"dota_chatwheel_message_Check_Runes"	"Vérifiez les runes svp"
"dota_chatwheel_message_Smoke_Gank"	"Tendons une embuscade avec une Smoke !"
"dota_chatwheel_message_GLHF"	"Good Luck, Have Fun"
"dota_chatwheel_message_Nice"	"Génial"
"dota_chatwheel_message_Thanks"	"Merci !"
"dota_chatwheel_message_Sorry"	"Désolé"
"dota_chatwheel_message_No_Give_Up"	"N'abandonnez pas !"
"dota_chatwheel_message_Just_Happened"	"Ça vient juste d'arriver"
"dota_chatwheel_message_Game_Is_Hard"	"C'est trop dur !"
"dota_chatwheel_message_New_Meta"	"Nouvelle méta"
"dota_chatwheel_message_My_Bad"	"C'est ma faute"
"dota_chatwheel_message_Regret"	"Je regrette déjà ce choix"
"dota_chatwheel_message_Relax"	"Du calme, tu t'en sors bien"
"dota_chatwheel_message_MissingHero"	"%s1 est absent !"
"dota_chatwheel_message_ReturnedHero"	"%s1 est de retour !"
"dota_chatwheel_message_GG"	"Good game"
"dota_chatwheel_message_GGWP"	"Good game, bien joué"
"dota_chatwheel_message_All_GG"	"Bon jeu"
"dota_chatwheel_message_All_GGWP"	"Bonne partie, bien joué"
"dota_chatwheel_message_What_To_Buy"	"Que devrais-je acheter ?"
"dota_chatwheel_message_Im_Retreating"	"Je me replie"
"dota_chatwheel_message_Space_Created"	"Ça a créé de l'espace"
"dota_chatwheel_message_Whoops"	"Oups"
"dota_chatwheel_message_Tower_then_Back"	"Détruisez la tour puis repliez-vous"
"dota_chatwheel_message_Barracks_then_Back"	"Détruisez les casernes puis repliez-vous"
"dota_chatwheel_message_Ward_Bottom_Rune"	"Une ward pour la rune du bas svp"
"dota_chatwheel_message_Ward_Top_Rune"	"Une ward pour la rune du haut svp"
"dota_chatwheel_message_Zeus_Ult"	"Zeus Ult maintenant !"
"dota_settings_hotkeys"	"Raccourcis"
"dota_settings_options"	"Options"
"dota_settings_audio"	"AUDIO"
"dota_settings_voice"	"Voix"
"dota_settings_volume"	"Volume"
"dota_settings_video"	"VIDÉO"
"dota_settings_resetkeys"	"Réinitialiser les raccourcis..."
"dota_settings_legacykeys"	"Utiliser les touches classiques"
"dota_settings_abilities"	"Capacités"
"dota_settings_abilities_hero"	"Héros"
"dota_settings_abilities_neutrals"	"Neutres"
"dota_settings_abilities_courier"	"Coursier"
"dota_settings_abilities_primary1"	"1"
"dota_settings_abilities_primary2"	"2"
"dota_settings_abilities_primary3"	"3"
"dota_settings_abilities_secondary1"	"4"
"dota_settings_abilities_secondary2"	"5"
"dota_settings_abilities_neutral1"	"1"
"dota_settings_abilities_neutral2"	"2"
"dota_settings_abilities_neutral3"	"3"
"dota_settings_abilities_neutral4"	"4"
"dota_settings_abilities_courier1"	"1"
"dota_settings_abilities_courier2"	"2"
"dota_settings_abilities_courier3"	"3"
"dota_settings_abilities_courier4"	"4"
"dota_settings_abilities_courier5"	"5"
"dota_settings_abilities_courier6"	"6"
"dota_settings_abilities_ultimate"	"U"
"dota_settings_cast"	"Utilisation"
"dota_settings_autocast"	"Utilisation auto."
"dota_settings_quickcast"	"Utilisation rapide"
"dota_settings_mirror"	"Touches identiques au panneau Héros"
"dota_settings_abilitylearn"	"Acquérir une capacité"
"dota_settings_upgradestats"	"Améliorer les statistiques"
"dota_settings_unitactions"	"Actions d'unités"
"dota_settings_attack"	"Attaquer / Forcer attaque"
"dota_settings_move"	"Mouvement"
"dota_settings_stop"	"Fermer"
"dota_settings_holdposition"	"Tenir la position"
"dota_settings_selecthero"	"Sélectionner le héros"
"dota_settings_selectall"	"Sélectionner toutes les unités"
"dota_settings_selectallothers"	"Sélectionner les autres unités"
"dota_settings_selectcourier"	"Sélectionner le coursier"
"dota_settings_courierdeliver"	"Livraison des objets par le coursier"
"dota_settings_courierhaste"	"Pointe de vitesse (Coursier)"
"dota_settings_useactionitem"	"Objet d'action"
"dota_settings_herotaunt"	"Item de raillerie"
"dota_settings_items"	"Objets"
"dota_settings_openshop"	"Ouvrir l'échoppe"
"dota_settings_purchasequickbuy"	"Achat rapide"
"dota_settings_purchasesticky"	"Acheter l'objet pré-sélectionné"
"dota_settings_grabstashitems"	"Prendre les objets de la réserve"
"dota_settings_camera"	"Caméra"
"dota_settings_cameraactions"	"Actions de la caméra"
"dota_settings_cameraup"	"Caméra en avant"
"dota_settings_cameradown"	"Caméra en arrière"
"dota_settings_cameraleft"	"Caméra vers la gauche"
"dota_settings_cameraright"	"Caméra vers la droite"
"dota_settings_cameragrip"	"Contrôler la caméra"
"dota_settings_recentevent"	"Afficher les évènements récents"
"dota_settings_inspectheroinworld"	"Vue showcase"
"dota_settings_chat"	"Chat"
"dota_settings_phrases"	"Phrases"
"dota_settings_chatwheel_page"	"Roue des dialogues"
"dota_settings_chatteam"	"Message à l'équipe"
"dota_settings_chatglobal"	"Message général"
"dota_settings_chatvoice_party"	"Communications audio (groupe)"
"dota_settings_chatvoice_team"	"Voix (équipe)"
"dota_settings_chatwheel_show"	"Roue des dialogues"
"dota_settings_playeractions"	"Actions du joueur"
"dota_settings_activateglyph"	"Activer le glyphe"
"dota_settings_scoreboardtoggle"	"Tableau des scores"
"dota_settings_pause"	"Pause"
"dota_settings_screenshot"	"Captures d'écran"
"dota_settings_console"	"Console"
"dota_settings_controlgroups"	"Contrôle de groupes"
"dota_settings_controlgroupsadditional"	"Contrôles de groupes additionnels"
"dota_settings_controlgroupcycle"	"Faire défiler les unités"
"dota_settings_group1"	"Groupe 1"
"dota_settings_group2"	"Groupe 2"
"dota_settings_group3"	"Groupe 3"
"dota_settings_group4"	"Groupe 4"
"dota_settings_group5"	"Groupe 5"
"dota_settings_group6"	"Groupe 6"
"dota_settings_group7"	"Groupe 7"
"dota_settings_group8"	"Groupe 8"
"dota_settings_group9"	"Groupe 9"
"dota_settings_group10"	"Groupe 10"
"dota_settings_advancedpanel_goto"	"Avancé"
"dota_settings_standardpanel_goto"	"Standard"
"dota_settings_spectatorandreplay"	"Spectateur / Contrôles rediffusion"
"dota_settings_spectatorandreplay_pt2"	"Spectateur / Contrôles rediffusion - Suite"
"dota_settings_spectatorcameraup"	"Caméra en avant (Spectateur)"
"dota_settings_spectatorcameradown"	"Caméra en arrière (Spectateur)"
"dota_settings_spectatorcameraleft"	"Caméra vers la gauche (Spectateur)"
"dota_settings_spectatorcameraright"	"Caméra vers la droite (Spectateur)"
"dota_settings_spectatorcameragrip"	"Contrôler la caméra (Spectateur)"
"dota_settings_spectatorpause"	"Pause spectateur"
"dota_settings_spectatorchat"	"Chat spectateur"
"dota_settings_spectatorscoreboard"	"Tableau des scores spectateur"
"dota_settings_spectatorbroadcastermenu"	"Ouvrir le menu de commentateur"
"dota_settings_spectatorincreasereplayspeed"	"Augmenter la vitesse de la rediffusion"
"dota_settings_spectatordecreasereplayspeed"	"Diminuer la vitesse de la rediffusion"
"dota_settings_spectatorstatsharvest"	"Statistiques des gains (Spectateur)"
"dota_settings_spectatorstatsitem"	"Statistiques des objets (Spectateur)"
"dota_settings_spectatorstatsgold"	"Graphique de l'or (Spectateur)"
"dota_settings_spectatorstatsxp"	"Graphique de l'expérience (Spectateur)"
"dota_settings_spectatorstatsfantasy"	"Statistiques fantasy (Spectateur)"
"dota_settings_spectatorfowboth"	"Brouillard des deux équipes (Spectateur)"
"dota_settings_spectatorfowradient"	"Brouillard du Radiant (Spectateur)"
"dota_settings_spectatorfowdire"	"Brouillard du Dire (Spectateur)"
"dota_settings_statsdropdown"	"Stats déroulantes"
"dota_settings_spectatordropdown_sort"	"Modifier le tri"
"dota_settings_spectatordropdown_close"	"Supprimer la catégorie"
"dota_settings_spectatordropdown_kda"	"Kills/Deaths/Assists"
"dota_settings_spectatordropdown_lasthits_denies"	"Last Hits/Denies"
"dota_settings_spectatordropdown_level"	"Niveau du héros"
"dota_settings_spectatordropdown_xp_per_min"	"XP par minute"
"dota_settings_spectatordropdown_gold"	"Or actuel"
"dota_settings_spectatordropdown_totalgold"	"Valeur nette"
"dota_settings_spectatordropdown_gold_per_min"	"Or par minute"
"dota_settings_spectatordropdown_buyback"	"Statut des rachats"
"dota_settings_spectatordropdown_fantasy"	"Scores fantasy"
"dota_settings_coaching"	"Coaching"
"dota_settings_spectatorcoach_viewtoggle"	"Activer/désactiver la vue élève (Coach)"
"dota_settings_keyboardtemplate"	"Choisir un modèle de clavier"
"dota_settings_or"	"ou"
"dota_settings_cancel"	"Annuler"
"dota_settings_apply"	"Valider"
"dota_settings_game"	"Partie"
"dota_settings_autoattack"	"Attaque automatique"
"dota_settings_attackafterspell"	"Attaque automatique après utilisation de compétence"
"dota_settings_autopurchase"	"Achat automatique des objets"
"dota_settings_autoselect"	"Auto-sélection des invocations"
"dota_settings_doubletapself"	"Raccourci pour utiliser sur soi"
"dota_settings_unifiedorders"	"Ordres globaux aux unités"
"dota_settings_teleportrequireshalt"	"Vous devez être à l'arrêt pour vous téléporter"
"dota_settings_herofinder"	"Montrer le héros (Touche Alt)"
"dota_settings_alwaysshownames"	"Afficher le nom des joueurs au dessus de la barre de santé"
"dota_settings_showhitpoints"	"Afficher les PV au dessus des barres de vie des joueurs"
"dota_settings_forceshophotkeys"	"Raccourcis clavier (Échoppe)"
"dota_settings_usebroadcastermenu"	"Utiliser les stats commentateur"
"dota_settings_colorblind"	"Mode daltonien"
"dota_settings_reducedflash"	"Réduction des flashs"
"dota_settings_minimap"	"Mini-carte"
"dota_settings_minimapsimplecolors"	"Couleurs simples (Mini-carte)"
"dota_settings_minimaphidebackground"	"Cacher le fond (Mini-carte)"
"dota_settings_minimapshowheroicon"	"Utiliser les icônes des héros sur la mini-carte"
"dota_settings_minimapalwaysshowname"	"Noms/icônes toujours sur la mini-carte"
"dota_settings_minimapflip"	"Mini-carte à droite"
"dota_settings_cameradecel"	"Décélération de la caméra"
"dota_settings_cameraspeed"	"Vitesse de la caméra"
"dota_settings_camerareversegrip"	"Caméra inversée"
"dota_settings_cameraedgepan"	"Bordures déroulantes"
"dota_settings_camerascreenshake"	"Activer les secousses d'écran"
"dota_settings_cameraresetonspawn"	"Déplacer la caméra lors de la réapp."
"dota_settings_cameradeadcolorshift"	"Changement de couleur de la caméra lorsque mort"
"dota_settings_profile"	"Profil"
"dota_settings_hideprofile"	"Masquer le profil Dota et Steam"
"dota_settings_exposematchdata"	"Rendre disponible les données des matchs publics"
"dota_settings_ignorenonfriendparties"	"Bloquer les invitations de groupe ne provenant pas de mes amis"
"dota_settings_ignorenonfriendguilds"	"Bloquer les invitations de la guilde ne provenant pas de mes amis"
"dota_settings_allowtradeinvitesheader"	"Demande d'échange de la part de :"
"dota_settings_trade_guildandfriends"	"Membres des guildes et amis"
"dota_settings_trade_friends"	"Amis seulement"
"dota_settings_trade_anyone"	"Tous"
"dota_settings_network"	"Réseau"
"dota_settings_networkquality"	"Qualité du réseau"
"dota_settings_networkquality_low"	"Faible"
"dota_settings_networkquality_high"	"Élevée"
"dota_settings_usenativeresolution"	"Utiliser la résolution actuelle de mon écran"
"dota_settings_customresolution"	"Utiliser les paramètres avancés"
"dota_settings_resolution"	"Résolution"
"dota_settings_rendering"	"Rendu"
"dota_settings_aspectratio"	"Format d'image"
"dota_settings_aspectratio43"	"4:3"
"dota_settings_aspectratio169"	"16:9"
"dota_settings_aspectratio1610"	"16:10"
"dota_settings_resolution_size"	"Taille"
"dota_settings_resolution_display_mode"	"Mode d'affichage"
"dota_settings_fullscreen"	"Plein écran exclusif"
"dota_settings_window"	"Fenêtré"
"dota_settings_borderless"	"Fenêtré plein écran"
"dota_settings_videodefaults"	"PARAMÈTRES VIDÉO PAR DÉFAUT"
"dota_settings_basicvideosettings"	"Utiliser les paramètres de base"
"dota_settings_fastestvideo"	"Plus rapide"
"dota_settings_appearancevideo"	"Plus beau"
"dota_settings_advancedvideosettings"	"Utiliser les paramètres avancés"
"dota_settings_antialiasing"	"Anticrénelage"
"dota_settings_specular"	"Spéculaire"
"dota_settings_bloom"	"Éclats lumineux et spéculaires"
"dota_settings_waterquality"	"Qualité d'affichage de l'eau"
"dota_settings_fog"	"Brouillard atmosphérique"
"dota_settings_animateportrait"	"Portrait animé"
"dota_settings_additivelight"	"Éclairage superficiel"
"dota_settings_worldlight"	"Éclairage du monde"
"dota_settings_ambientocclusion"	"Occlusion ambiante"
"dota_settings_ambientcreatures"	"Créatures environnantes"
"dota_settings_normal_maps"	"Cartes normales"
"dota_settings_vsync"	"Synchronisation verticale"
"dota_settings_renderquality"	"Qualité du rendu"
"dota_settings_shadowquality"	"Qualité des ombres"
"dota_settings_shadowquality_low"	"Faible"
"dota_settings_shadowquality_med"	"Moyenne"
"dota_settings_shadowquality_high"	"Élevée"
"dota_settings_texturequality"	"Qualité des textures"
"dota_settings_texturequality_low"	"Faible"
"dota_settings_texturequality_med"	"Moyenne"
"dota_settings_texturequality_high"	"Élevée"
"dota_settings_mastervolume"	"Volume principal"
"dota_settings_gamevolume"	"Sons du jeu"
"dota_settings_musicvolume"	"Musique"
"dota_settings_voicevolume"	"Voix"
"dota_settings_gamevoicevolume"	"Dialogue des unités"
"dota_settings_openmic"	"Activer \"micro ouvert\" pour communiquer avec les membres de groupe"
"dota_settings_openmicthreshold"	"Seuil d'activation"
"dota_settings_audiodefaults"	"Audio par défaut"
"dota_settings_defaultaudio"	"Par défaut"
"dota_settings_sounddevice"	"Périphérique audio :"
"dota_settings_speakerconfig"	"Configuration du son :"
"dota_settings_headphones"	"Casque audio"
"dota_settings_2speakers"	"2 enceintes"
"dota_settings_4speakers"	"4 enceintes"
"dota_settings_5speakers"	"Enceintes 5.1"
"dota_settings_7speakers"	"Enceintes 7.1"
"dota_settings_captions"	"Sous-titrage"
"dota_settings_playsoundinbackground"	"Jouer les sons sur le Bureau (Alt-Tab)"
"dota_settings_chatsounds"	"Son des messages du chat"
"dota_settings_mutecobroadcasters"	"Rendre muet les co-commentateurs"
"dota_settings_highqualityaudio"	"Audio haute qualité"
"dota_settings_enhancestereo"	"Stéréo améliorée"
"dota_settings_unitspeeh"	"Dialogue des unités"
"dota_settings_unitspeech_off"	"Désactivé"
"dota_settings_unitspeech_events"	"Événements"
"dota_settings_unitspeech_all"	"Tous"
"OS_Default_Device"	"Périphérique par défaut"
"DOTA_Keybind_ARROW"	"Flèche (Par défaut)"
"DOTA_Keybind_WASD"	"ZQSD"
"DOTA_Keybind_MMO"	"MMO"
"DOTA_Keybind_LEGACY"	"Touches classiques"
"DOTA_Keybind_LOL"	"League of Legends"
"DOTA_Keybind_HON"	"Heroes of Newerth"
"DOTA_Keybind_SMITE"	"Smite"
"DOTA_Hotkeys_Tooltip_LearnAbility"	"Passe en mode apprentissage de compétence lorsque vous avez des points de compétence à utiliser."
"DOTA_Hotkeys_Tooltip_LearnStats"	"Ajoute 2 points à chacune de vos statistiques lorsque vous avez des points de compétence à utiliser."
"DOTA_Hotkeys_Tooltip_HeroAttack"	"Vous déplace vers un endroit et attaque les unités ennemies rencontrées / Attaque une unité alliée si elle peut être sacrifiée."
"DOTA_Hotkeys_Tooltip_HeroMove"	"Déplacez-vous, ou suivez une unité sans l'attaquer."
"DOTA_Hotkeys_Tooltip_HeroStop"	"Interrompt l'action en cours."
"DOTA_Hotkeys_Tooltip_HeroHold"	"Interrompt votre action en cours et maintient votre position."
"DOTA_Hotkeys_Tooltip_HeroSelect"	"Sélectionne votre héros."
"DOTA_Hotkeys_Tooltip_SelectAll"	"Sélectionne toutes les unités sous votre contrôle."
"DOTA_Hotkeys_Tooltip_SelectAllOthers"	"Sélectionne toutes les autres unités sous votre contrôle. (Votre héros ne sera pas sélectionné.)"
"DOTA_Hotkeys_Tooltip_CourierSelect"	"Sélectionne le coursier"
"DOTA_Hotkeys_Tooltip_CourierDeliver"	"Se faire délivrer les objets de la réserve par le coursier."
"DOTA_Hotkeys_Tooltip_CourierHaste"	"Octroie un bonus de vitesse pour votre coursier quand disponible."
"DOTA_Hotkeys_Tooltip_UseActionItem"	"Utilise l'objet d'action."
"DOTA_Hotkeys_Tooltip_HeroTaunt"	"Utilise votre provocation de héros. Disponible en tant qu'objet équipable."
"DOTA_Hotkeys_Tooltip_ShopToggle"	"Ouvre le panneau de l’échoppe."
"DOTA_Hotkeys_Tooltip_PurchaseQuickbuy"	"Achète le prochain objet se trouvant dans votre zone d'achat rapide si vous en avez les moyens."
"DOTA_Hotkeys_Tooltip_PurchaseSticky"	"Achète le prochain objet se trouvant dans la 'Sticky area' si vous en avez les moyens."
"DOTA_Hotkeys_Tooltip_GrabStashItems"	"Transfère tous les objets de votre réserve à votre héros."
"DOTA_Hotkeys_Tooltip_RecentEvent"	"Déplacer la caméra à l’événement le plus récent dans le monde."
"DOTA_Hotkeys_Tooltip_InspectHeroInWorld"	"Observer une unité via une perspective rapprochée."
"DOTA_Hotkeys_Tooltip_ChatTeam"	"Envoie un message à votre équipe."
"DOTA_Hotkeys_Tooltip_ChatGlobal"	"Envoie un message à toute personne se trouvant dans la partie. (Ajoute un modificateur 'SHIFT' au raccourci chat d'équipe)"
"DOTA_Hotkeys_Tooltip_ChatVoiceParty"	"Activez votre microphone pour communiquer avec les membres de groupe. Si vous avez activé l'option « Micro ouvert », il fonctionnera aussi dans le tableau de bord."
"DOTA_Hotkeys_Tooltip_ChatVoiceTeam"	"Active votre microphone pour communiquer avec les membres de votre équipe."
"DOTA_Hotkeys_Tooltip_ChatWheel"	"Ouvre la roue des dialogues pour une communication simplifiée via des phrases couramment utilisées."
"DOTA_Hotkeys_Tooltip_CameraGrip"	"Maintenez et glissez sur le monde pour déplacer la caméra. Également associé au bouton central de la souris."
"DOTA_Hotkeys_Tooltip_ActivateGlyph"	"Active le glyphe de fortification afin de rendre les structures alliées invulnérables pendant 5 secondes."
"DOTA_Hotkeys_Tooltip_ScoreboardToggle"	"Ouvre le tableau des scores en jeu."
"DOTA_Hotkeys_Tooltip_Pause"	"Met en pause ou reprend une partie en cours."
"DOTA_Hotkeys_Tooltip_ScreenshotSettings"	"Prend une capture d'écran de la vue actuelle."
"DOTA_Hotkeys_Tooltip_Console"	"Ouvre la console. (Utilisateurs avancés uniquement)"
"DOTA_Hotkeys_Tooltip_ControlGroupCycle"	"Passe en revue chaque unité d'un groupe sélectionné."
"DOTA_Hotkeys_Tooltip_Group"	"Sélectionne un groupe de contrôle d'unités prédéfini. Pour définir un groupe de contrôle, sélectionnez les unités désirées et maintenez CTRL + un de ces raccourcis clavier de groupe."
"DOTA_Hotkeys_Tooltip_Legacy"	"Utilise les raccourcis associés à Dota 1. Les raccourcis des capacités varient en fonction du héros."
"DOTA_Hotkeys_Tooltip_Quickcast"	"Une compétence lancée via l'utilisation rapide se déclenche à la position du pointeur de la souris dès l'activation du raccourci."
"DOTA_Hotkeys_Tooltip_Autocast"	"Activez pour automatiquement lancer une capacité quand disponible. S'applique à un nombre limité de capacités."
"DOTA_Hotkeys_Tooltip_Cast"	"Raccourci pour utiliser une capacité du héros."
"DOTA_Hotkeys_Tooltip_ItemCast"	"Raccourci pour utiliser un objet de votre inventaire."
"DOTA_Hotkeys_Tooltip_ItemQuickcast"	"Un objet utilisé via l'utilisation rapide se déclenche à la position du pointeur de la souris dès l'activation du raccourci."
"DOTA_Settings_Tooltip_Autoattack"	"Déplacement automatique vers les ennemis proches pour les attaquer."
"DOTA_Settings_Tooltip_AutoattackAfterSpell"	"Si non coché, le héros restera sur place après avoir lancé un sort et attendra la prochaine instruction."
"DOTA_Settings_Tooltip_AutoPurchase"	"Achetez l'item suivant dans la liste suggérée quand vous en aurez les moyens."
"DOTA_Settings_Tooltip_AutoSelectSummons"	"Lorsque les unités sont invoquées par votre héros, elles sont automatiquement ajoutées à votre groupe de sélection."
"DOTA_Settings_Tooltip_DoubleTap"	"Un double-clic sur une compétence ou un objet, ou un double-appui sur la touche de raccourci lancera sur le sort sur vous-même, si celui-ci le permet."
"DOTA_Settings_Tooltip_UnifiedOrders"	"Maintenir CTRL enfoncé tout en donnant un ordre affectera toutes les unités sous votre contrôle."
"DOTA_Settings_Tooltip_TeleportStop"	"Se déplacer ou lancer un sort n’interrompra pas une téléportation en cours. Ne s'applique seulement que pour les Teleport Scrolls ou les Boots of Travel."
"DOTA_Settings_Tooltip_BroadcasterStats"	"Lorsque vous regardez une partie, cela affiche la liste déroulante des statistiques que le commentateur utilise."
"DOTA_Settings_Tooltip_Deceleration"	"Vitesse à laquelle la caméra se stabilise après un mouvement. Plus la valeur est importante, plus l\\'arrêt est rapide."
"DOTA_Settings_Tooltip_Screenshake"	"Certains sorts et étourdissements secouent la caméra."
"DOTA_Settings_Tooltip_CameraRespawn"	"Recentrer la caméra sur votre héros dès qu'il réapparaîtra."
"DOTA_Settings_Tooltip_HideProfile"	"Votre profil Dota 2 ne sera plus accessible pour personne. Votre profil Steam ne sera pas accessible depuis Dota 2."
"DOTA_Settings_Tooltip_ShareMatchData"	"Rend disponible les données des matchs de vos parties publiques à des entités tierces."
"DOTA_Settings_Tooltip_NetworkQuality"	"Si vous avez une connexion réseau de mauvaise qualité, choisir 'BAS' dans les paramètres pourrait améliorer vos performances réseau."
"DOTA_Settings_Tooltip_MinimapSimple"	"Les couleurs de la mini-carte représentent les équipes plutôt que les joueurs individuels."
"DOTA_Settings_Tooltip_MinimapDrawHeroes"	"Affiche l’icône du héros sur la mini-carte au lieu de son nom quand la touche ALT est maintenue appuyée."
"DOTA_Settings_Tooltip_MinimapNamesIcon"	"Toujours afficher l'icône du héros ou son nom sur la mini-carte, maintenir ALT affichera temporairement un X ou un O."
"DOTA_Settings_Tooltip_ShopHotkeys"	"Les raccourcis de l'échoppe remplaceront les autres raccourcis préalablement affectés à d'autres fonctions tant que l'échoppe est ouverte."
"DOTA_Settings_LegacyKeysActive"	"Les touches classiques de Dota 2 sont actuellement activées. Pour personnaliser chaque touche individuelle, veuillez d'abord désactiver les touches classiques (legacy keys)."
"DOTA_create_bot_practice_desc"	"Jouez un match contre des adversaires contrôlés par l'IA. Vous pouvez utiliser le matchmaking pour jouer avec d\\'autres joueurs humains ou remplir les emplacements d'équipe vacants avec des bots."
"DOTA_Lobby_BotDifficulty"	"DIFFICULTÉ DES BOTS"
"DOTA_Lobby_BotDifficulty_no_bot"	"Pas de Bot"
"DOTA_Lobby_BotDifficulty_passive"	"Passif"
"DOTA_Lobby_BotDifficulty_easy"	"Facile"
"DOTA_Lobby_BotDifficulty_medium"	"Moyen"
"DOTA_Lobby_BotDifficulty_hard"	"Difficile"
"DOTA_Lobby_BotDifficulty_unfair"	"Injuste"
"DOTA_Lobby_BotTeam"	"Choisir une équipe"
"DOTA_create_bot_practice_solo"	"Solo"
"DOTA_create_bot_practice_coop"	"Coop"
"DOTA_create_bot_practice_coop_desc"	"Utilisez le matchmaking pour jouer avec d'autres joueurs contre des bots. <font color='#dd6666'>NOTE :</font> Abandonner cette partie entraînera une sanction."
"DOTA_Lobby_BotDifficulty_bot_passive"	"Bot passif"
"DOTA_Lobby_BotDifficulty_bot_easy"	"Bot facile"
"DOTA_Lobby_BotDifficulty_bot_medium"	"Bot moyen"
"DOTA_Lobby_BotDifficulty_bot_hard"	"Bot difficile"
"DOTA_Lobby_BotDifficulty_bot_unfair"	"Bot injuste"
"dota_lobby_title"	"{s:lobby_name}"
"dota_lobby_title_local_game"	"Lobby local"
"dota_lobby_title_default"	"Lobby"
"lobby_row_player_name"	"{s:player_name}"
"dota_lobby_row_game_name"	"{s:game_name}"
"dota_lobby_row_slots"	"{s:slots}"
"dota_lobby_row_game_mode"	"{s:game_mode}"
"dota_lobby_row_join"	"Rejoindre"
"dota_lobby_row_leave"	"Quitter"
"dota_lobby_coaches_title"	"Coachs"
"dota_lobby_browser_all_game_modes"	"Tous les modes de jeux"
"dota_lobby_browser_title"	"Parcourir les lobbies Dota"
"dota_lobby_browser_num_available"	"( {d:lobbies_available} disponible(s) )"
"dota_lobby_browser_no_lobbies"	"Aucun lobby trouvé"
"dota_lobby_browser_no_matching_lobbies"	"Aucun lobby ne correspond à votre recherche"
"dota_lobby_browser_updating"	"Mise à jour de la liste des lobbies..."
"dota_lobby_browser_search_placeholder"	"Chercher des lobbys"
"dota_lobby_browser_game_mode"	"Mode de jeu"
"dota_lobby_browser_refresh"	"Actualiser"
"dota_lobby_browser_filter_title"	"Filtrer les lobbys"
"dota_lobby_submit_filter"	"Valider"
"dota_popup_lobby_password_title"	"Mot de passe du lobby"
"DOTA_AttackCapability_Melee"	"Corps-à-corps"
"DOTA_AttackCapability_Ranged"	"À distance"
"DOTA_Item_OnMarket"	"Marché"
"DOTA_Items_DefaultSet"	"Ensemble par défaut"
"DOTA_Items_SetEquipped_Label"	"Équipé"
"DOTA_EquippedItem_Label"	"Équipé"
"DOTA_PreviewingItem_Label"	"Prévisualisation"
"DOTA_EquippedItem_Rarity"	"{s:equipped_econ_set_rarity}"
"DOTA_EquippedItem_SetName"	"{s:equipped_econ_set_name}"
"DOTA_EquippedItem_DefaultSet"	"Ensemble par défaut"
"DOTA_EquippedItem_PartialSet"	"Ensemble partiel"
"DOTA_EquippedItem_Style"	"{i:equipped_econ_set_style_count} Style(s)"
"DOTA_EquippedItem_Button_Details"	"{s:equipped_details_button_text}"
"DOTA_EquippedItem_Customize"	"Personnaliser"
"DOTA_EquippedItem_CustomSet"	"Ensemble personnalisé"
"DOTA_EquippedItem_Equip"	"Équiper"
"DOTA_EquippedItem_Unpack_And_Equip"	"Déballer et équiper"
"DOTA_EquippedItem_Details"	"Informations relatives {s:equipped_econ_set_type_name}"
"DOTA_EquippedItem_Purchase_Button"	"Acheter"
"DOTA_EquippedItem_Marketplace_Button"	"Marché"
"DOTA_EquippedItem_BundleName"	"Compris dans le bundle \"{s:equipped_econ_set_bundle}\""
"DOTA_EquippedItem_FilterText"	"Prévisualisation"
"DOTA_EquippedItem_SaleAmount"	"-{i:equipped_econ_set_sale_amount}%"
"DOTA_EquippedItem_RegularSetPrice"	"{s:equipped_econ_regular_set_price}"
"DOTA_EquippedItem_SetPrice"	"{s:equipped_econ_set_price}"
"DOTA_EquippedItem_TreasurePrice"	"{s:equipped_econ_treasure_price}"
"DOTA_HeroDemo_Button"	"Démo {s:econ_item_category_name}"
"DOTA_HeroDemo_Button_Tooltip"	"Lancez le mode Démo pour voir cet ensemble d'objets ou les capacités de ce héros"
"DOTA_HeroDemo_Button_Return"	"Retourner à la démo"
"DOTA_HeroDemo_Button_Return_Tooltip"	"Retournez au mode Démo et chargez l'ensemble d'objets ou le héros choisi"
"DOTA_HeroDemo_Button_DBQuit"	"Quitter la démo"
"DOTA_EquippedItem_Bundle"	"Bundle"
"DOTA_EquippedItem_ItemSet"	"Ensemble"
"DOTA_EquippedItem_Item"	"Objet"
"DOTA_EconItemSet_Name"	"{s:econ_set_name}"
"DOTA_EconItemSet_Rarity"	"{s:econ_set_rarity}"
"DOTA_EconItemSet_Status"	"{s:econ_set_status}"
"DOTA_EconItemSet_Price"	"{s:econ_set_price}"
"DOTA_EconItemSet_SaleAmount"	"-{i:econ_sale_amount}%"
"DOTA_EconItemSet_DeveloperOnly"	"Non public"
"DOTA_EconItemSet_Tooltip_InBundle"	"Cet ensemble est compris dans un bundle"
"DOTA_EconItemSet_Tooltip_MultipleStyles"	"Possède des styles multiples"
"DOTA_HeroRole_Carry"	"Carry"
"DOTA_HeroRole_Support"	"Support"
"DOTA_HeroRole_Nuker"	"Nuker"
"DOTA_HeroRole_Disabler"	"Disabler"
"DOTA_HeroRole_Jungler"	"Jungler"
"DOTA_HeroRole_Durable"	"Durable"
"DOTA_HeroRole_Escape"	"Escape"
"DOTA_HeroRole_LaneSupport"	"Lane Support"
"DOTA_HeroRole_Pusher"	"Pusher"
"DOTA_HeroRole_Initiator"	"Initiator"
"DOTA_HeroRole_Description_Carry"	"Deviendra plus utile en fin de partie s'il obtient un avantage d'or significatif."
"DOTA_HeroRole_Description_Support"	"Peut se concentrer d'avantage sur l'utilisation de ses capacités et favoriser son équipe plutôt que d'amasser de l'or et des objets."
"DOTA_HeroRole_Description_Nuker"	"Peut rapidement tuer les héros ennemis à l'aide de sorts qui infligent des dégâts élevés avec de faibles temps de recharge."
"DOTA_HeroRole_Description_Disabler"	"Possède un disable garanti pour un ou plusieurs de ses sorts."
"DOTA_HeroRole_Description_Jungler"	"Peut farmer efficacement les creeps neutres à l'intérieur de la jungle en début de partie."
"DOTA_HeroRole_Description_Durable"	"A la capacité de résister plus longtemps lors de teamfights."
"DOTA_HeroRole_Description_Escape"	"A la capacité d'éviter rapidement la mort."
"DOTA_HeroRole_Description_LaneSupport"	"Utile en début de partie pour protéger le carry de l'équipe et le laisser farmer."
"DOTA_HeroRole_Description_Pusher"	"Peut rapidement assiéger et détruire les tours et casernes"
"DOTA_HeroRole_Description_Initiator"	"Bon pour déclencher les teamfights."
"DOTA_HeroGrid_OptionCategory_Role"	"Rôles :"
"DOTA_HeroGrid_OptionCategory_Attributes"	"Attributs :"
"DOTA_HeroGrid_OptionCategory_AttackType"	"Type d'attaque :"
"DOTA_HeroLoadout_PreviousHeroName"	"{s:previous_hero_name}"
"DOTA_HeroLoadout_NextHeroName"	"{s:next_hero_name}"
"DOTA_HeroLoadout_CurrentHeroName"	"{s:hero_name}"
"DOTA_HeroLoadout_AttackType"	"{s:hero_attack_type}"
"DOTA_HeroLoadout_HeroFilterName"	"Héros"
"DOTA_HeroLoadout_Search"	"Rechercher les objets de {s:hero_name}"
"DOTA_HeroCustomize_Title"	"Personnaliser le héros"
"DOTA_HeroCustomize_OwnedItems"	"Objets possédés"
"DOTA_HeroCustomize_Slot"	"Empl."
"DOTA_HeroCustomize_SlotName"	"{s:slot_name}"
"DOTA_HeroCustomize_SlotEquippedItemName"	"{s:equipped_item_name}"
"DOTA_HeroCustomize_DefaultItemName"	"Objet par défaut"
"DOTA_HeroCustomize_PreviewItemName"	"{s:preview_item_name}"
"DOTA_HeroCustomize_PreviewStyle"	"{s:preview_style_name}"
"DOTA_HeroCustomize_PreviewItemSlot"	"{s:preview_item_slot}"
"DOTA_HeroCustomize_Rarity"	"{s:preview_item_rarity}"
"DOTA_HeroCustomize_StyleLocked"	"Les conditions requises pour vous équiper de cet objet ne sont pas remplies."
"DOTA_UIEconItem_StyleIndex"	"{i:style_index}"
"dota_ready_up_num_accepted"	"{i:num_accepted} / {i:total_players} ont accepté"
"returning_top_of_queue"	"Retour prioritaire à la création de match"
"returning_to_lobby"	"Retour au lobby pour trouver plus de joueurs..."
"GC_reconnecting"	"Reconnexion au réseau Dota 2..."
"GC_nosteam"	"Pas de connexion à Steam"
"GC_searching"	"Recherche du réseau Dota 2..."
"GC_noconnection"	"Non connecté au réseau Dota 2."
"GC_connecting"	"Connexion au réseau Dota 2..."
"GC_connected"	"Connecté au réseau Dota 2."
"GC_down"	"Réseau Dota 2 actuellement déconnecté."
"GC_Network_Full"	"Le réseau Dota 2 est actuellement saturé."
"GC_Queue_Position"	"Position dans la file d'attente : %s1"
"GC_Queue_Wait_Time"	"Le réseau Dota 2 est actuellement saturé. Position dans la file d'attente : {i:gc_queue_position}, Temps d'attente estimé : {s:gc_queue_wait_time}"
"GC_Wait_Time"	"Temps d'attente estimé : %s1"
"GC_Wait_Time_Unknown"	"Inconnu"
"GC_suspended"	"Compte suspendu après que le système Valve Anti-Triche (VAC) ait détecté des outils externes attachés à Dota 2."
"dota_practice_vs_bots"	"Commencer l'entraînement contre des bots"
"dota_practice_vs_bots_desc"	"Jouer à un match d'entraînement contre des bots. Ceci ne fait pas partie du matchmaking, et vous pourrez quitter le match à tout moment"
"dota_practice_vs_bots_difficulty"	"Difficulté des bots"
"dota_practice_vs_bots_team"	"Jouer avec quelle équipe ?"
"DOTA_practice_vs_bots_team_radiant"	"Radiant"
"DOTA_practice_vs_bots_team_dire"	"Dire"
"DOTA_practice_vs_bots_team_random"	"Aléatoire"
"DOTA_EmoticonUpsell"	"Les émoticônes sont déblocables grâce à l'achat d'objets d'héros spécifiques, ou de tickets de ligue."
"DOTA_CurrentTime"	"{t:t:current_time}"
"DOTA_MonthlyPlayers"	"{s:users_last_month}"
"DOTA_MonthlyPlayersLabel"	"Joueurs uniques au cours du dernier mois"
"DOTA_CurrentPlayers"	"{s:current_users}"
"DOTA_CurrentPlayersLabel"	"Joueurs en jeu actuellement"
"DOTA_Search_NoResults"	"Aucun résultats"
"DOTA_Search_ItemShortDescription"	"<span class=\"ItemRarityColor\">{s:item_rarity}</span> {s:item_slot}"
"join_error_already_in_game"	"Impossible de rejoindre la salle d'entraînement, puisque vous êtes déjà dans une partie."
"join_error_invalid_lobby"	"Le lobby indiqué n'existe plus."
"join_error_incorrect_password"	"Mot de passe incorrect."
"join_error_access_denied"	"Accès refusé."
"join_error_generic"	""
"join_error_in_team_party"	"Impossible de rejoindre la salle d'entraînement. Vous devez dissoudre votre groupe avant de rejoindre des parties d'entraînements."
"join_error_lobby_full"	"Le lobby est plein."
"join_error_timed_out"	"Délai d'attente de la requête dépassé."
"DOTA_Friends_Ready_To_Play"	"Jeux ouverts"
"DOTA_Friend_Finding_Match"	"Recherche..."
"DOTA_Friend_In_Match"	"Dans un match"
"DOTA_Friend_Solo_Open_Party"	"{s:player_name} souhaite jouer"
"DOTA_Friend_In_Party_Open"	"{s:player_name} est dans un groupe ouvert"
"DOTA_Friend_Solo_Open_Party_Self"	"Vous recherchez des joueurs pour former un groupe"
"DOTA_Friend_In_Open_Party_Self"	"Vous êtes dans un groupe ouvert"
"DOTA_Friends_In_Party_Open"	"{d:num_friends} amis dans un groupe ouvert"
"DOTA_Friend_Lobby_Mode_Self"	"Vous êtes dans un lobby {s:game_mode}"
"DOTA_Friend_Lobby_Mode_1_Friend"	"{s:player_name} dans un lobby {s:game_mode}"
"DOTA_Friend_Lobby_Mode_N_Friends"	"{d:num_friends} amis dans un lobby {s:game_mode}"
"DOTA_Friend_Lobby_Mode_Small"	"Lobby {s:game_mode}"
"DOTA_Friend_Lobby_Players"	"{d:player_count} / {d:max_player_count}"
"DOTA_Friend_Lobby_Join_Button"	"{s:join_button_text}"
"DOTA_Friend_Lobby_Friend_Count"	"+{d:extra_friend_count}"
"DOTA_Friend_Invite_To_Party"	"Inviter au groupe"
"DOTA_Friend_SuggestInviteToParty"	"Suggérer une invitation"
"DOTA_Request_Join_Party"	"Demander à  rejoindre le groupe"
"DOTA_Request_Merge_Parties"	"Faire un demande de fusion des groupes"
"DOTA_Request_Merge_Parties_NotLeader"	"Le chef du groupe peut envoyer une requête pour fusionner les groupes."
"DOTA_Friend_PartyInvitePending"	"Invitation de groupe en attente"
"DOTA_Friend_PartyInvitePending_Leader"	"Invitation de groupe en attente<br/>Cliquez pour annuler l'invitation"
"DOTA_Friend_PartyMergeRequestPending"	"Requête pour rejoindre le groupe en attente"
"DOTA_Friend_PartyMergeRequestPending_Leader"	"Requête de groupe en attente<br/>Cliquez pour annuler la requête"
"DOTA_Friend_JoinParty"	"Rejoindre le groupe"
"DOTA_Friend_Watch"	"Regarder"
"DOTA_PartyVisTooltip_SoloTitleOpen"	"Souhaite jouer"
"DOTA_PartyMerge_Error_Title"	"Impossible de rejoindre/fusionner le groupe"
"DOTA_PartyMerge_Error_TOO_MANY_PLAYERS"	"Ces groupes ne peuvent pas être rejoints car trop de joueurs sont présents."
"DOTA_PartyMerge_Error_TOO_MANY_COACHES"	"Ces groupes ne peuvent pas être rejoints car trop de coachs sont présents."
"DOTA_PartyMerge_Error_ENGINE_MISMATCH"	"Ces groupes ne peuvent pas être rejoints car ils jouent à des versions différentes de Dota"
"DOTA_PartyMerge_Error_NO_SUCH_GROUP"	"Ce groupe n'existe plus."
"DOTA_Feed_Timestamp_Recently"	"À l'instant"
"DOTA_Feed_Timestamp_MinutesAgo"	"Il y a {i:value} minutes"
"DOTA_Feed_Timestamp_HourAgo"	"Il y a {i:value} heure"
"DOTA_Feed_Timestamp_HoursAgo"	"Il y a {i:value} heures"
"DOTA_Feed_Timestamp_Yesterday"	"Hier"
"DOTA_Feed_Timestamp_Date"	"{s:month} {s:day}"
"dota_lobby_type_general"	"Non classé"
"dota_lobby_type_practice"	"Entraînement"
"dota_lobby_type_practice_game_mode_custom"	"Jeu custom"
"dota_lobby_type_tournament"	"Tournoi"
"dota_lobby_type_coop_bot"	"Coop avec des bots"
"dota_lobby_type_competitive"	"Match classé"
"dota_lobby_type_casual_1v1"	"Match 1v1"
"dota_lobby_unknown"	"Inconnu"
"DOTA_Lobby_No_Players_Title"	"PAS DE JOUEUR DANS L'ÉQUIPE"
"DOTA_Lobby_No_Players_Desc"	"Il doit y avoir au moins un joueur dans l'équipe du Radiant ou du Dire."
"dota_match_result_won"	"Gagnés"
"dota_match_result_lost"	"Défaite"
"dota_match_result_none"	"???"
"dota_social_feed_loading"	"Chargement..."
"DOTA_LoadingPlayerUnknown"	"-"
"DOTA_LoadingPlayerLoading"	"Chargement..."
"DOTA_LoadingPlayerFullyConnected"	"Prêt"
"DOTA_LoadingPlayerFailed"	"Échec"
"LoadingScreenTimer"	"{t:d:countdown_timer_seconds}"
"HeroSelectionTimer"	"{i:timer_seconds}"
"LoadingScreenMapInfo"	"Carte : {s:map_name}"
"LoadingScreenPlayersInfo"	"Joueurs : {i:players_loaded}/{i:players_total}"
"LoadingScreenSpectatorsInfo"	"Spectateurs :  {i:spectators_loaded}/{i:spectators_total}"
"custom_end_screen_victory_message"	"Victoire de l'équipe {s:winning_team_name} !"
"custom_end_screen_legend_player"	"Joueur"
"custom_end_screen_legend_level"	"Niveau"
"custom_end_screen_legend_hero"	"Héro"
"custom_end_screen_legend_kills"	"K"
"custom_end_screen_legend_deaths"	"D"
"custom_end_screen_legend_assists"	"A"
"custom_end_screen_legend_items"	"Items"
"custom_end_screen_legend_gold"	"Or"
"custom_end_screen_legend_team_score"	"Score"
"custom_scoreboard_hero_name_and_desc"	"{s:hero_name} - Niveau {i:hero_level}"
"CustomEndScreenClose"	"Fermer"
"DOTA_Armory_Category_Heroes"	"Héros"
"DOTA_Armory_Category_Companions"	"Compagnons"
"DOTA_Armory_Category_Couriers"	"Coursiers"
"DOTA_Armory_Category_Pets"	"Mascottes"
"DOTA_Armory_Category_World"	"Monde"
"DOTA_Armory_Category_Wards"	"Wards"
"DOTA_Armory_Category_Weather"	"Effets météo"
"DOTA_Armory_Category_Effigies"	"Effigies"
"DOTA_Armory_Category_Interface"	"Interface"
"DOTA_Armory_Category_Emoticons"	"Émoticônes"
"DOTA_Armory_Category_LoadingScreens"	"Écrans de chargement"
"DOTA_Armory_Category_HUDs"	"HUDs"
"DOTA_Armory_Category_CursorPacks"	"Packs de curseurs"
"DOTA_Armory_Category_Audio"	"Audio"
"DOTA_Armory_Category_VoicePacks"	"Packs de voix"
"DOTA_Armory_Category_AnnouncerPacks"	"Packs d'annonceurs"
"DOTA_Armory_Category_Music"	"Musique"
"DOTA_Armory_Category_All"	"Tous"
"DOTA_Armory_Category_Other"	"Autres"
"DOTA_Armory_Category_View"	"Affichage des catégories"
"DOTA_Armory_Filter"	"Filtrer"
"DOTA_Armory_SortBy"	"Trier par :"
"DOTA_Armory_SortBy_Rarity"	"Rareté"
"DOTA_Armory_SortBy_Quality"	"Qualité"
"DOTA_Armory_SortBy_Name"	"Nom"
"DOTA_Armory_SortBy_Recent"	"Date d'acquisition"
"DOTA_Armory_SortBy_Sockets"	"Nbr. d'emplacements"
"DOTA_Armory_Search"	"Rechercher les objets de l'armurerie"
"DOTA_Armory_ContextMenu_Preview"	"Prévisualisation de l'objet"
"DOTA_Armory_ContextMenu_PreviewSet"	"Prévisualisation de l'ensemble"
"DOTA_Armory_ContextMenu_Equip"	"Équiper"
"DOTA_Armory_ContextMenu_Unequip"	"Déséquiper"
"DOTA_Armory_ContextMenu_Socketing"	"Sertir"
"DOTA_Armory_ContextMenu_GiftWrap"	"Emballage cadeau"
"DOTA_Armory_ContextMenu_Delete"	"Supprimer"
"dota_page_match_details_loading"	"Chargement du match..."
"dota_page_match_details_victory"	"Gagnant :  {s:winner}"
"dota_page_match_details_legend_player"	"Joueur"
"dota_page_match_details_legend_level"	"Niveau"
"dota_page_match_details_legend_hero"	"Héros"
"dota_page_match_details_legend_kills"	"K"
"dota_page_match_details_legend_deaths"	"D"
"dota_page_match_details_legend_assists"	"A"
"dota_page_match_details_legend_items"	"Items"
"dota_page_match_details_legend_gold"	"Or"
"dota_page_match_details_legend_last_hits"	"LH"
"dota_page_match_details_legend_denies"	"DN"
"dota_page_match_details_legend_gold_per_min"	"OPM"
"dota_page_match_details_legend_xp_per_min"	"XPM"
"dota_page_match_details_legend_winner_tooltip"	"Équipe gagnante"
"dota_page_match_details_legend_kills_tooltip"	"Victimes"
"dota_page_match_details_legend_deaths_tooltip"	"Morts"
"dota_page_match_details_legend_assists_tooltip"	"Assists"
"dota_page_match_details_legend_last_hits_tooltip"	"Last Hits sur Creep"
"dota_page_match_details_legend_gold_per_min_tooltip"	"Or par minute"
"dota_page_match_details_legend_xp_per_min_tooltip"	"XP par minute"
"dota_page_match_details_header_league_name"	"Nom de la ligue"
"dota_page_match_details_header_custom_game_map_name"	"Nom de la carte"
"dota_page_match_details_header_match_id"	"ID du match"
"dota_page_match_details_header_game_mode"	"Mode de jeu"
"dota_page_match_details_header_duration"	"Durée"
"dota_page_match_details_header_timestamp"	"Date / heure du match"
"dota_page_match_details_voting_votes"	"{i:num_votes} votes"
"dota_page_match_details_match_discussion"	"Discussion du match"
"dota_page_match_details_comment_placeholder"	"Écrire un commentaire..."
"dota_page_match_details_comment_loading_comments"	"Chargement des commentaires..."
"dota_page_match_details_comment_no_comments"	"Aucun commentaire posté à propos de ce match."
"dota_page_match_details_replay_existence_unknown"	"Recherche de rediffusion..."
"dota_page_match_details_replay_existence_cdn_found"	"Télécharger l'enregistrement"
"dota_page_match_details_replay_existence_not_found"	"Enregistrement non disponible"
"dota_page_match_details_replay_existence_downloading"	"Téléchargement..."
"dota_page_match_details_replay_existence_disk_found_replay"	"Regarder l'enregistrement"
"dota_page_match_details_replay_existence_disk_found_highlights"	"Voir les moments forts"
"dota_page_match_details_replay_existence_wrong_engine"	"Les rediffusions Source 1 ne sont pas disponibles sur Source 2"
"dota_profile_content_tab_activity_feed"	"Flux d'activité"
"dota_profile_content_tab_recent_games"	"Parties récentes"
"dota_profile_recent_games_option_show_practice_matches"	"Afficher mes matchs d'entraînements"
"dota_profile_recent_game_header_timestamp"	"Date / Heure"
"dota_profile_recent_game_header_hero_name"	"Héros joué"
"dota_profile_recent_game_header_result"	"Résultat"
"dota_profile_recent_game_header_duration"	"Durée"
"dota_profile_recent_game_header_type"	"Type"
"dota_profile_recent_game_result_win"	"Victoire"
"dota_profile_recent_game_result_loss"	"Défaite"
"dota_profile_recent_game_result_abandon"	"Abandon"
"dota_profile_recent_game_icon_source1"	"S1"
"dota_profile_hero_with_index"	"{d:hero_index} {s:hero_name}"
"dota_profile_hero"	"{s:hero_name}"
"dota_replay_manager_error_not_found"	"Impossible de trouver les enregistrements sur CDN."
"dota_replay_manager_error_disk_full"	"Impossible d'allouer de l'espace pour le fichier de l'enregistrement."
"dota_replay_manager_error_chunk_failed"	"Échec lors du téléchargement du fichier de l'enregistrement."
"dota_page_match_details_replay_error_not_found"	"Enregistrement non trouvé sur le disque."
"DOTA_tooltip_econ_item_name"	"{s:item_name}"
"DOTA_tooltip_econ_item_description"	"{s:item_description}"
"DOTA_tooltip_econ_item_set"	"Fait parti de l'ensemble : <font color='#dddddd'>{s:item_set}</font>"
"DOTA_tooltip_econ_item_rarity_label"	"Rareté : "
"DOTA_tooltip_econ_item_rarity"	"{s:item_rarity}"
"DOTA_tooltip_econ_item_slot"	"Emplacement : {s:item_slot}"
"DOTA_tooltip_econ_item_gifter"	"{g:dota_persona:gifter_name}"
"DOTA_tooltip_econ_item_gift_received_date"	"Reçu le : {t:T:gift_received_date_time}"
"DOTA_tooltip_econ_item_trade_restriction_permanent"	"Non échangeable"
"DOTA_tooltip_econ_item_trade_restriction_date"	"Non échangeable avant le : {t:T:tradable_after_date_time} {t:s:tradable_after_date_time}"
"DOTA_tooltip_econ_item_market_restriction_permanent"	"Non négociable"
"DOTA_tooltip_econ_item_gift_restriction_permanent"	"Ne peut pas être offert"
"DOTA_tooltip_econ_item_gift_restriction_date"	"Ne peut pas être offert avant le : {t:T:giftable_after_date_time} {t:s:giftable_after_date_time}"
"DOTA_tooltip_econ_item_gem_type"	"{s:gem_type}"
"DOTA_tooltip_econ_item_gem_strange_count"	"{d:strange_count}"
"DOTA_tooltip_econ_item_gem_description"	"{s:gem_description}"
"DOTA_tooltip_econ_item_partner"	"{s:partner}"
"DOTA_econ_item_details_item_name"	"{s:item_name}"
"DOTA_econ_item_details_item_creation_date"	"DATE DE CRÉATION :  {t:l:creation_date}"
"DOTA_econ_item_details_set_includes"	"Comprend les objets suivants :"
"DOTA_econ_item_details_item_set"	"Fait parti de l'ensemble : <font color='#dddddd'>{s:item_set}</font>"
"DOTA_econ_item_details_rarity_label"	"Rareté :"
"DOTA_econ_item_details_item_rarity"	"{s:item_rarity}"
"DOTA_econ_item_details_item_slot"	"Emplacement : {s:item_slot}"
"DOTA_econ_item_details_item_description"	"{s:item_description}"
"DOTA_econ_item_details_gem_type"	"{s:gem_type}"
"DOTA_econ_item_details_gem_strange_count"	"{d:strange_count}"
"DOTA_econ_item_details_gem_description"	"{s:gem_description}"
"DOTA_Treasure_Name"	"{s:treasure_name}"
"DOTA_Treasure_Rarity"	"Trésor - <span class=\"ItemRarityColor\">{s:treasure_rarity}</span>"
"custom_game_team_select"	"Choix de l'équipe"
"custom_game_team_select_timer"	"{i:countdown_timer_seconds}"
"custom_game_team_select_shuffle"	"Aléatoire"
"custom_game_team_select_auto_start"	"Début automatique"
"custom_game_team_select_starting"	"Démarrage"
"custom_game_team_select_unassigned_players"	"Joueurs non-assignés"
"custom_game_team_select_lock_start"	"Verrouiller + Démarrer"
"custom_game_team_select_cancel_unlock"	"Annuler + Déverrouiller"
"custom_game_team_select_join"	"Rejoindre"
"custom_game_team_select_empty_slot"	"Emplacement vide"
"custom_game_team_select_auto_assign"	"Sélection automatique"
"CouldntFindCompendium"	"Impossible de charger le fichier de test du compendium : %s1"
"CompendiumPageError_Pages"	"Impossible de trouver un bloc 'pages' dans le fichier de données du compendium."
"CompendiumPageError_Template"	"Impossible de trouver une entrée 'template' pour la page '%s1' du compendium (numéro de page %s2)"
"CompendiumPageError_Template2"	"Impossible de trouver le modèle nommé '%s1' dans la page '%s2' du compendium"
"CompendiumPageError_Image"	"Impossible de trouver une image nommée '%s1' dans la page '%s2' du compendium"
"CompendiumPageError_Text"	"Impossible de trouver un bloc de texte nommé '%s1' dans la page '%s2' du compendium"
"CompendiumPageError_Video"	"Impossible de trouver une vidéo nommée '%s1' dans la page '%s2' du compendium"
"CompendiumPageError_Scrollbar"	"Impossible de trouver une barre de défilement nommée '%s1' dans la page '%s2' du compendium"
"CompendiumPageError_Selection"	"Impossible de trouver un choix nommé '%s1' dans la page '%s2' du compendium"
"CompendiumPageError_PageNames"	"La page web '%s1' utilise le même nom qu'une autre page. Les noms de pages web doivent être uniques."
"CompendiumPageError_CustomText"	"Erreur dans le bloc de texte personnalisé '%s1' dans la page '%s2' du compendium"
"CompendiumPageError_CustomImg"	"Erreur dans le bloc d'image personnalisé '%s1'"
"CompendiumPageError_CustomBar"	"Erreur dans le bloc de barre de progression personnalisée '%s1' dans la page '%s2' du compendium"
"CompendiumPageError_CustomEle"	"Échec de l'instanciation de l'élément personnalisé '%s1' dans la page '%s2' du compendium"
"CompendiumPageError_CTFont"	"Police invalide '%s1' spécifié à la page '%s2' du Compendium. Polices valides :\ntexte, texte en gras, titre"
"CompendiumPageError_CTAlign"	"Alignement invalide '{s:s1}' spécifié à la page '{s:s2}' du Compendium. Alignements valides :\n gauche, droite, centre"
"CompendiumPageError_CTDepth"	"Profondeur invalide '{s:s1}'. Profondeurs valides :\n front, back"
"CompendiumPageError_LinePos"	"La ligne '{s:s1}' ne possède pas les deux blocs de position 'start' et 'end'."
"CompendiumPageError_CTPoints"	"Index de sélection invalide '{s:s1}' dans la section 'points' du texte personnalisé '{s:s2}'."
"CompendiumPageError_CTPoints2"	"Index de sélection invalide '{s:s1}' dans la section 'points' du texte personnalisé '{s:s2}'. Aucune sélection comportant l'index n'a été trouvée."
"CompendiumPageError_SelDesc"	"Impossible de trouver une clef 'description' pour le choix '{s:s1}' dans la page '{s:s2}' du compendium"
"CompendiumPageError_Points"	"Pas (ou zéro) 'points' renseigné pour le choix '{s:s1}' dans la page '{s:s2}' du compendium"
"CompendiumPageError_SelType"	"Pas de 'choice_type' renseigné pour le choix '{s:s1}' dans la page '{s:s2}' du compendium"
"CompendiumPageError_BarType"	"'data' manquante pour la barre de progression '{s:s1}' dans la page '{s:s2}' du compendium"
"CompendiumPageError_NoTime"	"'time' spécifié pour la sélection '{s:s1}' dans '{s:s2}' manquant ou invalide"
"CompendiumPageError_ElementType"	"'elementtype' manquant ou invalide pour l'élément '{s:s1}' dans la page '{s:s2}' du compendium"
"CompendiumPageError_SelTimer"	"Chronomètre inconnu de nom '{s:s1}' dans la page '{s:s2}' du compendium"
"CompendiumPageError_BadElement"	"Élément SF inconnu nommé '{s:s1}' dans la page '{s:s2}' du compendium"
"CompendiumPageError_SelNoTimer"	"Aucun chronomètre trouvé dans la page '{s:s1}' du compendium (elle possède des choix nécessitant un chronomètre)"
"CompendiumPageError_SelUnknown"	"'{s:s1}' ne correspond pas à 'choice_type' pour le choix '{s:s2}'"
"CompendiumPageError_BarUnknown"	"'data' de '{s:s1}' invalide pour la sélection '{s:s2}'"
"CompendiumPageError_InvalidEquation"	"Équation spécifiée invalide : '{s:s1}' pour '{s:s2}'"
"CompendiumPageError_SelChoices"	"Ensemble 'choices' manquant pour le choix '{s:s1}' dans la page '{s:s2}' du compendium"
"CompendiumPageError_NoHero"	"Impossible de trouver un héros ayant pour Hero ID '{s:s1}' pour le choix '{s:s2}'"
"CompendiumPageError_Unknown"	"Erreur interne au fonctionnement du compendium. Contactez Valve pour résoudre le problème."
"CompendiumPageError_ImageDL"	"Échec du démarrage du téléchargement de l'image '{s:s1}' du compendium ({s:s2})"
"CompendiumPageError_ImageDLErr"	"Impossible de télécharger l'image du Compendium '%s' ({s:s2})"
"CompendiumPageError_BtnNoElem"	"Aucun bloc 'selection_elements' trouvé pour le bouton '{s:s1}' dans la page '{s:s2}' du compendium"
"CompendiumPageError_BtnBadVal"	"La valeur de la sélection '{s:s1}' dans le bouton '{s:s2}' n'est pas dans la liste de choix de l'index de sélection"
"CompendiumPageError_BtnBadSel"	"Le paramètre 'selection_force_to' de l'élément '{s:s1}' n'est pas dans la liste de choix pour la sélection '{s:s2}'"
"CompendiumPageError_BtnSelIdx"	"'selection_index' manquant ou invalide dans le bouton'{s:s1}' dans la page '{s:s2}' du compendium"
"CompendiumPageError_CmdSelIdx"	"'selection_index' ou 'force_selection_index' manquant ou invalide dans l'élement '{s:s1}' dans la page '{s:s2}' du compendium"
"CompendiumPageError_ImgSelIdx"	"'selection_index' de '{s:s1}' invalide dans l'image '{s:s2}' ."
"CompendiumPageError_ImgShowSelIdx"	"'show_selection_index' de '{s:s1}' invalide dans l'image '{s:s2}' ."
"CompendiumPageError_ImgSelVal"	"Choix de sélection invalide '{s:s1}' dans la section 'show_selection_images' de l'image '{s:s2}'"
"CompendiumPageError_ImgBadStyle"	"Style d'image incorrect '{s:s1}' pour l'image '{s:s2}'."
"CompendiumPageError_DynTxtSel"	"Le texte '{s:s1}' à la page '{s:s2}' contient une % selection_X % invalide. Aucune sélection préenregistrée ne comporte cet index."
"CompendiumPageError_NoTxtList"	"Impossible de trouver une liste de textes nommée '{s:s1}' à la page '{s:s2}'"
"CompendiumPageError_TOCPage"	"table_of_contents_page à la page '{s:s1}' n'existe pas."
"CompendiumPageError_SelIndex"	"Choix '{s:s1}' dans la page '{s:s2}' du compendium sans 'selection_index' ou incorrect."
"CompendiumPageError_SelUsed"	"Le choix '{s:s1}' dans la page '{s:s2}' du compendium n'a pas de 'selection_index' unique."
"CompendiumPageError_SelVal"	"La sélection '{s:s1}' dans la page '{s:s2}' du compendium comporte des choix avec des valeurs identiques"
"CompendiumPageError_SelValInv"	"La sélection '{s:s1}' dans la page '{s:s2}' du compendium a un choix comportant une valeur <= 0. Les valeurs du choix doivent être supérieures à 0."
"CompendiumPageError_SelTTVal"	"La sélection '{s:s1}' dans la page '{s:s2}' du compendium possède une entrée tooltip_data avec une valeur qui ne fait pas partie des choix possibles."
"CompendiumPageError_NoAnswer"	"La sélection '{s:s1}' dans la page '{s:s2}' du compendium ne comporte pas de clé 'answer' ou 'answers' dans sa section 'result'"
"CompendiumPageError_MissAnswer"	"Selection '{s:s1}' in compendium page '{s:s2}' has an 'answer' or 'answers' key that doesn't match any of its choices"
"CompendiumPageError_Timer"	"Le chronomètre '{s:s1}' a un temps Unix invalide."
"CompendiumPageError_UnknownAction"	"L'objet '{s:s1}' fait référence à une action inconnue '{s:s2}'"
"CompendiumPageError_SameElement"	"Le système de visibilité à trouvé plusieurs éléments nommés '{s:s1}' à la page '{s:s2}'"
"CompendiumPageError_DupeKey"	"L'ensemble clef-valeur '{s:s1}' contient plusieurs clefs avec le même nom '{s:s2}'."
"CompendiumError_Template"	"Impossible de trouver le modèle nommé '{s:s1}'"
"CompendiumError_DupeTemplate"	"Plusieurs modèles nommés '{s:s1}' ont été trouvés"
"CompendiumError_NoDefines"	"Le modèles '{s:s1}' nécessite une définition, mais le cas '{s:s2}' de ce dernier n'a pas de bloc 'définition'."
"CompendiumError_MissingDef"	"Le cas dérivé '{s:s1}' ne contient pas la définition nommée '{s:s2}', mais le modèle dont il dérive en a besoin."
"CompendiumError_BadDef"	"Le cas dérivé '{s:s1}' contient une définition indispensable nommée '{s:s2}' qui ne commence pas par '%def', ce qui est nécessaire."
"DOTA_GlobalItems_Companions"	"Compagnons"
"DOTA_GlobalItems_Couriers"	"Coursiers"
"DOTA_GlobalItems_Pets"	"Mascottes"
"DOTA_GlobalItems_World"	"Global"
"DOTA_GlobalItems_Wards"	"Wards"
"DOTA_GlobalItems_Effigies"	"Effigies"
"DOTA_GlobalItems_Weather"	"Effets météo"
"DOTA_GlobalItems_Interface"	"Interface"
"DOTA_GlobalItems_Emoticons"	"Émoticônes"
"DOTA_GlobalItems_LoadingScreens"	"Écrans de chargement"
"DOTA_GlobalItems_HUDs"	"HUDs"
"DOTA_GlobalItems_Audio"	"Audio"
"DOTA_GlobalItems_Announcers"	"Packs d'annonceurs"
"DOTA_GlobalItems_Music"	"Musique"
"DOTA_Search"	"Rechercher"
"DOTA_Start"	"Commencer"
"DOTA_PleaseWait"	"Veuillez patienter..."
"DOTA_ProfileCard_HeroHover"	"Passer la souris pour afficher :"
"DOTA_ChallengeGroup_2_Desc"	"Entraînez-vous avec et contre des héros contrôlés par l'IA dans un environnement permettant de vous entraîner en toute tranquillité."
"DOTA_ChatTab_ToggleSounds"	"Jouer un son lorsque vous recevez un message sur ce canal."
"dota_lobby_balanced_shuffle"	"Mélange équilibré"
"dota_lobby_swap_teams"	"Permuter les équipes"
"dota_lobby_unassigned_players"	"Joueurs non-assignés"
"dota_lobby_broadcast_channels"	"Canaux de diffusion"
"dota_lobby_settings"	"Paramètres de la salle d'attente"
"dota_lobby_settings_edit"	"Modifier"
"dota_lobby_leave"	"Quitter ce lobby"
"DOTA_Custom_Game_View_Lobby_List"	"Voir la liste des lobbies"
"DOTA_Custom_Game_Lobby_List_Title"	"Liste des lobbies"
"DOTA_Custom_Game_Browse_All"	"Parcourir toutes les parties"
"DOTA_Custom_Game_Friends_Ready"	"Amis prêts à jouer"
"DOTA_Custom_Game_Friends_Who_Play"	"Amis en jeu"
"DOTA_Custom_Game_Friends_Playing_Now"	"Amis en train de jouer"
"DOTA_Custom_Game_Browse_Sort"	"Trier :"
"DOTA_Custom_Game_Sort_Popular_Today"	"Les mieux notés (aujourd'hui)"
"DOTA_Custom_Game_Sort_Popular_Week"	"Les mieux notés (cette semaine)"
"DOTA_Custom_Game_Sort_Top_Rated"	"Les mieux notés (tous les temps)"
"DOTA_Custom_Game_Sort_Date"	"Date de publication"
"DOTA_WatchLive_WatchLabel"	"REGARDER :"
"DOTA_WatchLive_ThirdParty"	"TIERS"
"DOTA_WatchLive_Steam"	"STEAM"
"DOTA_WatchLive_InGame"	"EN JEU"
"DOTA_WatchLive_Broadcaster0"	"Regarder {g:dota_persona:b:broadcaster_account_id_0}"
"DOTA_WatchLive_Broadcaster1"	"Regarder {g:dota_persona:b:broadcaster_account_id_1}"
"DOTA_WatchLive_Broadcaster2"	"Regarder {g:dota_persona:b:broadcaster_account_id_2}"
"DOTA_WatchLive_Broadcaster3"	"Regarder {g:dota_persona:b:broadcaster_account_id_3}"
"DOTA_WatchLive_Broadcaster4"	"Regarder {g:dota_persona:b:broadcaster_account_id_4}"
"DOTA_WatchLive_Broadcaster5"	"Regarder {g:dota_persona:b:broadcaster_account_id_5}"
"DOTA_WatchLive_Broadcaster6"	"Regarder {g:dota_persona:b:broadcaster_account_id_6}"
"DOTA_WatchLive_Broadcaster7"	"Regarder {g:dota_persona:b:broadcaster_account_id_7}"
"DOTA_WatchLive_Broadcaster8"	"Regarder {g:dota_persona:b:broadcaster_account_id_8}"
"DOTA_WatchLive_Broadcaster9"	"Regarder {g:dota_persona:b:broadcaster_account_id_9}"
"dota_matchmaking_region_title_confirm"	"Confirmer les régions de matchmaking"
"dota_play_lobby_games"	"Matchs avec lobby"
"dota_play_host_loading"	"Chargement de l'hôte..."
"dota_play_connecting_to_server"	"Connexion..."
"dota_reconnecting"	"Reconnexion..."
"dota_matchmaking_regions_retry"	"Réessayer"
"dota_matchmaking_region_ping_calculating"	"Ping : calcul en cours ..."
"dota_matchmaking_region_ping_failed"	"Ping : échec"
"dota_matchmaking_region_or"	"Ou"
"dota_matchmaking_region_selected_offline"	"Une ou plusieurs région(s) sélectionnée(s) sont temporairement hors ligne."
"dota_matchmaking_region_selected_unreachable"	"Impossible de confirmer la connectivité du réseau avec la/les région(s) sélectionnée(s)."
"dota_matchmaking_region_all_unavailable"	"Échec lors du ping envoyé aux régions. Vérifiez votre connexion Internet."
"dota_matchmaking_region_check_internet"	"Vérifiez votre connexion Internet."
"dota_matchmaking_region_poor_choices"	"Les régions selectionnées auront comme conséquence une connexion lente aux serveurs du jeu."
"dota_settings_networkhud"	"Afficher les informations du réseau"
"dota_settings_fullscreenbrightness"	"Luminosité"
"dota_settings_dashboard_renderquality"	"Tableau de bord de haute qualité"
"dota_settings_lowlatency_audio"	"Détecter la latence audio automatiquement"
"dota_settings_quicktargetattack"	"Attaque rapide"
"dota_settings_chat_whispers"	"Afficher les messages Steam sous forme de chuchotements"
"dota_settings_no_mode_resolutions"	"Aucune résolution prise en charge"
"DOTA_Settings_Tooltip_QuickTargetAttack"	"Appuyer sur la touche d'attaque déclenchera une attaque à la position du pointeur de la souris."
"dota_lobby_browser_header_name"	"Nom du lobby"
"dota_lobby_browser_header_slots"	"Emplacements"
"dota_lobby_browser_header_game_mode"	"Mode de jeu"
"dota_lobby_browser_region"	"Région"
"dota_lobby_browser_lobby_name"	"Nom du lobby"
"DOTA_Friend_Game_Mode_Self"	"Vous êtes dans une partie {s:game_mode}"
"DOTA_Friend_Game_Mode_1_Friend"	"{s:player_name} joue à {s:game_mode}"
"DOTA_Friend_Game_Mode_N_Friends"	"{d:num_friends} amis jouent {s:game_mode}"
"Compendium_DefaultText_TimerTitle_Active"	"LES SÉLECTIONS PRENNENT FIN DANS"
"Compendium_DefaultText_TimerTitle_Expired"	"LES SÉLECTIONS SONT TERMINÉES"
"Compendium_DefaultText_CD_Days"	"Jours"
"Compendium_DefaultText_CD_Hours"	"Heures"
"Compendium_DefaultText_CD_Minutes"	"Minutes"
"Compendium_DefaultText_CD_Seconds"	"Secondes"
"NetGraph_FPS"	"fps : {d:fps}"
"NetGraph_Ping"	"ping : {d:ping}ms"
"NetGraph_Loss"	"pertes : {d:loss}%"
"DOTA_Credits"	"Remerciements"
"DOTA_ActorCredits_1_Name"	"Dee Bradley Baker"
"DOTA_ActorCredits_2_Name"	"Dennis Bateman"
"DOTA_ActorCredits_3_Name"	"Tom Chantler"
"DOTA_ActorCredits_3_Heroes"	"Centaur, Lion, Obsidian Destroyer, Riki, Slark, Tusk, Witch Doctor"
"DOTA_ActorCredits_4_Name"	"Merle Dandridge"
"DOTA_ActorCredits_4_Heroes"	"Legion Commancer, Winter Wyvern"
"DOTA_ActorCredits_5_Name"	"Barry Dennen"
"DOTA_ActorCredits_5_Heroes"	"Chaos Knight, Phantom Lancer, Rubick"
"DOTA_ActorCredits_6_Name"	"Dave Fennoy"
"DOTA_ActorCredits_6_Heroes"	"Batrider, Ember Spirit, Faceless Void, Jakiro, Venomancer, Skeleton King"
"DOTA_ActorCredits_7_Name"	"Jim French"
"DOTA_ActorCredits_7_Heroes"	"Elder Titan"
"DOTA_ActorCredits_8_Name"	"Michael Gregory"
"DOTA_ActorCredits_8_Heroes"	"Bounty Hunter, Clinkz, Silencer"
"DOTA_ActorCredits_9_Name"	"Gin Hammond"
"DOTA_ActorCredits_9_Heroes"	"Crystal Maiden, Drow Ranger, Enchantress, Mirana, Phantom Assassin, Spectre, Vengeful Spirit"
"DOTA_ActorCredits_10_Name"	"John Patrick Lowrie"
"DOTA_ActorCredits_10_Heroes"	"Ancient Apparition, Dark Seer, Doom Bringer, Earthshaker, Pudge, Nevermore, Storm Spirit"
"DOTA_ActorCredits_11_Name"	"Ellen McLain"
"DOTA_ActorCredits_11_Heroes"	"Broodmother, Dead Phophet"
"DOTA_ActorCredits_12_Name"	"Bruce Miles"
"DOTA_ActorCredits_12_Heroes"	"Alchemist, Lifestealer, Omniknight"
"DOTA_ActorCredits_13_Name"	"Linda K. Morris"
"DOTA_ActorCredits_13_Heroes"	"Luna, Naga Siren, Queen of Pain, Templar Assassin"
"DOTA_ActorCredits_14_Name"	"Sam A. Mowry"
"DOTA_ActorCredits_14_Heroes"	"Anti-Mage, Beastmaster, Rattletrap, Necrolyte, Slardar, Warlock"
"DOTA_ActorCredits_15_Name"	"Eric Newsome"
"DOTA_ActorCredits_15_Heroes"	"Chen, Leshrac, Natures Prophet, Razor, Tidehunter, Tiny, Zeus"
"DOTA_ActorCredits_16_Name"	"Nolan North"
"DOTA_ActorCredits_17_Name"	"Dempsey Pappion"
"DOTA_ActorCredits_17_Heroes"	"Magnus, Nyx Assassin, Visage"
"DOTA_ActorCredits_18_Name"	"TJ Ramini"
"DOTA_ActorCredits_18_Heroes"	"Abaddon, Bristleback, Skywrath Mage, Shredder"
"DOTA_ActorCredits_19_Name"	"Harry S. Robins"
"DOTA_ActorCredits_19_Heroes"	"Tinker"
"DOTA_ActorCredits_20_Name"	"Gary Schwartz"
"DOTA_ActorCredits_20_Heroes"	"Lich, Pugna"
"DOTA_ActorCredits_21_Name"	"David Scully"
"DOTA_ActorCredits_21_Heroes"	"Bane, Dazzle, Juggernaut, Morphling, Sand King, Sven, Weaver"
"DOTA_ActorCredits_22_Name"	"Mike Shapiro"
"DOTA_ActorCredits_22_Heroes"	"Oracle"
"DOTA_ActorCredits_23_Name"	"David Sobolov"
"DOTA_ActorCredits_23_Heroes"	"Terrorblade"
"DOTA_ActorCredits_24_Name"	"Jon St. John"
"DOTA_ActorCredits_24_Heroes"	"Axe, Bloodseeker, Enigma, Kunkka"
"DOTA_ActorCredits_25_Name"	"Fred Tatasciore"
"DOTA_ActorCredits_25_Heroes"	"Disruptor, Spirit Breaker, Treant, Undying, Ursa"
"DOTA_ActorCredits_25_Extra"	"Golem du Warlock"
"DOTA_ActorCredits_26_Name"	"Jen Taylor"
"DOTA_ActorCredits_26_Heroes"	"Lina, Medusa, Puck, Windrunner"
"DOTA_ActorCredits_27_Name"	"Tony Todd"
"DOTA_ActorCredits_27_Heroes"	"Dragon Knight, Night Stalker, Viper"
"DOTA_ActorCredits_28_Name"	" "
"DOTA_ActorCredits_28_Heroes"	" "
"DOTA_Custom_Game_Finished_Vote_Title"	"Vote jeu custom"
"DOTA_Custom_Game_Finished_Vote_Question"	"Que pensez-vous de ce jeu custom ?"
"DOTA_TabName_ModsLobbyList"	"Liste des lobbies"
"DOTA_JoinChatChannel_ChannelName"	"Nom du canal"
"DOTA_JoinChatChannel_ChannelMemberCount"	"Membres"
"DOTA_Chat_ChannelMemberCount"	"{d:channel_member_count}"
"DOTA_Trading_UI_Body_Outgoing"	"En attende de la réponse de {s:player_name}..."
"DOTA_GiftWrap_Item"	"Emballage cadeau {g:dota_item_name:gift_item_def}."
"DOTA_GiftWrap_Success_Header"	"Succès"
"DOTA_EquippedItem_AddToShuffle"	"Ajouter au mélange"
"DOTA_EquippedItem_RemoveFromShuffle"	"Supprimer du mélange"
"DOTA_EquippedItem_Unpack_And_AddToShuffle"	"Déballer et ajouter au mélange"
"DOTA_GameplayVersion"	"Version du jeu : <span class=\"VersionNumber\">{s:gameplay_version_number}</span>"
"DOTA_CurrentGameplayVersion"	"6.85"
"DOTA_Recycling_DragItems"	"Déposez vos objets indésirables ici"
"DOTA_Friends_Add_Friend_Tooltip"	"Ajouter à votre liste d'amis"
"dota_settings_voice_always_sample_mic"	"Streamlined Push To Talk"
"dota_settings_voice_always_sample_mic_tooltip"	"Garde le périphérique d'enregistrement vocal actif pour éviter que le jeu ne se fige sur certains ordinateurs."
"DOTA_HeroLoadout_Shuffle_Count"	"Objet(s) dans le mélange : ({i:loadout_items_in_shuffle})"
"DOTA_HeroLoadout_Add_All_To_Shuffle"	"Tout ajouter au mélange"
"DOTA_HeroLoadout_Clear_Shuffle"	"Changer l'équipement"
"DOTA_Treasure_Purchase"	"Acheter un trésor"
"DOTA_Treasure_CharmPurchase"	"Acheter un porte-bonheur"
"DOTA_Treasure_SearchPlaceholder"	"Rechercher des trésors"
"DOTA_Treasure_ViewAll"	"Voir tous les trésors"
"DOTA_Treasure_QuantityOption"	"Qté : {d:quantity}"
"DOTA_Treasure_Gift"	"Cadeau"
"DOTA_Treasure_Open"	"Ouvrir"
"DOTA_Treasure_OpenQuantity"	"{d:owned_quantity}"
"DOTA_Treasure_Owned"	"Possédé"
"DOTA_Treasure_Received"	"Reçu"
"DOTA_Treasure_Autographed"	"Dédicace :"
"DOTA_Treasure_AutographName"	"{s:treasure_autograph_name}"
"DOTA_OpenTreasureTooltip_NormalTitle"	"Contient les objets suivants :"
"DOTA_OpenTreasureTooltip_NoDupeDescription"	"Chaque fois que vous ouvrirez ce trésor, vous recevrez {d:items_per_treasure} des objets ci-dessus. Vous ne recevrez pas de doublons jusqu'à ce que vous en possédiez un de chaque."
"DOTA_OpenTreasureTooltip_DupeDescription"	"Chaque fois que vous ouvrirez ce trésor, vous recevrez {d:items_per_treasure} des objets ci-dessus. Vous ne recevrez pas de doublons avant d'en avoir un de chaque."
"DOTA_OpenTreasureTooltip_RareTitle"	"Et la chance de recevoir des récompenses bonus :"
"DOTA_OpenTreasureTooltip_UnitName"	"{s:unit_name}"
"DOTA_OpenTreasureTooltip_ItemName"	" - {g:dota_item_name:item_def}"
"dota_profile_content_tab_official_info"	"Infos pro"
"dota_profile_oi_preview_warning"	"Cette information ne peut être éditée qu'une fois toutes les deux semaines, assurez-vous donc qu'elle soit correcte avant de mettre à jour !"
"dota_profile_oi_submit_info"	"Envoyer les infos"
"dota_profile_oi_submit_success"	"Succès !"
"Compendium_PreparePublish"	"Préparer pour publier"
"Compendium_PublishFinishedTitle"	"Publication réussie"
"DOTA_Treasure"	"Trésor"
"DOTA_Blog"	"Nouveau dans Dota 2"
"DOTA_SortBy"	"Trier par"
"DOTA_SortOption_Owned"	"Possedé"
"DOTA_SortOption_Price"	"Prix"
"Action_Use"	"Utiliser"
"DOTA_BadgeLevel"	"{d:badge_level}"
"DOTA_AHC_CurrentHero"	"Héros actuel"
"DOTA_AHC_CurrentHeroName"	"{s:current_hero_name}"
"DOTA_AHC_NextHeroName"	"{s:next_hero_name}"
"DOTA_AHC_TotalAttemptsValue"	"{d:challenge_total_attempts} parties"
"DOTA_AHC_EquivalentWorldAverageValue"	"{d:challenge_average_total_attempts} parties"
"DOTA_AHC_FullChallengesCompletedValue"	"{d:full_challenges_completed}"
"DOTA_AHC_BestFullChallengeValueNone"	"N/A"
"DOTA_AHC_BestFullChallengeValue"	"{d:best_full_challenge} parties"
"DOTA_AHC_FullChallengeAverageValue"	"{s:full_challenge_average} parties"
"DOTA_AHC_ChallengeTrophyName"	"{s:challenge_trophy_name}"
"DOTA_AHC_ChallengeTrophyLevel"	"Niveau {d:challenge_trophy_level}"
"DOTA_ItemSet_Count_text"	"{d:item_current_group} / {d:item_group_count}"
"dota_settings_enable_console"	"Activer la console"
"DOTA_HeroLoadout_About"	"À propos"
"DOTA_HeroLoadout_Guides"	"Guides"
"DOTA_HeroLoadout_Roles"	"Rôles"
"DOTA_HeroLoadout_Biography"	"Biographie"
"DOTA_Armory_ClearFilter"	"Supprimer les filtres"
"DOTA_Armory_ContextMenu_Tags"	"Tags..."
"DOTA_EffigyEditor_CreateEffigy"	"Créer une effigie"
"DOTA_EffigyEditor_PoseEffigy"	"Pose de l'effigie"
"DOTA_EffigyEditor_Model"	"Héros"
"DOTA_EffigyEditor_Inscription"	"Inscription :"
"DOTA_EffigyEditor_Animation"	"Animation :"
"DOTA_EffigyEditor_Frame"	"Sélectionnez une image :"
"dota_profile_content_tab_all_hero_challenge"	"Défi All-Hero"
"DOTA_tooltip_econ_item_modifier_announcer"	"Annonceur"
"DOTA_tooltip_econ_item_modifier_HUD"	"HUD"
"DOTA_tooltip_econ_item_modifier_health_bar"	"Barre de vie"
"DOTA_tooltip_econ_item_modifier_ability_name"	"Nom de la capacité"
"DOTA_tooltip_econ_item_modifier_loading_screen"	"Écran de chargement"
"DOTA_tooltip_econ_item_modifier_cursor_pack"	"Pack de curseurs"
"DOTA_tooltip_econ_item_modifier_portrait"	"Portrait"
"DOTA_tooltip_econ_item_modifier_ambient_effects"	"Effets ambiants"
"DOTA_tooltip_econ_item_modifier_spell_effects"	"Effets des sorts"
"DOTA_tooltip_econ_item_modifier_model"	"Modèle"
"DOTA_tooltip_econ_item_modifier_wearable"	"Équipements"
"DOTA_tooltip_econ_item_modifier_courier"	"Coursier"
"DOTA_tooltip_econ_item_modifier_pet"	"Mascotte"
"DOTA_tooltip_econ_item_modifier_weather"	"Météo"
"DOTA_tooltip_econ_item_modifier_sound"	"Son"
"DOTA_tooltip_econ_item_modifier_soundscape"	"Ambiance sonore"
"DOTA_tooltip_econ_item_modifier_voice"	"Voix"
"DOTA_tooltip_econ_item_modifier_icon"	"Icône"
"DOTA_econ_item_details_style_label"	"Style :"
"Compendium_Retry"	"Réessayer"
"Compendium_preview_click"	"Cliquez ici pour activer !"
"Compendium_to_next_level"	"PROCHAIN NIVEAU"
"Compendium_LevelupPts_Singular"	"1 Pt"
"Compendium_LevelupPts_Plural"	"{d:next_comp_level} Pts"
"DOTA_GlobalItems_MegaKill"	"Packs Mega-Kill"
"DOTA_Treasure_BonusReward"	"Récompense bonus"
"DOTA_OpenTreasureTooltip_ExtraItems"	"... et {d:extra_items_count} en plus !"
"DOTA_AASystem_Green"	"Temps de jeu en ligne accumulé : {s:playtime}. Vous jouez actuellement dans des délais raisonnables pour votre santé. Amusez-vous bien !"
"DOTA_AASystem_Yellow"	"Temps de jeu en ligne accumulé : {s:playtime}. Vous avez dépassé le temps de jeu raisonnable pour votre santé. Veuillez prendre le temps de faire une pause !"
"DOTA_AASystem_Red"	"Temps de jeu en ligne accumulé : {s:playtime}. Vous avez dépassé le temps de jeu raisonnable pour votre santé. Nous vous recommandons de vous déconnecter et de faire une pause !"
"DOTA_AntiAddiction_CompleteInfoNow"	"Entrez vos informations"
"DOTA_AntiAddiction_Label_Green"	"Temps de jeu : {s:playtime} (En bonne santé)"
"DOTA_AntiAddiction_Label_Yellow"	"Temps de jeu : {s:playtime} (Peut contrevenir à une bonne santé)"
"DOTA_AntiAddiction_Label_Red"	"Temps de jeu : {s:playtime} (Dépassé)"
"DOTA_Workshop_Browse"	"Parcourir"
"DOTA_Workshop_TextureName_color"	"Couleur"
"DOTA_Workshop_MaterialName_NormalTexture"	"Carte normale"
"DOTA_Workshop_Model"	"Modèle"
"DOTA_Workshop_Animations"	"Animations"
"DOTA_Workshop_Misc"	"Divers"
"DOTA_Workshop_SubmissionType_Ward"	"Ward"
"DOTA_Workshop_ImportNoP4"	"Importer (Sans P4)"
"DOTA_Workshop_SaveSettings"	"Enregistrer les paramètres"
"DOTA_Workshop_LoadSettings"	"Charger les paramètres"
"DOTA_Workshop_Ready"	"Prêt"
"DOTA_Workshop_Optional"	"Facultatif"
"DOTA_Workshop_LOD1Title"	"Géométrie en jeu"
"DOTA_Workshop_Texture_Title"	"Fichiers textures"
"DOTA_Workshop_Models_Title"	"Modèles"
"DOTA_Workshop_Materials_Title"	"Matériels"
"DOTA_Workshop_Marketing_Title"	"Marketing"
"DOTA_Workshop_Particles_Title"	"Particules"
"DOTA_Workshop_Images_Title"	"Images"
"DOTA_Workshop_AbilityIcons_Title"	"Icônes de capacité"
"DOTA_UI_LoadScreen_16_9"	"Format d'image 16:9"
"DOTA_UI_LoadScreen_16_10"	"Format d'image 16:10"
"DOTA_UI_LoadScreen_4_3"	"Format d'image 4:3"
"DOTA_Workshop_ChatEmoticon_DefaultFrame"	"Image par défaut"
"DOTA_Workshop_ChatEmoticon_DefaultFrame_Desc"	"L'image à afficher lorsque l’émoticône n'est pas animée. De 0 à nombre d'images moins un. Utiliser -1 pour automatiquement choisir la dernière image. Si rien n'est spécifié, la première image (0) sera utilisée."
"DOTA_Workshop_File_ChatEmoticon"	"Image source (fichiers .png)"
"DOTA_Workshop_Animation_Title"	"Animations"
"DOTA_Workshop_Animation_UIBlock"	"Animations %s1"
"DOTA_Workshop_Preview_Anim"	"Animation :"
"DOTA_Workshop_Preview_Gesture"	"Overlay :"
"DOTA_Workshop_Preview_Skin"	"Texture :"
"DOTA_Workshop_Preview_Model"	"Modèle :"
"DOTA_Workshop_Preview_NoAttachment"	"Aucun"
"DOTA_Workshop_Preview_TogglePedestal"	"Activer le piédestal"
"DOTA_Workshop_Preview_ToggleUI"	"Activer interface"
"DOTA_Workshop_ImportError_Validation"	"Échec de la validation"
"DOTA_Workshop_ZipError"	"Erreur de fichier !"
"DOTA_Workshop_Error_NoManifest"	"Le fichier Zip ne contient pas manifest.txt."
"DOTA_Workshop_Quicksave_Fail"	"Échec de l'enregistrement"
"DOTA_Workshop_Quickload_Fail"	"Échec du chargement"
"DOTA_Workshop_Import"	"Importer"
"DOTA_Workshop_Importing"	"Importation"
"DOTA_Workshop_Import_Success"	"IMPORTATION RÉUSSIE"
"DOTA_Workshop_Import_Failed"	"ÉCHEC DE L'IMPORTATION"
"DOTA_Workshop_Animation_Run"	"Course"
"DOTA_Workshop_Animation_Die"	"Mort"
"DOTA_Workshop_Animation_Die2"	"Mort alternative"
"DOTA_Workshop_Animation_Attack"	"Attaque"
"DOTA_Workshop_Animation_AttackB"	"Attaque alternative"
"DOTA_Workshop_Animation_Flail_Desc"	"Une animation utilisée lorsque l'unité est rendue inoffensive et se trouve en mouvement  (ex. dans un cyclone, sous un effet \"black hole\" ou encore lancée en l'air)."
"DOTA_Workshop_LD_Trueform_AbilityUlt"	"DRUID FORM"
"DOTA_Workshop_Animation_Victory"	"VICTOIRE"
"DOTA_Workshop_Animation_Defeat"	"DÉFAITE"
"DOTA_Workshop_Animation_RunOutOfRange"	"COURSE (HORS DE PORTÉE)"
"DOTA_Workshop_BackgroundColor"	"Couleur de l'arrière-plan"
"DOTA_Workshop_BackgroundTexture"	"Texture d'arrière-plan"
"DOTA_Workshop_Camera"	"Caméra"
"DOTA_Workshop_GameDay"	"Jour"
"DOTA_Workshop_GameNight"	"Nuit"
"DOTA_Workshop_Next"	"Suivant"
"DOTA_Workshop_Portrait"	"Portrait"
"DOTA_Workshop_Prev"	"Précédent"
"DOTA_Workshop_ShadowColor"	"Couleur de l'ombre"
"DOTA_Workshop_Submit"	"Envoyer"
"DOTA_Workshop_Texture"	"Texture"
"DOTA_Workshop_Err_InvalidFile"	"Fichier invalide : '%1'"
"DOTA_Workshop_LoadSession"	"Charger"
"DOTA_Workshop_SaveSession"	"Sauvegarder"
"DOTA_Workshop_LoadSessionError"	"Erreur de chargement de session"
"DOTA_Workshop_SaveSessionError"	"Erreur de sauvegarde de session"
"DOTA_Workshop_Err_Misc"	"Erreur interne (%1)"
"DOTA_Filter_Field_Category"	"Tags"
"DOTA_Armory_Attributes"	"Attributs"
"DOTA_Event_Level"	"Niveau"
"DOTA_Done"	"Terminé"
"DOTA_Treasure_OpenAnother"	"Ouvrir un autre"
"DOTA_Treasure_OpenTreasure"	"Ouvrir le trésor"
"DOTA_Treasure_OpenNoDupe"	"Chaque trésor contient {d:items_per_treasure} des items normaux affichés. Vous ne recevrez pas de doublons tant que vous n'aurez pas un item différent de chaque. Si vous avez de la chance, vous pourrez obtenir un item rare."
"DOTA_Treasure_OpenDupe"	"Chaque trésor contient {d:items_per_treasure} des items normaux affichés. Il est possible que vous receviez des doublons. Si vous avez de la chance, vous pourrez obtenir un item rare."
"DOTA_Treasure_OpenFailed_NoItem"	"Aucun trésor à ouvrir dans votre inventaire."
"DOTA_Treasure_OpenFailed_NoItemsReceived"	"Impossible d'obtenir la liste des objets obtenus pour ce trésor."
"DOTA_Treasure_OpenSuccess"	"Félicitations ! Vous avez reçu :"
"DOTA_Custom_Game_Created_By"	"Crée par <b>{g:dota_persona:author}</b>"
"DOTA_Custom_Game_Dedicated_Servers"	"Serveurs dédiés"
"DOTA_TabName_Heroes"	"Héros"
"DOTA_Profile_Edit"	"Modifier le profil"
"DOTA_Profile_ViewSteamProfile"	"Afficher le profil Steam"
"DOTA_TrophyXPProgress"	"{d:trophy_xp} / {d:total_trophy_xp}PT"
"DOTA_TrophyDetails_XP"	"{d:trophy_details_xp}PT"
"DOTA_TrophyPlusProfileXP"	"+{d:trophy_xp} points de trophée"
"DOTA_WatchReplays_Game1"	"Partie 1"
"DOTA_WatchReplays_Game2"	"Partie 2"
"DOTA_WatchReplays_Game3"	"Partie 3"
"DOTA_WatchReplays_Game4"	"Partie 4"
"DOTA_WatchReplays_Game5"	"Partie 5"
"DOTA_WatchReplayError_DoesNotExist"	"Ce match n'existe pas."
"DOTA_WatchTournament_BestOf3"	"Meilleur des 3"
"DOTA_WatchTournament_BestOf5"	"Meilleur des 5"
"DOTA_ShuffledItem_Label"	"En mélange"
"DOTA_EquippedItem_Button_SingleItemShuffle"	"Équiper"
"DOTA_Feed_Title"	"Activité des amis"
"DOTA_Armory_Category_Treasures"	"Trésors"
"DOTA_Armory_Category_Gifts"	"Cadeaux"
"DOTA_Armory_Category_Bundles"	"Bundles"
"DOTA_Armory_Category_Compendiums"	"Compendiums"
"DOTA_Armory_ContextMenu_AddShuffle"	"Ajouter au mélange"
"DOTA_Armory_ContextMenu_RemoveShuffle"	"Supprimer du mélange"
"DOTA_Armory_Filter_Tradeable"	"ÉCHANGEABLE"
"DOTA_Armory_Filter_Duplicate"	"EN DOUBLE"
"DOTA_Armory_Filter_WillExpire"	"EXPIRERA"
"DOTA_Armory_Filter_Rarity"	"RARETÉ"
"DOTA_Armory_Filter_Quality"	"QUALITÉ"
"DOTA_Armory_Filter_Tags"	"TAGS"
"DOTA_Armory_Filter_Delete"	"Supprimer le filtre"
"DOTA_Armory_Filter_CreateNew"	"Nouveau filtre..."
"DOTA_Armory_Filter_FilterName"	"Nom du filtre"
"Compendium_LeagueID"	"ID de ligue"
"DOTA_Popup_Item_Received_Header_FoundInCrate"	"Vous avez reçu un objet !"
"DOTA_Popup_Item_Received_Label_IOfN"	"{d:item_i} de {d:item_n}"
"dota_casters"	"Commentateurs"
"LobbySetting_League"	"Ligue"
"LobbySetting_League_Value"	"{s:lobbysetting_league}"
"DOTA_WatchLive_Purchase"	"Ticket {g:dota_item_price:ticket_itemdef}"
"DOTA_WatchLive_Activate"	"Activer le ticket"
"DOTA_WatchLive_LoadMore"	"Afficher plus"
"DOTA_WatchReplays_Pending"	"En attente..."
"DOTA_WatchReplays_Downloading"	"Téléchargement...{i:download_pct}%"
"DOTA_WatchReplays_Decompressing"	"Décompression...{i:decompress_pct}%"
"LoadingScreenCastersInfo"	"Commentateurs : {i:casters_loaded}/{i:casters_total}"
"DOTA_Armory_ContextMenu_EquipSet"	"S'équiper de l'ensemble"
"DOTA_Armory_Tag1_Default"	"Tag 1"
"DOTA_Armory_Tag2_Default"	"Tag 2"
"DOTA_Armory_Tag3_Default"	"Tag 3"
"DOTA_Armory_Tag4_Default"	"Tag 4"
"DOTA_Armory_Tag5_Default"	"Tag 5"
"DOTA_Armory_Tag6_Default"	"Tag 6"
"DOTA_Armory_Tag7_Default"	"Tag 7"
"DOTA_Armory_Tag8_Default"	"Tag 8"
"dota_page_match_details_replay_existence_decompressing"	"Décompression..."
"DOTA_Workshop_TextureName_trans"	"Transparence"
"DOTA_Workshop_TextureName_metalnessmask"	"Métallisé"
"DOTA_Workshop_TextureDetails_normal"	"Carte normale"
"DOTA_Workshop_Ward_Model"	"Modèle de Ward"
"DOTA_Workshop_CreateNewItem"	"Créer un nouvel objet"
"DOTA_PreviewSounds_ExampleSounds"	"Exemple de sons"
"DOTA_Treasure_FilterAll"	"Tous"
"DOTA_Workshop_Tags_SingleItem"	"Objet unique"
"DOTA_Trophies_ViewMyCollection"	"Ma collection"
"DOTA_Custom_Game_About"	"À propos"
"DOTA_Custom_Game_Updates"	"Mises à jour"
"DOTA_EventName_International2014"	"The International 2014"
"DOTA_EventName_International2015"	"The International 2015"
"DOTA_EventName_FallMajor2015"	"Automne 2015"
"dota_lobby_host"	"Salle d'attente de l'hôte : {s:lobby_host_name}"
"DOTA_econ_item_details_styles_header"	"Styles"
"DOTA_econ_item_details_style_name"	"{s:style_name}"
"DOTA_econ_item_details_tooltip_lock_reason"	"{s:style_lock_reason}"
"DOTA_econ_item_details_description_header"	"Description"
"DOTA_econ_item_details_description_reset"	"Réinitialiser"
"DOTA_econ_item_details_description_edit"	"Modifier"
"DOTA_Workshop_SubmitUpdate"	"Soumettre une mise à jour"
"DOTA_Workshop_SelectAbility"	"Sélectionnez une capacité"
"DOTA_Workshop_SubmissionType_HudSkin"	"Skin Hud"
"DOTA_Workshop_Imported_S1MaskOverwrite_Text"	"AVERTISSEMENT\nÊtes-vous sûr de vouloir écraser les fichiers suivants ?\n%1"
"DOTA_Workshop_SaveSessionPrompt_Text"	"Sauvegarder votre session actuelle ?"
"UI_File_Filter_PNG"	"Fichiers PNG (*.png)"
"DOTA_Teams_WindowTitle"	"ÉQUIPES"
}
