"dota"
{
"DOTA_Accept"	"Приемане"
"DOTA_Cancel"	"Отказ"
"DOTA_Console"	"Конзола"
"DOTA_Create"	"Създаване"
"DOTA_Decline"	"Отхвърляне"
"DOTA_Error"	"Грешка"
"DOTA_Join"	"Присъединяване"
"DOTA_Leave"	"Напускане"
"DOTA_New"	"Ново"
"DOTA_Ok"	"Добре"
"DOTA_Sale"	"Разпродажба"
"DOTA_Close"	"Затваряне"
"DOTA_Continue"	"Продължаване"
"DOTA_Add"	"Добавяне"
"DOTA_Edit"	"Редактиране"
"DOTA_Enable"	"Включване"
"DOTA_Disable"	"Изключване"
"DOTA_Refresh"	"Опресняване"
"DOTA_Loading"	"Зареждане"
"DOTA_None"	"Няма"
"DOTA_Customize"	"Персонализиране"
"DOTA_AcceptChanges"	"Приемане на промените"
"Unknown"	"Неизвестно"
"UI_Yes"	"Да"
"UI_No"	"Не"
"UI_File_Filter_Any"	"Всички файлове (*.*)"
"DOTA_MainMenu_Heroes"	"Герои"
"DOTA_MainMenu_Watch"	"Наблюдаване"
"DOTA_MainMenu_Learn"	"Обучение"
"DOTA_MainMenu_Mods"	"Персонализирани игри"
"DOTA_TabName_GlobalItems"	"Глобални предмети"
"DOTA_TabName_Treasury"	"Съкровищница"
"DOTA_TabName_Armory"	"Оръжейна"
"DOTA_ConfirmQuit"	"Потвърждаване на излизането"
"DOTA_ConfirmQuitDesc"	"Наистина ли желаете да излезете от Dota 2?"
"DOTA_ConfirmQuitDescUnsafe"	"Напускането на игра преди приключването ѝ е възможно да я развали за останалите играчи. Наистина ли желаете да излезете от Dota 2?"
"DOTA_InvalidPersonaName"	"[неизвестно]"
"DOTA_Friends_WindowTitle"	"ПРИЯТЕЛИ"
"DOTA_FriendsCategory_PlayingDota"	"В Dota <font color='#ACEBA9'>({d:friend_count})</font>"
"DOTA_FriendsCategory_Online"	"На линия <font color='#6a9dcc'>({d:friend_count})</font>"
"DOTA_FriendsCategory_Pending"	"Висящи <font color='#eeee82'>({d:friend_count})</font>"
"DOTA_FriendsCategory_Offline"	"Извън линия <font color='#676666'>({d:friend_count})</font>"
"DOTA_Friends_Empty"	"Списъкът Ви с приятели в момента е празен"
"DOTA_FriendsMenu_Tooltip_NoneReady"	"Приятели"
"DOTA_UserName"	"{g:dota_persona:user_account_id}"
"DOTA_UserNamePro"	"{g:dota_persona_pro:user_account_id}"
"DOTA_UserNickname"	"{g:dota_persona_nickname:user_account_id}"
"DOTA_UserRichPresence"	"{s:user_rich_presence}"
"DOTA_ProfileCard_StatTitle_SoloRank"	"Личен рейтинг"
"DOTA_ProfileCard_StatTitle_PartyRank"	"Колективен рейтинг"
"DOTA_ProfileCard_StatTitle_Wins"	"Победи"
"DOTA_ProfileCard_StatTitle_Commends"	"Препоръки"
"DOTA_ProfileCard_StatTitle_GamesPlayed"	"Мачове"
"DOTA_ProfileCard_StatTitle_FirstMatchDate"	"Първи мач"
"DOTA_ProfileCard_StatValue_Int"	"{d:stat_value}"
"DOTA_ProfileCard_StatValue_Date"	"{t:s:stat_value}"
"DOTA_ProfileCard_StatValue_String"	"{s:stat_value}"
"DOTA_ProfileCard_SlotTab_Trophies"	"Трофеи"
"DOTA_ProfileCard_SlotTab_Items"	"Оръжейна"
"DOTA_ProfileCard_SlotTab_Heroes"	"Герои"
"DOTA_ProfileCard_SlotTab_Emoticons"	"Емотикони"
"DOTA_ProfileCard_NoTrophies"	"Няма достъпни трофеи."
"DOTA_ProfileCard_NoItems"	"Няма достъпни предмети."
"DOTA_ProfileCard_HeroOnly"	"Само герой"
"DOTA_ProfileCard_HeroShowWins"	"Показване на победи"
"DOTA_ProfileCard_HeroShowWinsAndLosses"	"Показване на победи и загуби"
"DOTA_ProfileCard_ItemSearchPrefix"	"Търсене за:"
"DOTA_ProfileCard_ItemSearchPlaceholder"	"Предмети по име"
"DOTA_ProfileCard_ItemArmoryLink"	"Преглед на цялата оръжейна"
"DOTA_HeroTooltip_HeroName"	"{s:hero_name}"
"DOTA_HeroTooltip_HeroRecord"	"{s:hero_wins_string}, {s:hero_losses_string}"
"DOTA_ProfileCard_HeroSearchPlaceholder"	"Търсене по име на герой"
"DOTA_Wins_Singular"	"1 победа"
"DOTA_Wins_Plural"	"{d:hero_wins} победи"
"DOTA_Losses_Singular"	"1 загуба"
"DOTA_Losses_Plural"	"{d:hero_losses} загуби"
"DOTA_Profile_TotalGames"	"Общо игри"
"DOTA_Profile_Solo_MMR"	"Личен рейтинг"
"DOTA_Profile_Team_MMR"	"Отборен рейтинг"
"DOTA_Profile_Party_MMR"	"Колективен рейтинг"
"DOTA_Profile_VictoryCount"	"Победи"
"DOTA_Profile_ProfilePage"	"Профил"
"DOTA_Profile_TrophyPage"	"Трофеи"
"DOTA_Profile_RecentGamesPage"	"Скорошни игри"
"DOTA_Profile_HeroPage"	"Герои"
"DOTA_Profile_PlayStyle"	"Стил на игра"
"DOTA_Profile_MostRecent"	"Последна(и) {s:num_style_games} игра(и)"
"DOTA_Profile_RecentActivity"	"Скорошна дейност"
"DOTA_Profile_Fighting"	"Сражаване"
"DOTA_Profile_Fighting_TooltipTitle"	"Сражаване"
"DOTA_Profile_Fighting_Tooltip"	"Играчи, които се сражават в много битки с вражеските герои."
"DOTA_Profile_Farming"	"Фермене"
"DOTA_Profile_Farming_TooltipTitle"	"Фермене"
"DOTA_Profile_Farming_Tooltip"	"Играчи, които събират злато от убиването на крийпове."
"DOTA_Profile_Supporting"	"Поддържане"
"DOTA_Profile_Supporting_TooltipTitle"	"Поддържане"
"DOTA_Profile_Supporting_Tooltip"	"Играчи, които поддържат своя отбор с лечение, пазители и предмети."
"DOTA_Profile_Tooltip_Value"	"{s:CurrentStatValue}"
"DOTA_Profile_Tooltip_Comparison"	"{s:CurrentComparisonValue}"
"DOTA_Profile_StatsCompare"	"Сравнение с моите статистики"
"DOTA_Profile_Self"	"За мен"
"DOTA_Profile_GPM"	"Средно ЗВМ"
"DOTA_Profile_XPM"	"Средно ОВМ"
"DOTA_Profile_LH"	"Средно последни удари"
"DOTA_Profile_TripleKills"	"Тройни убийства"
"DOTA_Profile_FirstBlood"	"Първа кръв"
"DOTA_Profile_FirstBled"	"Първи убит"
"DOTA_Profile_CourierKills"	"Убити куриери"
"DOTA_Profile_Aegises"	"Откраднати Aegises"
"DOTA_Profile_CheeseEaten"	"Изядени сирена"
"DOTA_Profile_GPMValue"	"{s:GPM}"
"DOTA_Profile_XPMValue"	"{s:XPM}"
"DOTA_Profile_LHValue"	"{s:LH}"
"DOTA_Profile_RampagesValue"	"{d:Rampages}"
"DOTA_Profile_TripleKillsValue"	"{d:TripleKills}"
"DOTA_Profile_FirstBloodValue"	"{d:FirstBlood}"
"DOTA_Profile_FirstBledValue"	"{d:FirstBled}"
"DOTA_Profile_CourierKillsValue"	"{d:CourierKills}"
"DOTA_Profile_AegisesValue"	"{d:Aegises}"
"DOTA_Profile_CheeseEatenValue"	"{d:CheeseEaten}"
"DOTA_Profile_CreepStackValue"	"{d:CreepStack}"
"DOTA_Profile_GPMLocalValue"	"{s:GPMLocal}"
"DOTA_Profile_XPMLocalValue"	"{s:XPMLocal}"
"DOTA_Profile_LHLocalValue"	"{s:LHLocal}"
"DOTA_Profile_RampagesLocalValue"	"{d:RampagesLocal}"
"DOTA_Profile_TripleKillsLocalValue"	"{d:TripleKillsLocal}"
"DOTA_Profile_FirstBloodLocalValue"	"{d:FirstBloodLocal}"
"DOTA_Profile_FirstBledLocalValue"	"{d:FirstBledLocal}"
"DOTA_Profile_CourierKillsLocalValue"	"{d:CourierKillsLocal}"
"DOTA_Profile_AegisesLocalValue"	"{d:AegisesLocal}"
"DOTA_Profile_CheeseEatenLocalValue"	"{d:CheeseEatenLocal}"
"DOTA_Profile_CreepStackLocalValue"	"{d:CreepStackLocal}"
"DOTA_RecentGames_Title"	"Скорошни игри"
"DOTA_RecentGames_TimeStamp"	"Дата/час"
"DOTA_RecentGames_HeroSelection"	"Игран герой"
"DOTA_RecentGames_GameResult"	"Резултат"
"DOTA_RecentGames_GameLength"	"Времетраене"
"DOTA_RecentGames_Team"	"Отбор"
"DOTA_RecentGames_GameType"	"Тип"
"DOTA_RecentGames_Items"	"Предмети"
"DOTA_RecentGame_Timestamp_Entry"	"{t:s:timestamp} {t:t:timestamp}"
"DOTA_RecentGame_Duration"	"{t:d:duration}"
"DOTA_RecentGame_Downloading"	"{s:DownloadPercent} сваляне"
"DOTA_RecentGame_Watch"	"Гледане на повторението"
"DOTA_RecentGame_NoReplay"	"Няма повторение"
"DOTA_RecentGame_Expired"	"Повторението е изтекло"
"DOTA_RecentGame_Download"	"Сваляне на мача"
"DOTA_RecentGame_Pending"	"Повторението е висящо"
"DOTA_RecentGame_Unavailable"	"Повторението е недостъпно"
"DOTA_RecentGame_MatchID"	"Мач № {s:match_id}"
"DOTA_No_Team_Name"	"--"
"DOTA_TrophyCount"	"{d:trophy_count} трофей"
"DOTA_TrophiesCount"	"{d:trophy_count} трофея"
"DOTA_TrophyCount_Number"	"{d:trophy_count}"
"DOTA_TrophyCount_NoNum"	"Трофей"
"DOTA_TrophiesCount_NoNum"	"Трофеи"
"DOTA_Trophies_ViewAll"	"Всички"
"DOTA_TrophyName"	"{s:trophy_name}"
"DOTA_TrophyCategory"	"{s:trophy_category}"
"DOTA_TrophyDescription"	"{s:trophy_description}"
"DOTA_TrophyXP"	"{d:trophy_xp}<span class=\"TrophyPointTextSmall\">ТТ</span>"
"DOTA_NextTrophy"	"Следваща награда"
"DOTA_NewPlayerQuestion_Title"	"ДОБРЕ ДОШЛИ В DOTA 2"
"DOTA_PlayerOriginQuestion_Question"	"За да подобрите игралното си преживяване, моля, споделете колко сте запознати с Dota 2 и сходни игри:"
"DOTA_PlayerOriginQuestion_BeginnerButton"	"Аз съм начинаещ."
"DOTA_PlayerOriginQuestion_RTSButton"	"Играл съм стратегии в реално време."
"DOTA_PlayerOriginQuestion_MOBAButton"	"Играл съм сходни на Dota 2 игри."
"DOTA_PlayerOriginQuestion_Dota2Button"	"Играл съм Dota 2."
"DOTA_PlayerOriginQuestion_MOBAExplanation"	"Изберете играта, с която сте запознати най-добре:"
"DOTA_OtherGames_LOL"	"League of Legends"
"DOTA_OtherGames_DOTA"	"DotA 1"
"DOTA_OtherGames_HON"	"Heroes of Newerth"
"DOTA_OtherGames_Smite"	"Smite"
"DOTA_OtherGames_Other"	"Друга игра"
"DOTA_PlayerOriginQuestion_ConfirmationButton"	"НЕКА ДА ИГРАЕМ"
"DOTA_Challenges_Title"	"Обучение"
"DOTA_ChallengeGroup_1_Title"	"Обучителни мачове с ботове"
"DOTA_LearnGuidedBotMatches_Title"	"Обучителни мачове с ботове"
"FileOpenDialog_Save"	"Запазване"
"FileOpenDialog_Select"	"Избиране"
"DOTA_FindingMatch"	"Намиране на мач ( {s:find_match_time} )"
"DOTA_FindMatchTime"	"{s:find_match_time}"
"DOTA_Create_Lobby"	"Създаване на лоби"
"DOTA_LobbyStartGame"	"Стартиране на играта"
"DOTA_FindMatchStatus"	"{s:searching_matchtype} / {s:searching_gamemodes} / {s:searching_region}"
"StoreCheckout_NoItems"	"Вашата кошница е празна!"
"StoreCheckout_TooManyItems"	"Имате твърде много предмети в кошницата!"
"StoreCheckout_Loading"	"Проверяване…"
"StoreCheckout_Unavailable"	"Касата е недостъпна в този момент."
"StoreCheckout_Fail"	"Магазинът на играта в момента е затворен."
"StoreCheckout_InvalidParam"	"Някой програмист е оплескал работата! Беше предаден невалиден параметър към координатора в играта. Моля, опитайте покупката отново."
"StoreCheckout_InternalError"	"Изглежда има грешка при инициализирането или актуализирането на транзакцията Ви. Моля, изчакайте една минута и опитайте отново или се свържете с поддръжката за помощ."
"StoreCheckout_ContactSupport"	"Възникна грешка с транзакцията Ви. Моля, свържете се с поддръжката за помощ."
"StoreCheckout_NotApproved"	"Координаторът на играта не одобри транзакцията Ви със Steam. Моля, опитайте покупката отново по-късно."
"StoreCheckout_NotLoggedin"	"Трябва да сте влезли в Steam, за да може да завършите покупката."
"StoreCheckout_WrongCurrency"	"Валутата за транзакция не съвпада с тази в портфейла Ви."
"StoreCheckout_NoAccount"	"Вашият Steam акаунт в момента е недостъпен. Моля, опитайте тази покупка отново по-късно."
"StoreCheckout_InsufficientFunds"	"Нямате достатъчно средства, за да завършите покупката."
"StoreCheckout_TimedOut"	"Времето за тази транзакция изтече. Моля, опитайте да закупите отново."
"StoreCheckout_SteamAccountDisabled"	"Вашият Steam акаунт е изключен и не може да направи покупката."
"StoreCheckout_SteamAccountNoPurchase"	"Транзакции чрез Steam портфейл бяха изключени на този акаунт."
"StoreCheckout_OldPriceSheet"	"Локалният продуктов списък не е актуален. Заявка за подновяване."
"StoreCheckout_TransactionNotFound"	"Номерът на тази транзакция не беше намерен от координатора на играта. Моля, опитайте покупката отново."
"StoreCheckout_TransactionCompleted"	"Транзакцията завършена!\\\nНаслаждавайте се на плячката!"
"StoreCheckout_CompleteButUnfinalized"	"Не можахме да потвърдим успех. Ако е била успешна, Вашите предмети ще бъдат доставени по-късно."
"StoreCheckout_NotEnoughRoom"	"Нямате достатъчно място в оръжейната, за да купите толкова много предмети."
"StoreCheckout_ContactSupport_Dialog_Title"	"Предупреждение"
"StoreCheckout_ContactSupport_Dialog_Btn"	"Свържете се"
"StoreCheckout_LimitedQuantityItemsUnavailable"	"Предмет, който се опитвате да купите, е разпродаден или недостъпен в момента."
"DOTA_AbilityTooltip_Name"	"{s:name}"
"DOTA_AbilityTooltip_Level"	"Ниво {s:level}"
"DOTA_AbilityTooltip_Description"	"{s:description}"
"DOTA_AbilityTooltip_ScepterDescription"	"{s:scepterdescription}"
"DOTA_AbilityTooltip_ExtraDescription"	"{s:extradescription}"
"DOTA_AbilityTooltip_Attributes"	"{s:attributes}"
"DOTA_AbilityTooltip_Cooldown"	"{s:cooldown}"
"DOTA_AbilityTooltip_ManaCost"	"{s:manacost}"
"DOTA_AbilityTooltip_Lore"	"{s:lore}"
"DOTA_AbilityTooltip_BuildComment"	"{s:buildcomment}"
"DOTA_PendingInvitesTooltip_NonLeader"	"Кликнете, за да прегледате поканите."
"DOTA_Chat_ChannelName"	"{s:channel_name}"
"DOTA_EditChatTab_Target"	"{s:target}"
"DOTA_Chat_Autocomplete_Title"	"{s:autocomplete_title}"
"DOTA_Chat_Autocomplete_Channels"	"Канали"
"DOTA_Chat_Autocomplete_Commands"	"Команди"
"DOTA_Chat_Autocomplete_CommandName"	"/{s:command_name}"
"DOTA_Chat_Autocomplete_CommandDescription"	"{s:command_description}"
"dota_suggest_invite_format"	"Моля, поканете {s:invite_persona} в колектива."
"DOTA_ChatMessage_Default"	"<span class=\"{s:target_class} {s:sender_class}\"><span class=\"ChatTarget\">(<a href=\"{s:target_link}\">{s:target}</a>)</span> <span class=\"ChatPersona\">[{s:event_crest}{s:persona}]</span>: {g:dota_filtered_string:message}</span>"
"DOTA_ChatMessage_WhisperTo"	"<span class=\"{s:target_class} {s:sender_class}\">До <span class=\"ChatPersona\">[{s:event_crest}{s:persona}]</span>: {g:dota_filtered_string:message}</span>"
"DOTA_ChatMessage_WhisperFrom"	"<span class=\"{s:target_class} {s:sender_class}\">От <span class=\"ChatPersona\">[{s:event_crest}{s:persona}]</span>: {g:dota_filtered_string:message}</span>"
"DOTA_ChatMessage_System"	"<span class=\"{s:target_class} {s:sender_class}\"><span class=\"ChatTarget\">({s:target})</span>: {g:dota_filtered_string:message}</span>"
"DOTA_ChatTarget_Format_Default"	"{s:target}"
"DOTA_ChatTarget_Prompt_Default"	"До ({s:target}):"
"DOTA_ChatTarget_Format_Whisper"	"{s:persona}"
"DOTA_ChatTarget_Prompt_Whisper"	"До [{s:persona}]:"
"DOTA_ChatTarget_Party"	"Парти"
"DOTA_ChatTarget_Lobby"	"Лоби"
"DOTA_ChatTarget_Team"	"Отбор"
"DOTA_ChatTarget_Guild"	"Гилдия"
"DOTA_ChatTarget_Console"	"Конзола"
"DOTA_ChatTarget_Whisper"	"Шепнене"
"DOTA_ChatTarget_Invalid"	"Няма канал"
"DOTA_ChatTarget_GameAll"	"Всички"
"DOTA_ChatTarget_GameAllies"	"Съюзници"
"DOTA_ChatTarget_GameCoaching"	"Обучаване"
"DOTA_ChatTarget_GameSpectator"	"Наблюдател"
"DOTA_ChatTargetMenu_Title"	"{s:target}"
"DOTA_ChatTargetMenu_ToggleEnabled"	"{s:toggle_enabled}"
"DOTA_Chat_MissedMessages"	"{s:missed_message_count}"
"DOTA_ChatCommand_Party"	"p"
"DOTA_ChatCommand_Party_Name"	"Парти"
"DOTA_ChatCommand_Lobby"	"l"
"DOTA_ChatCommand_Lobby_Name"	"Лоби"
"DOTA_ChatCommand_Channel"	"c"
"DOTA_ChatCommand_Channel_Name"	"Канал"
"DOTA_ChatCommand_Whisper"	"w"
"DOTA_ChatCommand_Whisper_Name"	"Шептене"
"DOTA_ChatCommand_Reply"	"r"
"DOTA_ChatCommand_Reply_Name"	"Отговор"
"DOTA_ChatCommand_Help"	"?"
"DOTA_ChatCommand_Help_Name"	"Помощ"
"DOTA_ChatCommand_InviteToParty"	"partyinvite"
"DOTA_ChatCommand_LeaveParty"	"leaveparty"
"DOTA_ChatCommand_JoinChannel"	"joinchannel"
"DOTA_ChatCommand_LeaveChannel"	"leavechannel"
"DOTA_ChatCommand_GameAll"	"all"
"DOTA_ChatCommand_GameAll_Name"	"Всички"
"DOTA_ChatCommand_GameAllies"	"allies"
"DOTA_ChatCommand_GameCoaching"	"coach"
"DOTA_ChatCommand_GameCoaching_Name"	"Обучаване"
"DOTA_ChatCommand_GameSpectator"	"spectator"
"DOTA_ChatCommand_GameSpectator_Name"	"Наблюдател"
"DOTA_ChatCommand_Clear"	"clear"
"DOTA_ChatCommand_Clear_Name"	"Изчистване"
"DOTA_ChatHelp_Commands"	"Команди"
"DOTA_ChatHelp_NameFormat"	"{s:command_name}:"
"DOTA_ChatHelp_CommandFormat"	"/{s:command}"
"DOTA_Chat_PartyMemberSeparator"	", "
"DOTA_PartyInvite_Coach"	"Треньор:"
"DOTA_LobbyKicked_Header"	"Изритан от лобито"
"DOTA_LobbyKicked_Message"	"Вие бяхте изритан от лидера на лобито."
"DOTA_PlayerContextMenu_AddFriend"	"Добавяне на приятел"
"DOTA_PlayerContextMenu_InviteToLobby"	"Поканете в лобито"
"DOTA_FeaturedHero_HeroName"	"{s:hero_name}"
"DOTA_FeaturedHeroReason_SaleItem"	"На разпродажба сега"
"DOTA_HeroSelectorCategory_Favorites"	"Любими"
"DOTA_HeroSelector_ClearFilters"	"Изчистване на филтрите"
"DOTA_AllItemSet_Selector_Title"	"Всички"
"DOTA_Lobby_Settings_Competitive"	"СЪРЕВНОВАТЕЛНО"
"DOTA_Lobby_Settings_Spectators_Enabled"	"ВКЛЮЧЕНО"
"dota_lobby_settings_hide_password"	"Скриване на паролата"
"DOTA_Lobby_Settings_Visibility_Public"	"Публично"
"DOTA_Lobby_Settings_Visibility_Unlisted"	"Невписан"
"DOTA_TeamUnsetHeader"	"Няма избран отбор"
"DOTA_TeamUnsetMessage"	"Поне един от отборите няма зададено име/лого. Наистина ли искате мачът да започне?"
"dota_lobby_broadcast_join"	"Присъединяване"
"dota_popup_broadcast_channel_edit_language"	"Език"
"lobby_slot_error_header"	"Неуспех при размяната на слота"
"generic_gc_timeout"	"Времето за изпращане на съобщението изтече."
"lobby_slot_denied"	"Нямате правомощия, за да се присъедините към този слот."
"lobby_slot_error"	"Неуспешна смяната на слота в лобито."
"LobbySetting_GameMode_Value"	"{s:lobbysetting_gamemode}"
"LobbySetting_Bots_Value"	"{s:lobbysetting_bots}"
"LobbySetting_Password_Value"	"{s:lobbysetting_password}"
"LobbySetting_Server_Value"	"{s:lobbysetting_server}"
"LobbySetting_Cheats_Value"	"{s:lobbysetting_cheats}"
"LobbySetting_Spectators_Value"	"{s:lobbysetting_spectators}"
"LobbySetting_Visibility_Value"	"{s:lobbysetting_visibility}"
"DOTA_Custom_Game_Create_Lobby"	"Създаване на лоби"
"DOTA_Custom_Game_Download_Queued"	"Сваляне на опашка"
"DOTA_Custom_Game_Installed"	"Инсталирани"
"DOTA_Custom_Game_Rating"	"Оценка"
"DOTA_Custom_Game_Last_Updated"	"Последно обновена на {s:last_updated_date}"
"DOTA_Custom_Game_Screenshots"	"Снимки"
"DOTA_Custom_Game_Map_Label"	"Карта"
"DOTA_Custom_Game_Map_Any"	"Всякакви"
"DOTA_Custom_Game_Update"	"Обновяване"
"DOTA_Custom_Game_Spectate"	"Наблюдаване"
"DOTA_Custom_Game_Add_Favorite"	"Любима"
"DOTA_Custom_Lobby_Settings_Title"	"Създаване на лоби"
"DOTA_Custom_Lobby_Settings_Map"	"Карта"
"DOTA_Custom_Lobby_Public"	"Публично"
"DOTA_Custom_Lobby_List_Game_Header"	"Игра"
"DOTA_Custom_Lobby_List_Map_Header"	"Карта"
"DOTA_TabName_ModsOverview"	"Общ изглед"
"DOTA_TabName_ModsSubscribed"	"Библиотека"
"DOTA_TabName_ModsWorkshop"	"Работилница"
"DOTA_TabName_ModsBrowse"	"Преглед"
"DOTA_WatchTabName_Live"	"На живо"
"DOTA_WatchTabName_Replays"	"Повторения"
"DOTA_WatchTabName_Downloads"	"Сваляния"
"DOTA_WatchTournaments_FeaturedTeams"	"Отбори"
"DOTA_WatchTournaments_PrizePool"	"Награден фонд:"
"DOTA_Watch_Pending"	"Изчакване, за да гледате игра…"
"DOTA_Watch_GameServerNotFound"	"Сървърът, който е хост на играта, не беше намерен."
"DOTA_Watch_Unavailable"	"В момента не може да гледате тази игра."
"DOTA_Watch_LobbyNotFound"	"Лобито не е намерено."
"client_version_out_of_date"	"Клиентът на играта не е актуализиран. Моля, затворете Dota 2 и я рестартирайте, за да получите най-новата версия."
"dota_abandon_dialog_title"	"Изоставяне на играта"
"dota_abandon_dialog_confirm"	"Сигурни ли сте, че желаете да изоставите тази игра?"
"dota_abandon_dialog_yes"	"Да, изоставяне на играта."
"dota_leave_dialog_title"	"Напускане на играта"
"dota_leave_dialog_confirm"	"Сигурни ли сте, че искате да напуснете играта?"
"dota_leave_dialog_yes"	"Да, напускане на играта."
"dota_accept_match_readyup_title"	"Изчакване за играчите"
"dota_accept_match_accept"	"Приемане"
"dota_accept_match_decline"	"Отхвърляне"
"dota_finding_match_players"	"( {s:searching_player_count} търсят)"
"dota_finding_match_generic"	"Нормален мач"
"dota_finding_match_ranked"	"Мач с рейтинг"
"dota_finding_match_bot"	"Мач с ботове"
"dota_finding_match_team"	"Отборен мач с рейтинг"
"dota_finding_1v1_match_casual"	"Мач 1 срещу 1"
"dota_safe_to_abandon_inline"	"Играта е безопасна за напускане"
"dota_match_connected"	"Свързани сте към игра"
"dota_match_local_game"	"Свързани сте към локална игра"
"dota_match_connecting"	"Свързване към играта…"
"dota_match_in_progress"	"Започната игра"
"dota_match_finished"	"Играта е приключила"
"matchmaking_waiting_for_players"	"Изчакване за други играчи"
"matchmaking_player_declined"	"Даден играч отказа мача"
"dota_match_find_server"	"Намиране на сървър"
"matchmaking_account_disabled"	"Вие сте твърде подривен и няма да имате възможност за чат или присъединяване към търсенето на мачове за %s1"
"matchmaking_match_disabled_party"	"{s:match_denied_player_name} ще попречи включването към играта, поради предишна липса на реакция за готовност или изоставена игра. Оставащо време: {t:r:match_denied_time}"
"matchmaking_low_priority_party"	"{s:match_denied_player_name} ще позволи само мачове с нисък приоритет за следващите, поради напускания на игри или получени прекомерно много доклади от играчи. Оставащи игри: {d:match_denied_games}"
"matchmaking_match_disabled_local"	"Не Ви е позволено да се присъедините към играта %s1. Поради предишна липса на реакция за готовност, или защото сте изоставили последната си игра. Оставащо време: {t:r:match_denied_time}"
"matchmaking_low_priority_local"	"Ще сте способни да търсите мачове само с нисък приоритет, поради напускания на игри или доклади от играчи. Оставащи игри: {d:match_denied_games}"
"dota_play"	"Играйте Dota"
"dota_play_searching"	"Намиране на мач"
"dota_abandon_game"	"Изоставяне"
"dota_leaver_view_tooltip"	"Преглед на подробностите"
"DOTA_VAC_Verification_Button2"	"Затваряне"
"dota_region_automatic"	"Регион: Автоматичен"
"dota_ready_fail"	"НЕУСПЕХ ПРИ ЗАДАВАНЕ НА ГОТОВНОСТ"
"dota_ready_fail_desc"	"Бяхте премахнат от търсенето на мач, защото не отговорихте на поканата."
"dota_chatwheel_label_Ok"	"Добре"
"dota_chatwheel_label_Care"	"Внимателно"
"dota_chatwheel_label_GetBack"	"Отстъпление"
"dota_chatwheel_label_NeedWards"	"Нужда от уардове"
"dota_chatwheel_label_Stun"	"Зашеметяване"
"dota_chatwheel_label_Help"	"Помощ"
"dota_chatwheel_label_Push"	"Избутване"
"dota_chatwheel_label_GoodJob"	"Добре изиграно"
"dota_chatwheel_label_Missing"	"Липсващ герой"
"dota_chatwheel_label_Missing_Top"	"Липсващ герой в горната алея"
"dota_chatwheel_label_Missing_Mid"	"Липсващ герой в средната алея"
"dota_chatwheel_label_Missing_Bottom"	"Липсващ герой в долната алея"
"dota_chatwheel_label_Go"	"Давай!"
"dota_chatwheel_label_Initiate"	"Иницииране!"
"dota_chatwheel_label_Follow"	"След мен"
"dota_chatwheel_label_Group_Up"	"Групирайте се"
"dota_chatwheel_label_Spread_Out"	"Разпръснете се"
"dota_chatwheel_label_Split_Farm"	"Разделено фермене"
"dota_chatwheel_label_Attack"	"Атакувай сега!"
"dota_chatwheel_label_BRB"	"Сега се връщам"
"dota_chatwheel_label_Dive"	"Впускане!"
"dota_chatwheel_label_OMW"	"На път съм"
"dota_chatwheel_label_Get_Ready"	"Пригответе се"
"dota_chatwheel_label_Bait"	"Примамка"
"dota_chatwheel_label_Heal"	"Лекуване"
"dota_chatwheel_label_Mana"	"Мана"
"dota_chatwheel_label_OOM"	"Нямам мана"
"dota_chatwheel_label_Skill_Cooldown"	"Време за изчакване"
"dota_chatwheel_label_Ulti_Ready"	"Ултиматът е готов"
"dota_chatwheel_label_Enemy_Returned"	"Завръщане"
"dota_chatwheel_label_All_Missing"	"Всички липсват"
"dota_chatwheel_label_Enemy_Incoming"	"Идващи"
"dota_chatwheel_label_Invis_Enemy"	"Невидим враг"
"dota_chatwheel_label_Enemy_Had_Rune"	"Врагът има руна"
"dota_chatwheel_label_Split_Push"	"Разделен натиск"
"dota_chatwheel_label_Coming_To_Gank"	"Идвам за gank"
"dota_chatwheel_label_Request_Gank"	"Молба за gank"
"dota_chatwheel_label_Fight_Under_Tower"	"Под кулата"
"dota_chatwheel_label_Deny_Tower"	"Откажете кулата"
"dota_chatwheel_label_Buy_Courier"	"Купете куриер"
"dota_chatwheel_label_Upgrade_Courier"	"Подобри куриера"
"dota_chatwheel_label_Need_Detection"	"Трябва ни разкриване"
"dota_chatwheel_label_They_Have_Detection"	"Те имат разкриване"
"dota_chatwheel_label_Buy_TP"	"Купете телепорт"
"dota_chatwheel_label_Reuse_Courier"	"Използвайте куриера отново"
"dota_chatwheel_label_Deward"	"Премахнете този ward"
"dota_chatwheel_label_Building_Mek"	"Правя Mek"
"dota_chatwheel_label_Building_Pipe"	"Правя Pipe"
"dota_chatwheel_label_Stack_And_Pull"	"Натрупайте и издърпайте"
"dota_chatwheel_label_Pull"	"Дърпай крийпове"
"dota_chatwheel_label_Pulling"	"Дърпам крийпове"
"dota_chatwheel_label_Stack"	"Натрупай неутрални"
"dota_chatwheel_label_Roshan"	"Roshan"
"dota_chatwheel_label_Affirmative"	"Разбрано"
"dota_chatwheel_label_Wait"	"Изчакайте"
"dota_chatwheel_label_Pause"	"Пауза"
"dota_chatwheel_label_Current_Time"	"Текущо време"
"dota_chatwheel_label_Check_Runes"	"Проверете руните"
"dota_chatwheel_label_Smoke_Gank"	"Smoke Gank!"
"dota_chatwheel_label_GLHF"	"Успех"
"dota_chatwheel_label_Nice"	"Добре"
"dota_chatwheel_label_Thanks"	"Благодаря"
"dota_chatwheel_label_Sorry"	"Съжалявам"
"dota_chatwheel_label_No_Give_Up"	"Не се предавайте"
"dota_chatwheel_label_Just_Happened"	"Случи се"
"dota_chatwheel_label_Game_Is_Hard"	"Играта е трудна"
"dota_chatwheel_label_New_Meta"	"Нова мета"
"dota_chatwheel_label_My_Bad"	"Моя грешка"
"dota_chatwheel_label_Relax"	"Отпуснете се"
"dota_chatwheel_label_Im_Retreating"	"Отстъпвам"
"dota_chatwheel_header_positioning"	"Позициониране"
"dota_chatwheel_header_status"	"Статус"
"dota_chatwheel_header_enemy"	"Враг"
"dota_chatwheel_header_lane"	"Алея"
"dota_chatwheel_header_items"	"Предмети"
"dota_chatwheel_header_misc"	"Разни"
"dota_chatwheel_header_flavor"	"Разнообразие"
"dota_chatwheel_message_Ok"	"Добре."
"dota_chatwheel_message_Care"	"Внимателно!"
"dota_chatwheel_message_GetBack"	"Върни се!"
"dota_chatwheel_message_NeedWards"	"Нужни са ни wards."
"dota_chatwheel_message_Stun"	"Зашеметяване, сега!"
"dota_chatwheel_message_Help"	"Помощ!"
"dota_chatwheel_message_Push"	"Избутайте, сега!"
"dota_chatwheel_message_GoodJob"	"Добре изиграно!"
"dota_chatwheel_message_Missing"	"Липсва!"
"dota_chatwheel_message_Missing_Top"	"Липсващ герой в горната алея!"
"dota_chatwheel_message_Missing_Mid"	"Липсващ герой в средната алея!"
"dota_chatwheel_message_Missing_Bottom"	"Липсващ герой в долната алея!"
"dota_chatwheel_message_Go"	"Давай!"
"dota_chatwheel_message_Initiate"	"Иницииране!"
"dota_chatwheel_message_Follow"	"След мен"
"dota_chatwheel_message_Group_Up"	"Групирайте се"
"dota_chatwheel_message_Spread_Out"	"Разпръснете се"
"dota_chatwheel_message_Split_Farm"	"Разделете се и фермете"
"dota_chatwheel_message_Attack"	"Атакувай сега!"
"dota_chatwheel_message_BRB"	"Сега се връщам"
"dota_chatwheel_message_Dive"	"Впускане!"
"dota_chatwheel_message_OMW"	"На път съм"
"dota_chatwheel_message_Get_Ready"	"Приготви се"
"dota_chatwheel_message_Bait"	"Примамка"
"dota_chatwheel_message_Heal"	"Лекуване"
"dota_chatwheel_message_Mana"	"Мана"
"dota_chatwheel_message_OOM"	"Нямам мана"
"dota_chatwheel_message_Skill_Cooldown"	"Уменията ми са на изчакване"
"dota_chatwheel_message_Ulti_Ready"	"Ултиматът е готов"
"dota_chatwheel_message_Enemy_Returned"	"Врагът се завърна"
"dota_chatwheel_message_All_Missing"	"Всички вражески герои липсват!"
"dota_chatwheel_message_Enemy_Incoming"	"Врагът идва!"
"dota_chatwheel_message_Invis_Enemy"	"Невидим враг наблизо!"
"dota_chatwheel_message_Enemy_Had_Rune"	"Врагът има руна"
"dota_chatwheel_message_Split_Push"	"Разделен натиск"
"dota_chatwheel_message_Coming_To_Gank"	"Идвам за gank"
"dota_chatwheel_message_Request_Gank"	"Моля за gank"
"dota_chatwheel_message_Fight_Under_Tower"	"Бийте се под кулата"
"dota_chatwheel_message_Buy_Courier"	"Моля, купете куриер"
"dota_chatwheel_message_Upgrade_Courier"	"Някой може ли да подобри куриера?"
"dota_chatwheel_message_Need_Detection"	"Трябва ни разкриване"
"dota_chatwheel_message_They_Have_Detection"	"Те имат разкриване"
"dota_chatwheel_message_Buy_TP"	"Купете Teleport Scroll"
"dota_chatwheel_message_Reuse_Courier"	"Използвайте куриера отново"
"dota_chatwheel_message_Deward"	"Моля, премахнете wards"
"dota_chatwheel_message_Building_Mek"	"Правя Mekansm"
"dota_chatwheel_message_Building_Pipe"	"Правя Pipe"
"dota_chatwheel_message_Stack_And_Pull"	"Моля, натрупайте и издърпайте"
"dota_chatwheel_message_Pull"	"Моля, дръпнете крийповете"
"dota_chatwheel_message_Pulling"	"Дърпам крийпове"
"dota_chatwheel_message_Roshan"	"Roshan"
"dota_chatwheel_message_Affirmative"	"Разбрано"
"dota_chatwheel_message_Wait"	"Изчакайте"
"dota_chatwheel_message_Pause"	"Моля за пауза!"
"dota_chatwheel_message_Current_Time"	"Текущо игрово време"
"dota_chatwheel_message_Check_Runes"	"Моля, проверете руните"
"dota_chatwheel_message_Smoke_Gank"	"Да направим Smoke Gank!"
"dota_chatwheel_message_GLHF"	"Успех и приятна игра"
"dota_chatwheel_message_Nice"	"Добре"
"dota_chatwheel_message_Thanks"	"Благодаря!"
"dota_chatwheel_message_Sorry"	"Съжалявам"
"dota_chatwheel_message_No_Give_Up"	"Не се предавайте!"
"dota_chatwheel_message_Just_Happened"	"Случи се"
"dota_chatwheel_message_Game_Is_Hard"	"Играта е трудна"
"dota_chatwheel_message_New_Meta"	"Нова мета"
"dota_chatwheel_message_My_Bad"	"Моя грешка"
"dota_chatwheel_message_Regret"	"Съжалявам за решението си"
"dota_chatwheel_message_Relax"	"\\r\nСпокойно, справяш се добре"
"dota_chatwheel_message_MissingHero"	"%s1 липсва!"
"dota_chatwheel_message_ReturnedHero"	"%s1 се завърна!"
"dota_chatwheel_message_Im_Retreating"	"Отстъпвам"
"dota_settings_options"	"Настройки"
"dota_settings_audio"	"Аудио"
"dota_settings_video"	"Видео"
"dota_settings_items"	"Предмети"
"dota_settings_scoreboardtoggle"	"Табло с резултати"
"dota_settings_coaching"	"Обучаване"
"dota_settings_cancel"	"Отказ"
"dota_settings_game"	"Игра"
"dota_settings_profile"	"Профил"
"dota_settings_trade_friends"	"Само приятели"
"dota_settings_aspectratio"	"Съотношение"
"dota_settings_normal_maps"	"Листове със светлосенки"
"dota_settings_5speakers"	"5.1 говорителя"
"dota_settings_unitspeech_all"	"Всички"
"OS_Default_Device"	"Стандартно устройство"
"DOTA_Hotkeys_Tooltip_UseActionItem"	"Използване на предмета с действие."
"DOTA_Lobby_BotDifficulty"	"Трудност на ботовете"
"DOTA_Lobby_BotDifficulty_passive"	"Пасивна"
"DOTA_Lobby_BotDifficulty_easy"	"Лесна"
"DOTA_Lobby_BotDifficulty_medium"	"Средна"
"DOTA_Lobby_BotDifficulty_hard"	"Трудна"
"DOTA_Lobby_BotDifficulty_unfair"	"Нечестна"
"dota_lobby_row_join"	"Присъединяване"
"dota_lobby_browser_refresh"	"Опресняване"
"dota_lobby_submit_filter"	"Изпращане"
"DOTA_EquippedItem_Purchase_Button"	"Закупуване"
"DOTA_HeroRole_Support"	"Support"
"returning_top_of_queue"	"Връщане към търсене на мач с висок приоритет"
"GC_nosteam"	"Връзката към Steam бе загубена"
"GC_noconnection"	"Не сте свързани с Dota 2 мрежата."
"GC_Wait_Time"	"Приблизително време за изчакване: %s1"
"GC_Wait_Time_Unknown"	"Неизвестно"
"join_error_already_in_game"	"Неуспешно влизане в частното лоби, защото вече сте в игра."
"join_error_invalid_lobby"	"Лобито, което сте избрали, вече не съществува."
"join_error_incorrect_password"	"Грешна парола."
"join_error_access_denied"	"Достъпът е отказан."
"join_error_generic"	"
"
"join_error_in_team_party"	"Неуспешно влизане в тренировъчното лоби. Трябва да разпуснете отборното си парти, преди да влезете в частни игри."
"DOTA_Friend_Finding_Match"	"Намиране на мач…"
"DOTA_Friend_Watch"	"Наблюдаване"
"dota_lobby_type_practice"	"Тренировка"
"dota_lobby_type_tournament"	"Турнир"
"dota_lobby_type_coop_bot"	"Кооперативно с ботове"
"dota_lobby_type_competitive"	"С класиране"
"dota_lobby_type_casual_1v1"	"Мач 1 срещу 1"
"DOTA_Lobby_No_Players_Title"	"НЯМА ИГРАЧИ В ОТБОРА"
"DOTA_Lobby_No_Players_Desc"	"Трябва да имате поне един играч в отбора на Radiant или Dire."
"custom_end_screen_legend_player"	"Играч"
"custom_end_screen_legend_items"	"Предмети"
"custom_end_screen_legend_gold"	"Злато"
"CustomEndScreenClose"	"Затваряне"
"DOTA_Armory_Category_Heroes"	"Герои"
"DOTA_Armory_Category_Pets"	"Питомници"
"DOTA_Armory_Category_Weather"	"Атмосферни ефекти"
"DOTA_Armory_Category_Emoticons"	"Емотикони"
"DOTA_Armory_Category_LoadingScreens"	"Екрани при зареждане"
"DOTA_Armory_Category_Audio"	"Аудио"
"DOTA_Armory_Category_AnnouncerPacks"	"Пакет за говорител"
"DOTA_Armory_Category_All"	"Всички"
"DOTA_Armory_SortBy"	"Сортиране по:"
"DOTA_Armory_SortBy_Quality"	"Качество"
"DOTA_Armory_SortBy_Name"	"Име"
"DOTA_Armory_ContextMenu_Delete"	"Изтриване"
"dota_page_match_details_victory"	"Победител: {s:winner}"
"dota_page_match_details_legend_player"	"Играч"
"dota_page_match_details_legend_items"	"Предмети"
"dota_page_match_details_legend_gold"	"Злато"
"dota_page_match_details_legend_kills_tooltip"	"Убийства"
"dota_page_match_details_legend_assists_tooltip"	"Асистенции"
"dota_page_match_details_header_duration"	"Времетраене"
"dota_page_match_details_replay_existence_not_found"	"Повторението е недостъпно"
"dota_page_match_details_replay_existence_disk_found_replay"	"Гледане на повторението"
"dota_profile_content_tab_recent_games"	"Скорошни игри"
"dota_profile_recent_game_header_hero_name"	"Игран герой"
"dota_profile_recent_game_header_result"	"Резултат"
"dota_profile_recent_game_header_duration"	"Времетраене"
"dota_profile_recent_game_header_type"	"Тип"
"custom_game_team_select_starting"	"Стартиране"
"custom_game_team_select_join"	"Присъединяване"
"CouldntFindCompendium"	"Не може да бъде зареден тестовият файл на Compendium: {s:s1}"
"CompendiumPageError_NoTxtList"	"Не може да бъде намерен textlist наречен \\'%s1\\' на страница \\'%s2\\'"
"CompendiumPageError_TOCPage"	"table_of_contents_page страницата „{s:s1}“, не съществува."
"DOTA_GlobalItems_Pets"	"Питомници"
"DOTA_GlobalItems_Weather"	"Атмосферни ефекти"
"DOTA_GlobalItems_Emoticons"	"Емотикони"
"DOTA_GlobalItems_LoadingScreens"	"Екрани при зареждане"
"DOTA_GlobalItems_Audio"	"Аудио"
"DOTA_GlobalItems_Announcers"	"Пакет за говорител"
"DOTA_Search"	"Търсене"
"DOTA_Start"	"Стартиране"
"dota_lobby_settings_edit"	"Редактиране"
"DOTA_Custom_Game_Friends_Playing_Now"	"Приятели играещи сега"
"Compendium_DefaultText_CD_Days"	"Дни"
"Compendium_DefaultText_CD_Hours"	"Часа"
"Compendium_DefaultText_CD_Minutes"	"Минути"
"Compendium_DefaultText_CD_Seconds"	"Секунди"
"DOTA_ActorCredits_1_Name"	"Дий Брадли Бейкър"
"DOTA_ActorCredits_1_Heroes"	"techies"
"DOTA_ActorCredits_2_Name"	"Денис Бейтмън"
"DOTA_ActorCredits_2_Heroes"	"invoker"
"DOTA_ActorCredits_3_Name"	"Том Чантлър"
"DOTA_ActorCredits_3_Heroes"	"centaur,lion,obsidian_destroyer,riki,slark,tusk,witch_doctor"
"DOTA_ActorCredits_4_Name"	"Мърл Дендридж"
"DOTA_ActorCredits_4_Heroes"	"legion_commander,winter_wyvern"
"DOTA_ActorCredits_5_Name"	"Барни Денън"
"DOTA_ActorCredits_5_Heroes"	"chaos_knight,phantom_lancer,rubick"
"DOTA_ActorCredits_6_Name"	"Дейв Феной"
"DOTA_ActorCredits_6_Heroes"	"batrider,ember_spirit,faceless_void,jakiro,venomancer,skeleton_king"
"DOTA_ActorCredits_7_Name"	"Джим Френч"
"DOTA_ActorCredits_7_Heroes"	"elder_titan"
"DOTA_ActorCredits_8_Name"	"Майкъл Грегъри"
"DOTA_ActorCredits_8_Heroes"	"bounty_hunter,clinkz,silencer"
"DOTA_ActorCredits_9_Name"	"Джин Хамънд"
"DOTA_ActorCredits_9_Heroes"	"crystal_maiden,drow_ranger,enchantress,mirana,phantom_assassin,spectre,vengefulspirit"
"DOTA_ActorCredits_10_Name"	"Джон Патрик Лори"
"DOTA_ActorCredits_10_Heroes"	"ancient_apparition,dark_seer,doom_bringer,earthshaker,pudge,nevermore,storm_spirit"
"DOTA_ActorCredits_11_Name"	"Елън Маклейн"
"DOTA_ActorCredits_11_Heroes"	"broodmother,death_prophet"
"DOTA_ActorCredits_12_Name"	"Брус Майлс"
"DOTA_ActorCredits_12_Heroes"	"alchemist,life_stealer,omniknight"
"DOTA_ActorCredits_13_Name"	"Линда К. Морис"
"DOTA_ActorCredits_13_Heroes"	"luna,naga_siren,queenofpain,templar_assassin"
"DOTA_ActorCredits_13_Extra"	"Говорител"
"DOTA_ActorCredits_14_Name"	"Сам A. Моури"
"DOTA_ActorCredits_14_Heroes"	"antimage,beastmaster,rattletrap,necrolyte,slardar,warlock"
"DOTA_ActorCredits_14_Extra"	"Търговецът в тайния магазин"
"DOTA_ActorCredits_15_Name"	"Ерик Нюсъм"
"DOTA_ActorCredits_15_Heroes"	"chen,leshrac,furion,razor,tidehunter,tiny,zuus"
"DOTA_ActorCredits_16_Name"	"Нолън Норт"
"DOTA_ActorCredits_16_Heroes"	"brewmaster,earth_spirit,gyrocopter,keeper_of_the_light,lone_druid,lycan,meepo,ogre_magi,shadow_demon,troll_warlord"
"DOTA_ActorCredits_17_Name"	"Дамси Папиън"
"DOTA_ActorCredits_18_Name"	"Ти Джей Рамини"
"DOTA_ActorCredits_18_Heroes"	"abaddon,bristleback,skywrath_mage,shredder"
"DOTA_ActorCredits_19_Name"	"Хари С. Робинс"
"DOTA_ActorCredits_19_Heroes"	"tinker"
"DOTA_ActorCredits_20_Name"	"Гари Швартц"
"DOTA_ActorCredits_20_Heroes"	"lich,pugna"
"DOTA_ActorCredits_21_Name"	"Дейвид Скъли"
"DOTA_ActorCredits_21_Heroes"	"bane,dazzle,juggernaut,morphling,sand_king,sven,weaver"
"DOTA_ActorCredits_22_Name"	"Майк Шапиро"
"DOTA_ActorCredits_22_Heroes"	"oracle"
"DOTA_ActorCredits_23_Name"	"Дейвид Соболов"
"DOTA_ActorCredits_23_Heroes"	"terrorblade"
"DOTA_ActorCredits_24_Name"	"Джон Ст. Джон"
"DOTA_ActorCredits_24_Heroes"	"axe,bloodseeker,enigma,kunkka"
"DOTA_ActorCredits_25_Name"	"Фред Таташиори"
"DOTA_ActorCredits_25_Heroes"	"disruptor,spirit_breaker,treant,undying,ursa"
"DOTA_ActorCredits_25_Extra"	"Warlock's Golem"
"DOTA_ActorCredits_26_Name"	"Джен Тейлър"
"DOTA_ActorCredits_26_Heroes"	"lina,medusa,puck,windrunner"
"DOTA_ActorCredits_27_Name"	"Тони Тод"
"DOTA_ActorCredits_27_Heroes"	"dragon_knight,night_stalker,viper"
"DOTA_ActorCredits_28_Name"	"
"
"DOTA_ActorCredits_28_Heroes"	"
"
"DOTA_Custom_Game_Finished_Vote_Skip"	"Пропускане"
"DOTA_TabName_ModsLobbyList"	"Списък с лобита"
"DOTA_WatchLive_Fullscreen"	"ЦЯЛ ЕКРАН"
"DOTA_JoinChatChannel_ChannelName"	"Име на канала"
"DOTA_JoinChatChannel_ChannelMemberCount"	"Членове"
"DOTA_Chat_ChannelMemberCount"	"{d:channel_member_count}"
"DOTA_GiftWrap_Success_Header"	"Успешно"
"dota_settings_about"	"Относно"
"DOTA_ClientVersion"	"Версия: <span class=\"VersionNumber\">{d:client_version_number}</span>"
"DOTA_CurrentGameplayVersion"	"6.85"
"DOTA_Credits_LindaKMorris_Extra"	"и говорителя по подразбиране"
"DOTA_Recycling"	"Рециклиране"
"DOTA_RecyclingCharm_Name"	"Charm of the Crucible Jewel II"
"dota_profile_oi_team"	"ОТБОР"
"dota_role_support"	"Support"
"DOTA_SortBy"	"Сортиране по"
"DOTA_SortOption_Price"	"Цена"
"DOTA_AHC_InProgress"	"Започнато"
"DOTA_HeroLoadout_Loadout"	"Снаряжение"
"DOTA_HeroLoadout_Guides"	"Ръководства"
"DOTA_EffigyEditor_ErrorPose"	"Неуспешна поза за Heroic Effigy of Fame."
"DOTA_tooltip_econ_item_modifier_announcer"	"Говорител"
"DOTA_tooltip_econ_item_modifier_loading_screen"	"Екран при зареждане"
"DOTA_tooltip_econ_item_modifier_pet"	"Питомец"
"DOTA_AntiAddiction_CompleteInfoNotNow"	"Не сега"
"DOTA_Workshop_Browse"	"Преглед"
"DOTA_Workshop_MaterialName_NormalTexture"	"Лист със светлосенки"
"DOTA_UI_LoadScreen_16_9"	"Съотношение 16:9"
"DOTA_UI_LoadScreen_16_10"	"Съотношение 16:10"
"DOTA_UI_LoadScreen_4_3"	"Съотношение 4:3"
"DOTA_Workshop_ImportError_Validation"	"Неуспешно потвърждаване"
"DOTA_Workshop_Submit"	"Изпращане"
"DOTA_Done"	"Готово"
"DOTA_WatchReplaysConextMenu_WatchLater"	"Наблюдаване по-късно"
"DOTA_WatchTournaments_PrizePoolLabel"	"награден фонд"
"DOTA_Popup_Item_Received_Button_Accept"	"Приемане"
"LobbySetting_League_Value"	"{s:lobbysetting_league}"
"DOTA_Armory_Tag1_Default"	"Етикет 1"
"DOTA_Armory_Tag2_Default"	"Етикет 2"
"DOTA_Armory_Tag3_Default"	"Етикет 3"
"DOTA_Armory_Tag4_Default"	"Етикет 4"
"DOTA_Armory_Tag5_Default"	"Етикет 5"
"DOTA_Armory_Tag6_Default"	"Етикет 6"
"DOTA_Armory_Tag7_Default"	"Етикет 7"
"DOTA_Armory_Tag8_Default"	"Етикет 8"
"DOTA_Workshop_TextureDetails_normal"	"Лист със светлосенки"
"DOTA_Treasure_HelpHeader"	"Всяко съкровище съдържа {d:items_per_treasure} от тези предмети"
"DOTA_Treasure_FilterAll"	"Всички"
"DOTA_EventName_International2014"	"The International 2014"
"DOTA_EventName_International2015"	"The International 2015"
"DOTA_EventName_FallMajor2015"	"Есен 2015"
"dota_profile_recent_game_result_win_ranked"	"{i:ranked_mmr} (+{i:ranked_mmr_delta})"
"dota_profile_recent_game_result_loss_ranked"	"{i:ranked_mmr} ({i:ranked_mmr_delta})"
"DOTA_tooltip_econ_item_gift_dedication"	"{s:gift_dedication}"
"DOTA_econ_item_details_style_name"	"{s:style_name}"
"DOTA_econ_item_details_tooltip_lock_reason"	"{s:style_lock_reason}"
}
