"dota"
{
"DOTA_Accept"	"Accepteren"
"DOTA_Cancel"	"Annuleren"
"DOTA_Console"	"Console"
"DOTA_Create"	"Maken"
"DOTA_Decline"	"Weigeren"
"DOTA_Error"	"Fout"
"DOTA_Join"	"Meedoen"
"DOTA_Leave"	"Verlaten"
"DOTA_New"	"Nieuw"
"DOTA_Ok"	"OK"
"DOTA_Sale"	"Uitverkoop"
"DOTA_Close"	"Sluiten"
"DOTA_Continue"	"Doorgaan"
"DOTA_Add"	"Toevoegen"
"DOTA_Edit"	"Bewerken"
"DOTA_Enable"	"Inschakelen"
"DOTA_Disable"	"Uitschakelen"
"DOTA_Refresh"	"Vernieuwen"
"DOTA_Loading"	"Laden"
"DOTA_None"	"Geen"
"DOTA_Customize"	"Aanpassen"
"DOTA_AcceptChanges"	"Wijzigingen accepteren"
"dota_team_radiant"	"Radiant"
"dota_team_dire"	"Dire"
"Unknown"	"Onbekend"
"UI_Yes"	"Ja"
"UI_No"	"Nee"
"UI_File_Filter_Any"	"Alle bestanden (*.*)"
"DOTA_MainMenu_Heroes"	"Helden"
"DOTA_MainMenu_Watch"	"Bekijken"
"DOTA_MainMenu_Learn"	"Leren"
"DOTA_MainMenu_Mods"	"Aangepaste spellen"
"DOTA_TabName_GlobalItems"	"Algemene items"
"DOTA_TabName_Treasury"	"Schatkamer"
"DOTA_TabName_Armory"	"Arsenaal"
"DOTA_ConfirmQuit"	"Afsluiten bevestigen"
"DOTA_ConfirmQuitDesc"	"Weet je zeker dat je Dota 2 wilt afsluiten?"
"DOTA_ConfirmQuitDescUnsafe"	"Als je een spel verlaat voordat het afgelopen is verpest je het mogelijk voor de andere spelers. Weet je zeker dat je Dota 2 wilt afsluiten?"
"DOTA_InvalidPersonaName"	"[onbekend]"
"DOTA_Friends_WindowTitle"	"VRIENDEN"
"DOTA_FriendsMenu_Tooltip_NoneReady"	"Vrienden"
"DOTA_UserName"	"{g:dota_persona:user_account_id}"
"DOTA_UserNamePro"	"{g:dota_persona_pro:user_account_id}"
"DOTA_UserNickname"	"{g:dota_persona_nickname:user_account_id}"
"DOTA_UserRichPresence"	"{s:user_rich_presence}"
"DOTA_ProfileCard_StatTitle_Commends"	"Aanbevelingen"
"DOTA_ProfileCard_StatTitle_GamesPlayed"	"Wedstrijden"
"DOTA_ProfileCard_StatTitle_FirstMatchDate"	"Eerste wedstrijd"
"DOTA_ProfileCard_StatValue_Int"	"{d:stat_value}"
"DOTA_ProfileCard_StatValue_Date"	"{t:s:stat_value}"
"DOTA_ProfileCard_StatValue_String"	"{s:stat_value}"
"DOTA_ProfileCard_SlotTab_Trophies"	"Trofeeën"
"DOTA_ProfileCard_SlotTab_Items"	"Arsenaal"
"DOTA_ProfileCard_SlotTab_Heroes"	"Helden"
"DOTA_ProfileCard_SlotTab_Emoticons"	"Emoticons"
"DOTA_ProfileCard_NoTrophies"	"Er zijn geen trofeeën beschikbaar."
"DOTA_ProfileCard_NoItems"	"Er zijn geen items beschikbaar."
"DOTA_ProfileCard_HeroOnly"	"Alleen helden"
"DOTA_HeroTooltip_HeroName"	"{s:hero_name}"
"DOTA_HeroTooltip_HeroRecord"	"{s:hero_wins_string}, {s:hero_losses_string}"
"DOTA_Wins_Singular"	"1 overwinning"
"DOTA_Wins_Plural"	"{d:hero_wins} overwinningen"
"DOTA_Profile_VictoryCount"	"Overwinningen"
"DOTA_Profile_ProfilePage"	"Profiel"
"DOTA_Profile_TrophyPage"	"Galerij der triomfen"
"DOTA_Profile_RecentGamesPage"	"Recente spellen"
"DOTA_Profile_HeroPage"	"Helden"
"DOTA_Profile_PlayStyle"	"Speelstijl"
"DOTA_Profile_RecentActivity"	"Recente activiteit"
"DOTA_Profile_Fighting"	"Vechten"
"DOTA_Profile_Fighting_TooltipTitle"	"Vechten"
"DOTA_Profile_Self"	"Ik"
"DOTA_Profile_GPM"	"Gem. GPM"
"DOTA_Profile_XPM"	"Gem. XPM"
"DOTA_Profile_LH"	"Gem. laatste slagen"
"DOTA_Profile_CourierKills"	"Koeriers gedood"
"DOTA_Profile_Aegises"	"Aegisen gestolen"
"DOTA_Profile_CheeseEaten"	"Kazen gegeten"
"DOTA_Profile_GPMValue"	"{s:GPM}"
"DOTA_Profile_XPMValue"	"{s:XPM}"
"DOTA_Profile_LHValue"	"{s:LH}"
"DOTA_Profile_RampagesValue"	"{d:Rampages}"
"DOTA_Profile_TripleKillsValue"	"{d:TripleKills}"
"DOTA_Profile_FirstBloodValue"	"{d:FirstBlood}"
"DOTA_Profile_FirstBledValue"	"{d:FirstBled}"
"DOTA_Profile_CourierKillsValue"	"{d:CourierKills}"
"DOTA_Profile_AegisesValue"	"{d:Aegises}"
"DOTA_Profile_CheeseEatenValue"	"{d:CheeseEaten}"
"DOTA_Profile_CreepStackValue"	"{d:CreepStack}"
"DOTA_Profile_GPMLocalValue"	"{s:GPMLocal}"
"DOTA_Profile_XPMLocalValue"	"{s:XPMLocal}"
"DOTA_Profile_LHLocalValue"	"{s:LHLocal}"
"DOTA_Profile_RampagesLocalValue"	"{d:RampagesLocal}"
"DOTA_Profile_TripleKillsLocalValue"	"{d:TripleKillsLocal}"
"DOTA_Profile_FirstBloodLocalValue"	"{d:FirstBloodLocal}"
"DOTA_Profile_FirstBledLocalValue"	"{d:FirstBledLocal}"
"DOTA_Profile_CourierKillsLocalValue"	"{d:CourierKillsLocal}"
"DOTA_Profile_AegisesLocalValue"	"{d:AegisesLocal}"
"DOTA_Profile_CheeseEatenLocalValue"	"{d:CheeseEatenLocal}"
"DOTA_Profile_CreepStackLocalValue"	"{d:CreepStackLocal}"
"DOTA_RecentGames_Title"	"Recente spellen"
"DOTA_RecentGames_TimeStamp"	"Datum/tijd"
"DOTA_RecentGames_HeroSelection"	"Gespeelde held"
"DOTA_RecentGames_GameResult"	"Resultaat"
"DOTA_RecentGames_GameLength"	"Duur"
"DOTA_RecentGames_Team"	"Team"
"DOTA_RecentGames_GameType"	"Soort"
"DOTA_RecentGames_Items"	"Items"
"DOTA_RecentGame_Timestamp_Entry"	"{t:s:timestamp} {t:t:timestamp}"
"DOTA_RecentGame_Duration"	"{t:d:duration}"
"DOTA_RecentGame_Downloading"	"{s:DownloadPercent} gedownload"
"DOTA_RecentGame_Watch"	"Herhaling bekijken"
"DOTA_RecentGame_NoReplay"	"Geen herhaling"
"DOTA_RecentGame_Expired"	"Herhaling verlopen"
"DOTA_RecentGame_Finding"	"Zoeken..."
"DOTA_RecentGame_Download"	"Spel downloaden"
"DOTA_RecentGame_Pending"	"Herhaling in behandeling"
"DOTA_RecentGame_Unavailable"	"Herhaling niet beschikbaar"
"DOTA_RecentGame_MatchID"	"Spel-id: #{s:match_id}"
"DOTA_No_Team_Name"	"--"
"DOTA_TrophyCount"	"{d:trophy_count} trofee"
"DOTA_TrophiesCount"	"{d:trophy_count} trofeeën"
"DOTA_TrophyCount_Number"	"{d:trophy_count}"
"DOTA_TrophyCount_NoNum"	"Trofee"
"DOTA_TrophiesCount_NoNum"	"Trofeeën"
"DOTA_Trophies_ViewAll"	"Alles weergeven"
"DOTA_TrophyName"	"{s:trophy_name}"
"DOTA_TrophyCategory"	"{s:trophy_category}"
"DOTA_TrophyDescription"	"{s:trophy_description}"
"DOTA_TrophyXP"	"{d:trophy_xp} XP"
"DOTA_NextTrophy"	"Volgende beloning"
"DOTA_NewPlayerQuestion_Title"	"WELKOM BIJ DOTA 2"
"DOTA_PlayerOriginQuestion_Question"	"Deel je ervaring met Dota 2 en gelijksoortige games om je spelbeleving te verbeteren:"
"DOTA_PlayerOriginQuestion_BeginnerButton"	"Ik ben een beginner."
"DOTA_PlayerOriginQuestion_RTSButton"	"Ik heb RTS-spellen gespeeld."
"DOTA_PlayerOriginQuestion_MOBAButton"	"Ik heb een spel gespeeld dat lijkt op Dota 2."
"DOTA_PlayerOriginQuestion_Dota2Button"	"Ik heb Dota 2 gespeeld."
"DOTA_PlayerOriginQuestion_MOBAExplanation"	"Selecteer de game waar je het meest comfortabel mee bent:"
"DOTA_OtherGames_LOL"	"League of Legends"
"DOTA_OtherGames_DOTA"	"DotA 1"
"DOTA_OtherGames_HON"	"Heroes of Newerth"
"DOTA_OtherGames_Smite"	"Smite"
"DOTA_OtherGames_Other"	"Een andere game"
"DOTA_PlayerOriginQuestion_ConfirmationButton"	"SPELEN MAAR"
"DOTA_Tutorial_SkipButton"	"Tutorial overslaan"
"DOTA_ConfirmSkip"	"Dota 2-introductie overslaan?"
"DOTA_ConfirmSkipDesc"	"Weet je zeker dat je de tutorials voor Dota 2 wilt overslaan?"
"DOTA_Tutorial_Start_Quest"	"QUEST STARTEN"
"DOTA_Tutorial_Quest0_Title"	"QUEST 1"
"DOTA_GuidedBotMatches_0_Title"	"Luna"
"DOTA_GuidedBotMatches_1_Title"	"Sven"
"DOTA_GuidedBotMatches_2_Title"	"Lina"
"FileOpenDialog_Open"	"Openen"
"FileOpenDialog_Save"	"Opslaan"
"FileOpenDialog_Select"	"Selecteren"
"DOTA_FindMatch"	"Spel zoeken"
"DOTA_FindingMatch"	"Spel zoeken ( {s:find_match_time} )"
"DOTA_FindMatchTime"	"{s:find_match_time}"
"DOTA_Searching"	"Zoeken"
"DOTA_StartSoloBotMatch"	"Spel met bots starten"
"DOTA_Create_Lobby"	"Lobby maken"
"DOTA_LobbyStartGame"	"Spel starten"
"DOTA_ReturnToLobby"	"Terug naar lobby"
"DOTA_FindMatchStatus"	"{s:searching_matchtype} / {s:searching_gamemodes} / {s:searching_region}"
"DOTA_FindGameModesMany"	"Spelmodi: "
"DOTA_FindRegionsMany"	"Regio's: "
"StoreCheckout_NoItems"	"Je winkelwagen is leeg!"
"StoreCheckout_TooManyItems"	"Je hebt te veel items in je winkelwagen!"
"StoreCheckout_Loading"	"Bezig met afrekenen..."
"StoreCheckout_Unavailable"	"Afrekenen is tijdelijk niet mogelijk."
"StoreCheckout_Cancelling"	"Annuleren..."
"StoreCheckout_Fail"	"De in-game winkel is momenteel gesloten."
"StoreCheckout_InvalidParam"	"Een programmeur heeft er een potje van gemaakt! Er werd een ongeldige parameter naar de spelcoördinator doorgespeeld. Probeer de aankoop opnieuw te voltooien."
"StoreCheckout_InternalError"	"Er is een fout opgetreden bij het starten of bijwerken van je transactie. Probeer het later opnieuw of neem contact op met Steam Support."
"StoreCheckout_ContactSupport"	"Er was een probleem met je transactie. Neem contact op met Steam Support voor hulp."
"StoreCheckout_ContactSupport_Dialog_Title"	"Waarschuwing"
"StoreCheckout_ContactSupport_Dialog_Btn"	"Contact"
"StoreCheckout_LimitedQuantityItemsUnavailable"	"Een item dat je probeert te kopen is uitverkocht of momenteel niet beschikbaar."
"StoreCheckout_Nexon_InsufficientFunds"	"Je hebt te weinig saldo om de aankoop te voltooien."
"StoreCheckout_Nexon_FundsLocked"	"Nexon Cash-vergrendeling is ingeschakeld."
"dota_suggest_invite_format"	"Nodig %s1 uit voor de groep."
"DOTA_ChatTargetMenu_NotActive"	"(Niet actief)"
"DOTA_LobbyKicked_Header"	"Gekickt uit lobby"
"DOTA_LobbyKicked_Message"	"Je bent door de lobbyleider uit de spellobby gekickt."
"DOTA_ConfirmLANLobby_title"	"LOKALE LOBBY"
"dota_lobby_settings_hide_password"	"Wachtwoord verbergen"
"DOTA_LeagueUnsetHeader"	"League niet geselecteerd"
"DOTA_LeagueUnsetMessage"	"Er is geen league ingesteld voor deze lobby, maar je kunt dat wel doen. Wedstrijd echt starten?"
"DOTA_Lobby_Broadcaster_Channel_Other_Language"	"Andere taal"
"lobby_slot_error_header"	"Kan niet van plaats wisselen"
"generic_gc_timeout"	"Bericht onderbroken."
"lobby_slot_denied"	"Je hebt geen toestemming om deze plaats in te nemen."
"lobby_slot_cameramanalready"	"Uitzendkanalen kunnen slechts één cameraman hebben"
"lobby_slot_cameramanon"	"Je bent nu gemarkeerd als cameraman"
"lobby_slot_cameramanoff"	"Je bent niet langer een cameraman"
"lobby_slot_error"	"Kan lobbypositie niet wijzigen."
"dota_lobby_lan_title"	"Lokale server"
"DOTA_Watch_GameServerNotFound"	"De spelserver die dit spel host kan niet worden gevonden."
"DOTA_Watch_Unavailable"	"Kan dit spel momenteel niet bekijken."
"DOTA_Watch_LobbyNotFound"	"Lobby niet gevonden."
"GameUI_Language_Brazilian"	"Braziliaans-Portugees"
"client_version_out_of_date"	"De spelclient is verouderd. Sluit Dota 2 af en start het opnieuw op om de laatste versie te downloaden."
"dota_abandon_dialog_title"	"Spel verlaten"
"dota_abandon_dialog_confirm"	"Weet je zeker dat je dit spel wilt verlaten?"
"dota_abandon_dialog_yes"	"Ja, spel verlaten."
"dota_leave_dialog_title"	"Spel verlaten"
"dota_leave_dialog_confirm"	"Weet je zeker dat je dit spel wilt verlaten?"
"dota_leave_dialog_yes"	"Ja, spel verlaten."
"dota_finding_match_players"	"( {s:searching_player_count} aan het zoeken )"
"dota_finding_match_generic"	"Normaal spel"
"dota_finding_match_ranked"	"Ranked spel"
"dota_finding_match_bot"	"Spel met bots"
"dota_finding_1v1_match_casual"	"1v1-spel"
"dota_match_connected"	"Verbonden met spel"
"dota_match_local_game"	"Verbonden met een lokaal spel"
"dota_match_connecting"	"Verbinden met spel..."
"dota_match_in_progress"	"Spel bezig"
"dota_match_finished"	"Spel afgelopen"
"matchmaking_waiting_for_players"	"Wachten op andere spelers"
"matchmaking_player_declined"	"Een speler heeft de match afgewezen"
"dota_match_wait_for_host"	"Wachten op host"
"dota_match_find_server"	"Server zoeken"
"dota_play_ranked_match"	"Ranked spel"
"dota_matchmaking_region_offline"	"Offline voor onderhoud"
"DOTA_VAC_Verification_Header"	"Valve Anti-Cheat (VAC)"
"DOTA_VAC_Verification_Header_Solo"	"Kan niet meedoen aan matchmaking omdat er een probleem is met je computer dat het VAC-systeem blokkeert. Zorg ervoor dat je geen programma's gebruikt die VAC belemmeren en bevestig dat Steam juist is geïnstalleerd."
"DOTA_VAC_Verification_Header_Party"	"Kan niet meedoen aan matchmaking omdat er een probleem is met de computer dat het VAC-systeem van een of meer van je groepsleden blokkeert. Zorg ervoor dat je groepsleden geen programma's gebruiken die VAC belemmeren en bevestig dat ze Steam juist hebben geïnstalleerd."
"DOTA_VAC_Verification_Button1"	"Meer informatie"
"DOTA_VAC_Verification_Button2"	"Sluiten"
"dota_region_automatic"	"Regio: Automatisch"
"dota_ready_fail"	"GEREED MAKEN MISLUKT"
"dota_chatwheel_label_Ok"	"Oké"
"dota_chatwheel_label_Care"	"Voorzichtig"
"dota_chatwheel_label_GetBack"	"Kom terug"
"dota_chatwheel_label_NeedWards"	"Wards nodig"
"dota_chatwheel_label_Stun"	"Verlammen"
"dota_chatwheel_label_Help"	"Help"
"dota_chatwheel_label_Push"	"Push"
"dota_chatwheel_label_GoodJob"	"Goed gespeeld"
"dota_chatwheel_label_Missing"	"Vermist"
"dota_chatwheel_label_Missing_Top"	"Boven vermist"
"dota_chatwheel_label_Missing_Mid"	"Midden vermist"
"dota_chatwheel_label_Missing_Bottom"	"Onder vermist"
"dota_chatwheel_label_Go"	"Gaan!"
"dota_chatwheel_label_Initiate"	"Initialiseren!"
"dota_chatwheel_label_Follow"	"Volg me"
"dota_chatwheel_label_Group_Up"	"Groeperen"
"dota_chatwheel_label_Spread_Out"	"Verspreiden"
"dota_chatwheel_label_Split_Farm"	"Opsplitsen en farmen"
"dota_chatwheel_label_Attack"	"Nu aanvallen!"
"dota_chatwheel_label_BRB"	"Ben zo terug"
"dota_chatwheel_label_Dive"	"Duiken!"
"dota_chatwheel_label_OMW"	"Ben onderweg"
"dota_chatwheel_label_Get_Ready"	"Maak je klaar"
"dota_chatwheel_label_Bait"	"Lokaas"
"dota_chatwheel_label_Mana"	"Mana"
"dota_chatwheel_label_OOM"	"Geen mana meer"
"dota_chatwheel_label_Skill_Cooldown"	"Afkoeltijd"
"dota_chatwheel_label_Ulti_Ready"	"Ultimate is gereed"
"dota_chatwheel_label_Enemy_Returned"	"Vijand is terug"
"dota_chatwheel_label_All_Missing"	"Iedereen is vermist"
"dota_chatwheel_label_Enemy_Incoming"	"Pas op!"
"dota_chatwheel_label_Invis_Enemy"	"Onzichtbare vijand"
"dota_chatwheel_label_Enemy_Had_Rune"	"De vijand heeft een rune"
"dota_chatwheel_label_Split_Push"	"Opsplitsen en pushen"
"dota_chatwheel_label_Coming_To_Gank"	"Ik kom ganken"
"dota_chatwheel_label_Request_Gank"	"Kom ganken"
"dota_chatwheel_label_Fight_Under_Tower"	"Onder de toren"
"dota_chatwheel_label_Deny_Tower"	"Toren afwijzen"
"dota_chatwheel_label_Buy_Courier"	"Koop een koerier"
"dota_chatwheel_label_Need_Detection"	"We hebben detectie nodig"
"dota_chatwheel_label_Buy_TP"	"Koop een TP"
"dota_chatwheel_label_Reuse_Courier"	"Hergebruik de koerier"
"dota_chatwheel_label_Deward"	"Dewarden"
"dota_chatwheel_label_Building_Mek"	"Ik maak een Mekansm"
"dota_chatwheel_label_Building_Pipe"	"Ik maak een Pipe"
"dota_chatwheel_label_Pull"	"Creeps pullen"
"dota_chatwheel_label_Pulling"	"Ik pull de creeps"
"dota_chatwheel_label_Jungling"	"Junglen"
"dota_chatwheel_label_Roshan"	"Roshan"
"dota_chatwheel_label_Affirmative"	"Ja"
"dota_chatwheel_label_Wait"	"Wacht"
"dota_chatwheel_label_Pause"	"Pauzeren"
"dota_chatwheel_label_Current_Time"	"Huidige tijd"
"dota_chatwheel_label_GLHF"	"Veel succes"
"dota_chatwheel_label_Nice"	"Mooi"
"dota_chatwheel_label_Thanks"	"Bedankt"
"dota_chatwheel_label_Sorry"	"Sorry"
"dota_chatwheel_label_No_Give_Up"	"Geef niet op"
"dota_chatwheel_label_Just_Happened"	"Dat gebeurde gewoon"
"dota_chatwheel_label_Game_Is_Hard"	"Dit spel is moeilijk"
"dota_chatwheel_label_New_Meta"	"Nieuwe meta"
"dota_chatwheel_label_My_Bad"	"Mijn fout"
"dota_chatwheel_label_Regret"	"Spijt"
"dota_chatwheel_label_Relax"	"Ontspan je"
"dota_chatwheel_label_GG"	"GG"
"dota_chatwheel_label_GGWP"	"GGWP"
"dota_chatwheel_label_All_GG"	"(Iedereen) GG"
"dota_chatwheel_label_All_GGWP"	"(Iedereen) GGWP"
"dota_chatwheel_label_What_To_Buy"	"Wat te kopen?"
"dota_chatwheel_label_Im_Retreating"	"Ik trek me terug"
"dota_chatwheel_label_Space_Created"	"Ruimte gemaakt"
"dota_chatwheel_label_Whoops"	"Oeps"
"dota_chatwheel_label_Tower_then_Back"	"Toren, dan terug"
"dota_chatwheel_label_Barracks_then_Back"	"Barakken, dan terug"
"dota_chatwheel_header_positioning"	"Positionering"
"dota_chatwheel_header_status"	"Status"
"dota_chatwheel_header_enemy"	"Vijand"
"dota_chatwheel_header_lane"	"Pad"
"dota_chatwheel_header_items"	"Items"
"dota_chatwheel_header_neutrals"	"Neutrals"
"dota_chatwheel_header_misc"	"Diversen"
"dota_chatwheel_header_flavor"	"Smaak"
"dota_chatwheel_message_Ok"	"Oké. "
"dota_chatwheel_message_Care"	"Voorzichtig!"
"dota_chatwheel_message_GetBack"	"Terug!"
"dota_chatwheel_message_NeedWards"	"We hebben wards nodig."
"dota_chatwheel_message_Stun"	"Verlam nu!"
"dota_chatwheel_message_Help"	"Help!"
"dota_chatwheel_message_Push"	"Nu pushen"
"dota_chatwheel_message_GoodJob"	"Goed gespeeld!"
"dota_chatwheel_message_Missing"	"Vermist!"
"dota_chatwheel_message_BRB"	"Ben zo terug"
"dota_chatwheel_message_Dive"	"Duiken!"
"dota_chatwheel_message_OMW"	"Ik ben onderweg"
"dota_chatwheel_message_Get_Ready"	"Maak je klaar"
"dota_chatwheel_message_Bait"	"Lokaas"
"dota_chatwheel_message_Mana"	"Mana"
"dota_chatwheel_message_OOM"	"Ik heb geen mana meer"
"dota_chatwheel_message_Smoke_Gank"	"Laten we ganken met smoke!"
"dota_chatwheel_message_GLHF"	"Veel succes en veel plezier"
"dota_chatwheel_message_Nice"	"Mooi"
"dota_chatwheel_message_Thanks"	"Bedankt!"
"dota_chatwheel_message_Sorry"	"Sorry"
"dota_chatwheel_message_No_Give_Up"	"Geef niet op!"
"dota_chatwheel_message_Just_Happened"	"Dat gebeurde gewoon"
"dota_chatwheel_message_Game_Is_Hard"	"Dit spel is moeilijk"
"dota_chatwheel_message_New_Meta"	"Nieuwe meta"
"dota_chatwheel_message_My_Bad"	"Mijn fout"
"dota_chatwheel_message_Regret"	"Ik had meteen spijt van mijn beslissing"
"dota_chatwheel_message_Relax"	"Ontspan je, je doet het goed"
"dota_chatwheel_message_MissingHero"	"%s1 is vermist!"
"dota_chatwheel_message_ReturnedHero"	"%s1 is teruggekeerd!"
"dota_chatwheel_message_GG"	"Goed spel"
"dota_chatwheel_message_GGWP"	"Goed spel, goed gespeeld"
"dota_chatwheel_message_All_GG"	"Goed spel"
"dota_chatwheel_message_All_GGWP"	"Goed spel, goed gespeeld"
"dota_chatwheel_message_What_To_Buy"	"Wat moet ik kopen?"
"dota_chatwheel_message_Im_Retreating"	"Ik trek me terug"
"dota_chatwheel_message_Space_Created"	"Ruimte gemaakt"
"dota_chatwheel_message_Whoops"	"Oeps"
"dota_chatwheel_message_Tower_then_Back"	"Vernietig de toren, val daarna terug"
"dota_chatwheel_message_Barracks_then_Back"	"Vernietig de barakken, val daarna terug"
"dota_chatwheel_message_Ward_Bottom_Rune"	"Ward de onderste rune"
"dota_chatwheel_message_Ward_Top_Rune"	"Ward de bovenste rune"
"dota_chatwheel_message_Zeus_Ult"	"Zeus, gebruik je ultimate!"
"dota_settings_audio"	"Geluid"
"dota_settings_video"	"Beeld"
"dota_settings_apply"	"Toepassen"
"dota_settings_game"	"Spel"
"DOTA_Keybind_LOL"	"League of Legends"
"DOTA_Keybind_HON"	"Heroes of Newerth"
"DOTA_Keybind_SMITE"	"Smite"
"DOTA_Lobby_BotDifficulty"	"Moeilijkheidsgraad bots"
"DOTA_Lobby_BotDifficulty_passive"	"Passief"
"DOTA_Lobby_BotDifficulty_easy"	"Makkelijk"
"DOTA_Lobby_BotDifficulty_medium"	"Gemiddeld"
"DOTA_Lobby_BotDifficulty_hard"	"Moeilijk"
"DOTA_Lobby_BotDifficulty_unfair"	"Oneerlijk"
"DOTA_Lobby_BotDifficulty_bot_passive"	"Passieve bot"
"DOTA_Lobby_BotDifficulty_bot_easy"	"Makkelijke bot"
"DOTA_Lobby_BotDifficulty_bot_medium"	"Gemiddelde bot"
"DOTA_Lobby_BotDifficulty_bot_hard"	"Moeilijke bot"
"DOTA_Lobby_BotDifficulty_bot_unfair"	"Oneerlijke bot"
"dota_lobby_title"	"{s:lobby_name}"
"lobby_row_player_name"	"{s:player_name}"
"dota_lobby_row_game_name"	"{s:game_name}"
"dota_lobby_row_slots"	"{s:slots}"
"dota_lobby_row_game_mode"	"{s:game_mode}"
"dota_lobby_row_join"	"Deelnemen"
"dota_lobby_row_leave"	"Verlaten"
"dota_lobby_browser_num_available"	"( {d:lobbies_available} beschikbaar )"
"DOTA_EquippedItem_Rarity"	"{s:equipped_econ_set_rarity}"
"DOTA_EquippedItem_SetName"	"{s:equipped_econ_set_name}"
"DOTA_EquippedItem_PartialSet"	"Gedeeltelijke set"
"DOTA_EquippedItem_Button_Details"	"{s:equipped_details_button_text}"
"DOTA_EquippedItem_Customize"	"Aanpassen"
"DOTA_EquippedItem_SaleAmount"	"-{i:equipped_econ_set_sale_amount}%"
"DOTA_EquippedItem_RegularSetPrice"	"{s:equipped_econ_regular_set_price}"
"DOTA_EquippedItem_SetPrice"	"{s:equipped_econ_set_price}"
"DOTA_EquippedItem_TreasurePrice"	"{s:equipped_econ_treasure_price}"
"DOTA_EconItemSet_Name"	"{s:econ_set_name}"
"DOTA_EconItemSet_Rarity"	"{s:econ_set_rarity}"
"DOTA_EconItemSet_Status"	"{s:econ_set_status}"
"DOTA_EconItemSet_Price"	"{s:econ_set_price}"
"DOTA_EconItemSet_SaleAmount"	"-{i:econ_sale_amount}%"
"DOTA_HeroGrid_OptionCategory_Role"	"Rollen:"
"DOTA_HeroLoadout_PreviousHeroName"	"{s:previous_hero_name}"
"DOTA_HeroLoadout_NextHeroName"	"{s:next_hero_name}"
"DOTA_HeroLoadout_CurrentHeroName"	"{s:hero_name}"
"DOTA_HeroLoadout_AttackType"	"{s:hero_attack_type}"
"DOTA_HeroLoadout_HeroFilterName"	"Held"
"DOTA_HeroCustomize_Slot"	"Positie"
"DOTA_HeroCustomize_SlotName"	"{s:slot_name}"
"DOTA_HeroCustomize_SlotEquippedItemName"	"{s:equipped_item_name}"
"returning_top_of_queue"	"Terugkeren naar matchmaking met hoge prioriteit..."
"GC_Wait_Time"	"Verwachte wachttijd: %s1"
"GC_Wait_Time_Unknown"	"Onbekend"
"DOTA_practice_vs_bots_team_radiant"	"Radiant"
"DOTA_practice_vs_bots_team_dire"	"Dire"
"DOTA_practice_vs_bots_team_random"	"Willekeurig"
"DOTA_CurrentTime"	"{t:t:current_time}"
"DOTA_MonthlyPlayers"	"{s:users_last_month}"
"DOTA_Search_NoResults"	"Geen resultaten"
"join_error_already_in_game"	"Kan niet meedoen in oefenlobby, want je bent al aan het spelen."
"join_error_invalid_lobby"	"De opgegeven lobby bestaat niet meer."
"join_error_incorrect_password"	"Onjuist wachtwoord."
"join_error_access_denied"	"Toegang geweigerd."
"join_error_generic"	" "
"DOTA_Feed_Timestamp_MinutesAgo"	"{i:value} minuten geleden"
"DOTA_Feed_Timestamp_HourAgo"	"{i:value} uur geleden"
"DOTA_Feed_Timestamp_HoursAgo"	"{i:value} uur geleden"
"DOTA_Feed_Timestamp_Yesterday"	"Gisteren"
"DOTA_Feed_Timestamp_Date"	"{s:month} {s:day}"
"dota_lobby_type_practice"	"Oefenspel"
"dota_lobby_type_tournament"	"Toernooi"
"dota_lobby_unknown"	"Onbekend"
"DOTA_Lobby_No_Players_Title"	"GEEN SPELERS IN EEN TEAM"
"dota_match_result_none"	"???"
"dota_social_feed_loading"	"Laden..."
"DOTA_LoadingPlayerUnknown"	"-"
"DOTA_LoadingPlayerLoading"	"Laden..."
"DOTA_LoadingPlayerFullyConnected"	"Gereed"
"DOTA_LoadingPlayerFailed"	"Mislukt"
"LoadingScreenTimer"	"{t:d:countdown_timer_seconds}"
"HeroSelectionTimer"	"{i:timer_seconds}"
"LoadingScreenPlayersInfo"	"Spelers: {i:players_loaded}/{i:players_total}"
"LoadingScreenSpectatorsInfo"	"Toeschouwers: {i:spectators_loaded}/{i:spectators_total}"
"custom_end_screen_victory_message"	"{s:winning_team_name} wint!"
"custom_end_screen_legend_player"	"Speler"
"custom_end_screen_legend_level"	"Level"
"custom_end_screen_legend_hero"	"Held"
"custom_end_screen_legend_gold"	"Goud"
"custom_end_screen_legend_team_score"	"Score"
"custom_scoreboard_hero_name_and_desc"	"Lvl {i:hero_level} {s:hero_name}"
"CustomEndScreenClose"	"Sluiten"
"DOTA_Armory_Category_Heroes"	"Helden"
"DOTA_Armory_Category_Couriers"	"Koeriers"
"DOTA_Armory_Category_World"	"Wereld"
"DOTA_Armory_Category_Wards"	"Wards"
"DOTA_Armory_Category_Weather"	"Weerseffecten"
"DOTA_Armory_Category_LoadingScreens"	"Laadschermen"
"DOTA_Armory_Category_Music"	"Muziek"
"DOTA_Armory_SortBy_Rarity"	"Zeldzaamheid"
"DOTA_Armory_SortBy_Quality"	"Kwaliteit"
"DOTA_Armory_SortBy_Name"	"Naam"
"dota_page_match_details_legend_player"	"Speler"
"dota_page_match_details_legend_level"	"Level"
"dota_page_match_details_legend_hero"	"Held"
"dota_profile_content_tab_activity_feed"	"Activiteiten-feed"
"dota_profile_content_tab_recent_games"	"Recente spellen"
"dota_profile_recent_games_option_show_practice_matches"	"Toon mijn oefenwedstrijden"
"dota_profile_recent_game_header_timestamp"	"Datum / tijd"
"dota_profile_recent_game_header_hero_name"	"Held gespeeld"
"dota_profile_recent_game_header_result"	"Resultaat"
"dota_profile_recent_game_header_duration"	"Duur"
"dota_profile_recent_game_header_type"	"Type"
"dota_profile_recent_game_result_abandon"	"Verlaten"
"dota_profile_recent_game_icon_source1"	"S1"
"dota_profile_hero_with_index"	"{d:hero_index} {s:hero_name}"
"dota_profile_hero"	"{s:hero_name}"
"DOTA_tooltip_econ_item_name"	"{s:item_name}"
"DOTA_tooltip_econ_item_description"	"{s:item_description}"
"DOTA_tooltip_econ_item_set"	"Onderdeel van: <font color='#dddddd'>{s:item_set}</font>"
"DOTA_tooltip_econ_item_rarity_label"	"Zeldzaamheid: "
"DOTA_tooltip_econ_item_rarity"	"{s:item_rarity}"
"DOTA_tooltip_econ_item_slot"	"Positie: {s:item_slot}"
"DOTA_tooltip_econ_item_gifter"	"{g:dota_persona:gifter_name}"
"DOTA_tooltip_econ_item_gift_received_date"	"Ontvangen: {t:T:gift_received_date_time}"
"DOTA_tooltip_econ_item_trade_restriction_permanent"	"Niet ruilbaar"
"DOTA_tooltip_econ_item_trade_restriction_date"	"Niet ruilbaar tot: {t:T:tradable_after_date_time} {t:s:tradable_after_date_time}"
"DOTA_tooltip_econ_item_market_restriction_permanent"	"Niet verhandelbaar"
"DOTA_tooltip_econ_item_gift_restriction_permanent"	"Niet schenkbaar"
"DOTA_tooltip_econ_item_gift_restriction_date"	"Niet schenkbaar tot: {t:T:giftable_after_date_time} {t:s:giftable_after_date_time}"
"DOTA_tooltip_econ_item_gem_type"	"{s:gem_type}"
"DOTA_tooltip_econ_item_gem_strange_count"	"{d:strange_count}"
"DOTA_tooltip_econ_item_gem_description"	"{s:gem_description}"
"DOTA_tooltip_econ_item_partner"	"{s:partner}"
"DOTA_econ_item_details_item_name"	"{s:item_name}"
"DOTA_econ_item_details_item_creation_date"	"AANMAAKDATUM: {t:l:creation_date}"
"DOTA_econ_item_details_set_includes"	"Bevat het volgende:"
"DOTA_econ_item_details_item_set"	"Onderdeel van: <font color='#dddddd'>{s:item_set}</font>"
"DOTA_econ_item_details_rarity_label"	"Zeldzaamheid: "
"DOTA_econ_item_details_item_rarity"	"{s:item_rarity}"
"DOTA_econ_item_details_item_slot"	"Positie: {s:item_slot}"
"DOTA_econ_item_details_item_description"	"{s:item_description}"
"DOTA_econ_item_details_gem_type"	"{s:gem_type}"
"DOTA_econ_item_details_gem_strange_count"	"{d:strange_count}"
"DOTA_econ_item_details_gem_description"	"{s:gem_description}"
"DOTA_Treasure_Name"	"{s:treasure_name}"
"DOTA_Treasure_Rarity"	"<span class=\"ItemRarityColor\">{s:treasure_rarity}</span> schat"
"custom_game_team_select_timer"	"{i:countdown_timer_seconds}"
"custom_game_team_select_shuffle"	"Husselen"
"custom_game_team_select_starting"	"Starten"
"custom_game_team_select_join"	"Deelnemen"
"CouldntFindCompendium"	"Het compendium-testbestand kon niet worden geladen: {s:s1}"
"CompendiumPageError_Pages"	"Kon geen \\'pages\\'-blok vinden in het compendium-databestand."
"CompendiumPageError_Template"	"Kon geen 'template'-vermelding vinden in compendiumpagina '{s:s1}' (paginanummer {s:s2})"
"CompendiumPageError_Template2"	"Kon geen template vinden met de naam '{s:s1}' in compendiumpagina '{s:s2}'"
"CompendiumPageError_Image"	"Kon geen afbeelding vinden met de naam '{s:s1}' in compendiumpagina '{s:s2}'"
"CompendiumPageError_Text"	"Kon geen tekstblok vinden met de naam '{s:s1}' in compendiumpagina '{s:s2}'"
"CompendiumPageError_Video"	"Kon een video genaamd '{s:s1}' niet vinden in compendiumpagina '{s:s2}'"
"CompendiumPageError_Scrollbar"	"Kon geen schuifbalk genaamd '{s:s1}' vinden in compendium-pagina '{s:s2}'"
"CompendiumPageError_Selection"	"Kon geen selectie vinden met de naam '{s:s1}' in compendiumpagina '{s:s2}'"
"CompendiumPageError_PageNames"	"Ingebedde pagina '{s:s1}' gebruikt dezelfde naam als een andere pagina. Paginanamen moeten uniek zijn."
"CompendiumPageError_CustomText"	"Fout in aangepast tekstblok '{s:s1}' in compendiumpagina '{s:s2}'"
"CompendiumPageError_CustomImg"	"Fout in aangepast afbeeldingblok '{s:s1}'"
"CompendiumPageError_CustomBar"	"Fout in aangepaste voortgangsbalk, blok '{s:s1}' in compendiumpagina '{s:s2}'"
"CompendiumPageError_CustomEle"	"Initialiseren van aangepast element '{s:s1}' mislukt in compendiumpagina '{s:s2}'"
"CompendiumPageError_CTFont"	"Ongeldig lettertype '{s:s1}' opgegeven in compendiumpagina '{s:s2}'. Geldige lettertypes:\ntext, textbold, title"
"CompendiumPageError_CTAlign"	"Ongeldige uitlijning '{s:s1}' opgegeven in compendiumpagina '{s:s2}'. Geldige uitlijningen:\n left, right, center"
"CompendiumPageError_CTDepth"	"Ongeldige diepte '{s:s1}'. Geldige dieptes:\n front, back"
"CompendiumPageError_LinePos"	"Lijn '{s:s1}' heeft niet beide 'start'- en 'end'-positieblokken."
"CompendiumPageError_CTPoints"	"Ongeldige selectie-index '{s:s1}' in 'points'-sectie van persoonlijke tekst '{s:s2}'."
"CompendiumPageError_CTPoints2"	"Ongeldige selectie-index '{s:s1}' in 'points'-sectie van persoonlijke tekst '{s:s2}'. Geen selectie gevonden met die index."
"CompendiumPageError_SelDesc"	"Geen 'description'-sleutel gevonden voor selectie '{s:s1}' in compendiumpagina '{s:s2}'"
"CompendiumPageError_Points"	"Ontbrekend (of nul) 'points' gespecificeerd voor selectie '{s:s1}' in compendiumpagina '{s:s2}'"
"CompendiumPageError_SelType"	"Ontbrekend 'choice_type' voor selectie '{s:s1}' in compendiumpagina '{s:s2}'"
"CompendiumPageError_BarType"	"'data' ontbreekt voor voortgangsbalk '{s:s1}' in compendiumpagina '{s:s2}'"
"CompendiumPageError_NoTime"	"Ontbrekend of ongeldige 'time' gespecificeerd voor selectie '{s:s1}' in '{s:s2}'"
"CompendiumPageError_ElementType"	"Ontbrekend of ongeldig 'elementtype' voor element '{s:s1}' in compendiumpagina '{s:s2}'"
"CompendiumPageError_SelTimer"	"Onbekende timer genaamd '{s:s1}' in compendiumpagina '{s:s2}'"
"CompendiumPageError_BadElement"	"Onbekend SF-element genaamd '{s:s1}' in compendiumpagina '{s:s2}'"
"CompendiumPageError_SelNoTimer"	"Geen timers gevonden in compendiumpagina '{s:s1}' (er zijn selecties die een timer nodig hebben)"
"CompendiumPageError_SelUnknown"	"Ongeldige 'choice_type' van '{s:s1}' voor selectie '{s:s2}'"
"CompendiumPageError_BarUnknown"	"Ongeldig 'data' van '{s:s1}' voor selectie '{s:s2}'"
"CompendiumPageError_SelChoices"	"Ontbrekende 'choices'-blok voor selectie '{s:s1}' in compendiumpagina '{s:s2}'"
"CompendiumPageError_NoHero"	"Kon geen held vinden met held-ID '{s:s1}' voor selectie '{s:s2}'"
"CompendiumPageError_Unknown"	"Interne compendiumlogica-fout. Contacteer Valve om dit op te lossen."
"CompendiumPageError_ImageDL"	"Starten van compendiumafbeelding '{s:s1}' ({s:s2}) downloaden is mislukt"
"CompendiumPageError_ImageDLErr"	"Downloaden van compendiumafbeelding '%s' ({s:s2}) is mislukt"
"CompendiumPageError_BtnNoElem"	"Geen 'selection_elements'-blok gevonden voor knop '{s:s1}' in compendiumpagina '{s:s2}'"
"CompendiumPageError_BtnBadVal"	"Keuzewaarde '{s:s1}' in knop '{s:s2}' staat niet in de keuzelijst voor die selectie-index."
"CompendiumPageError_BtnBadSel"	"'selection_force_to'-instelling in element '{s:s1}' zit niet in de opties voor keuzelijst '{s:s2}'"
"CompendiumPageError_BtnSelIdx"	"Knop '{s:s1}' in compendium-pagina '{s:s2}' heeft ontbrekende of onjuiste 'selection_index'"
"CompendiumPageError_CmdSelIdx"	"Element '{s:s1}' in compendiumpagina '{s:s2}' bevat een missend of ongeldig commando 'selection_index' of 'force_selection_index'"
"CompendiumPageError_ImgSelIdx"	"Onjuiste 'selection_index' van '{s:s1}' in afbeelding '{s:s2}'."
"CompendiumPageError_ImgShowSelIdx"	"Onjuiste 'show_selection_index' van '{s:s1}' in afbeelding '{s:s2}'."
"CompendiumPageError_ImgSelVal"	"Ongeldige selectiekeuze '{s:s1}' in 'show_selection_images'-sectie van afbeelding '{s:s2}'."
"CompendiumPageError_ImgBadStyle"	"Ongeldige afbeeldingsstijl '{s:s1}' voor afbeelding '{s:s2}'."
"CompendiumPageError_DynTxtSel"	"Tekst '{s:s1}' op pagina '{s:s2}' bevat ongeldige % selection_X %. Geen vooraf geregistreerde selectie met die index."
"CompendiumPageError_NoTxtList"	"Kan geen tekstlijst genaamd '{s:s1}' vinden op pagina '{s:s2}'"
"CompendiumPageError_TOCPage"	"Pagina table_of_contents_page '{s:s1}' bestaat niet."
"CompendiumPageError_SelIndex"	"Selectie '{s:s1}' in compendiumpagina '{s:s2}' heeft ontbrekende of ongeldige 'selection_index'"
"CompendiumPageError_SelUsed"	"Selectie '{s:s1}' in compendiumpagina '{s:s2}' heeft geen unieke 'selection_index'"
"CompendiumPageError_SelVal"	"Keuzemenu '{s:s1}' in compendiumpagina '{s:s2}' heeft keuzes met dezelfde waarden"
"CompendiumPageError_SelValInv"	"Keuzelijst '{s:s1}' in compendiumpagina '{s:s2}' heeft een keuze met een waarde <= 0. Keuzewaarden moeten groter zijn dan 0."
"CompendiumPageError_SelTTVal"	"Keuzelijst '{s:s1}' in compendiumpagina '{s:s2}' heeft een tooltip_data-item met een waarde die niet in de lijst van opties staat."
"CompendiumPageError_NoAnswer"	"Selectie '{s:s1}' op compendiumpagina '{s:s2}' heeft geen 'answer'- of 'answers'-sleutel in zijn 'result'-sectie"
"CompendiumPageError_MissAnswer"	"Selectie '{s:s1}' op compendiumpagina '{s:s2}' heeft een 'answer'- of 'answers'-sleutel die niet overeenkomt met een keuze"
"CompendiumPageError_Timer"	"Timer '{s:s1}' heeft een ongeldige epoch-tijd"
"CompendiumPageError_UnknownAction"	"Object '{s:s1}' verwijst naar onbekende actie '{s:s2}'"
"CompendiumPageError_SameElement"	"Zichtbaarheidssysteem heeft meerdere elementen met de naam '{s:s1}' op pagina '{s:s2}' gevonden"
"CompendiumPageError_DupeKey"	"KeyValues-blok '{s:s1}' bevat meerdere sleutels met dezelfde naam '{s:s2}'."
"CompendiumError_Template"	"Kon geen template vinden met de naam '{s:s1}'"
"CompendiumError_DupeTemplate"	"Meerdere templates met de naam '{s:s1}' gevonden"
"CompendiumError_NoDefines"	"Template '{s:s1}' heeft definities nodig, maar instantie '{s:s2}' ervan heeft geen 'defines'-blok."
"CompendiumError_MissingDef"	"Afgeleide instantie '{s:s1}' bevat geen definitie genaamd '{s:s2}', maar de template waarvan het afleidt vereist het."
"CompendiumError_BadDef"	"Afgeleide instantie '{s:s1}' bevat een vereiste definitie genaamd '{s:s2}' die niet met '%def' start, wat vereist is."
"DOTA_GlobalItems_World"	"Wereld"
"DOTA_GlobalItems_Wards"	"Wards"
"DOTA_GlobalItems_LoadingScreens"	"Laadschermen"
"DOTA_GlobalItems_Music"	"Muziek"
"DOTA_Search"	"Zoeken"
"DOTA_Start"	"Starten"
"DOTA_PleaseWait"	"Even geduld..."
"DOTA_ProfileCard_HeroHover"	"Toon bij aanwijzen:"
"dota_lobby_settings_edit"	"Bewerken"
"DOTA_WatchLive_Steam"	"STEAM"
"DOTA_WatchLive_Broadcaster0"	"{g:dota_persona:b:broadcaster_account_id_0} bekijken"
"DOTA_WatchLive_Broadcaster1"	"{g:dota_persona:b:broadcaster_account_id_1} bekijken"
"DOTA_WatchLive_Broadcaster2"	"{g:dota_persona:b:broadcaster_account_id_2} bekijken"
"DOTA_WatchLive_Broadcaster3"	"{g:dota_persona:b:broadcaster_account_id_3} bekijken"
"DOTA_WatchLive_Broadcaster4"	"{g:dota_persona:b:broadcaster_account_id_4} bekijken"
"DOTA_WatchLive_Broadcaster5"	"{g:dota_persona:b:broadcaster_account_id_5} bekijken"
"DOTA_WatchLive_Broadcaster6"	"{g:dota_persona:b:broadcaster_account_id_6} bekijken"
"DOTA_WatchLive_Broadcaster7"	"{g:dota_persona:b:broadcaster_account_id_7} bekijken"
"DOTA_WatchLive_Broadcaster8"	"{g:dota_persona:b:broadcaster_account_id_8} bekijken"
"DOTA_WatchLive_Broadcaster9"	"{g:dota_persona:b:broadcaster_account_id_9} bekijken"
"Compendium_DefaultText_CD_Days"	"dagen"
"Compendium_DefaultText_CD_Hours"	"uur"
"Compendium_DefaultText_CD_Minutes"	"minuten"
"Compendium_DefaultText_CD_Seconds"	"seconden"
"NetGraph_FPS"	"fps: {d:fps}"
"NetGraph_Ping"	"ping: {d:ping}ms"
"DOTA_Credits"	"Dankbetuigingen"
"DOTA_ActorCredits_1_Name"	"Dee Bradley Baker"
"DOTA_ActorCredits_2_Name"	"Dennis Bateman"
"DOTA_ActorCredits_3_Name"	"Tom Chantler"
"DOTA_ActorCredits_4_Name"	"Merle Dandridge"
"DOTA_ActorCredits_5_Name"	"Barry Dennen"
"DOTA_ActorCredits_6_Name"	"Dave Fennoy"
"DOTA_ActorCredits_7_Name"	"Jim French"
"DOTA_ActorCredits_8_Name"	"Michael Gregory"
"DOTA_ActorCredits_9_Name"	"Gin Hammond"
"DOTA_ActorCredits_10_Name"	"John Patrick Lowrie"
"DOTA_ActorCredits_11_Name"	"Ellen McLain"
"DOTA_ActorCredits_12_Name"	"Bruce Miles"
"DOTA_ActorCredits_13_Name"	"Linda K. Morris"
"DOTA_ActorCredits_14_Name"	"Sam A. Mowry"
"DOTA_ActorCredits_15_Name"	"Eric Newsome"
"DOTA_ActorCredits_16_Name"	"Nolan North"
"DOTA_ActorCredits_17_Name"	"Dempsey Pappion"
"DOTA_ActorCredits_18_Name"	"TJ Ramini"
"DOTA_ActorCredits_19_Name"	"Harry S. Robins"
"DOTA_ActorCredits_20_Name"	"Gary Schwartz"
"DOTA_ActorCredits_21_Name"	"David Scully"
"DOTA_ActorCredits_22_Name"	"Mike Shapiro"
"DOTA_ActorCredits_23_Name"	"David Sobolov"
"DOTA_ActorCredits_24_Name"	"Jon St. John"
"DOTA_ActorCredits_25_Name"	"Fred Tatasciore"
"DOTA_ActorCredits_26_Name"	"Jen Taylor"
"DOTA_ActorCredits_27_Name"	"Tony Todd"
"DOTA_PlayerContextMenu_Trade"	"Uitnodigen om te ruilen"
"DOTA_Custom_Game_Finished_Vote_Skip"	"Overslaan"
"DOTA_TabName_ModsLobbyList"	"Lobby-lijst"
"DOTA_WatchLive_Fullscreen"	"VOLLEDIG SCHERM"
"DOTA_JoinChatChannel_ChannelMemberCount"	"Leden"
"DOTA_Chat_ChannelMemberCount"	"{d:channel_member_count}"
"DOTA_GiftWrap_Success_Header"	"Geslaagd"
"DOTA_GiftWrap_Success"	"Je geschenk is afgeleverd."
"DOTA_CurrentGameplayVersion"	"6.84c"
"DOTA_Recycling"	"Recyclen"
"DOTA_Recycling_Action"	"Recycle"
"DOTA_Recycling_DragItems"	"Sleep ongewenste voorwerpen hier naartoe"
"DOTA_Recycling_Confirm"	"Weet je zeker dat je deze voorwerpen wilt recyclen?"
"DOTA_RecyclingCharm_Name"	"Charm of the Crucible Jewel II"
"DOTA_RecyclingCharm_Bonus"	"+25 Compendiummunten"
}
