"dota"
{
"DOTA_Accept"	"Annehmen"
"DOTA_Cancel"	"Abbrechen"
"DOTA_Console"	"Konsole"
"DOTA_Create"	"Erstellen"
"DOTA_Decline"	"Ablehnen"
"DOTA_Error"	"Fehler"
"DOTA_Join"	"Beitreten"
"DOTA_Leave"	"Verlassen"
"DOTA_New"	"Neu"
"DOTA_Ok"	"OK"
"DOTA_Sale"	"Angebot"
"DOTA_Close"	"Schließen"
"DOTA_Continue"	"Weiter"
"DOTA_Add"	"Hinzufügen"
"DOTA_Edit"	"Bearbeiten"
"DOTA_Enable"	"Aktivieren"
"DOTA_Disable"	"Deaktivieren"
"DOTA_Refresh"	"Aktualisieren"
"DOTA_Loading"	"Ladevorgang läuft"
"DOTA_None"	"Keine"
"DOTA_Customize"	"Anpassen"
"DOTA_AcceptChanges"	"Änderungen übernehmen"
"dota_team_radiant"	"Radiant"
"dota_team_dire"	"Dire"
"Unknown"	"Unbekannt"
"UI_Yes"	"Ja"
"UI_No"	"Nein"
"UI_File_Filter_Any"	"Alle Dateien (*.*)"
"DOTA_MainMenu_Heroes"	"Helden"
"DOTA_MainMenu_Watch"	"Zuschauen"
"DOTA_MainMenu_Learn"	"Lernen"
"DOTA_MainMenu_Mods"	"Angepasste Spiele"
"DOTA_TabName_GlobalItems"	"Globale Gegenstände"
"DOTA_TabName_Treasury"	"Schatzkammer"
"DOTA_TabName_Armory"	"Arsenal"
"DOTA_ConfirmQuit"	"VERLASSEN BESTÄTIGEN"
"DOTA_ConfirmQuitDesc"	"Möchten Sie Dota 2 wirklich beenden?"
"DOTA_ConfirmQuitDescUnsafe"	"Ein Spiel zu verlassen, obwohl es noch nicht beendet ist, könnte den anderen Spielern das Spiel ruinieren. Wollen Sie Dota 2 wirklich beenden?"
"DOTA_InvalidPersonaName"	"[unbekannt]"
"DOTA_Friends_WindowTitle"	"FREUNDE"
"DOTA_FriendsCategory_ReadyToPlay"	"In offenen Spielen <font color='#63C290'><b></b>({d:friend_count})</font>"
"DOTA_FriendsCategory_PlayingDota"	"In Dota <font color='#ACEBA9'>({d:friend_count})</font>"
"DOTA_FriendsCategory_Online"	"Online <font color='#6a9dcc'>({d:friend_count})</font>"
"DOTA_FriendsCategory_Pending"	"Ausstehend <font color='#eeee82'>({d:friend_count})</font>"
"DOTA_FriendsCategory_Offline"	"Offline <font color='#676666'>({d:friend_count})</font>"
"DOTA_Friends_Empty"	"Ihre Freundesliste ist derzeit leer"
"DOTA_FriendsMenu_Tooltip_NoneReady"	"Freunde"
"DOTA_UserName"	"{g:dota_persona:user_account_id}"
"DOTA_UserNamePro"	"{g:dota_persona_pro:user_account_id}"
"DOTA_UserNickname"	"{g:dota_persona_nickname:user_account_id}"
"DOTA_UserRichPresence"	"{s:user_rich_presence}"
"DOTA_ProfileCard_StatTitle_SoloRank"	"Solo-MMW"
"DOTA_ProfileCard_StatTitle_PartyRank"	"Gruppen-MMW"
"DOTA_ProfileCard_StatTitle_Wins"	"Siege"
"DOTA_ProfileCard_StatTitle_Commends"	"Empfehlungen"
"DOTA_ProfileCard_StatTitle_GamesPlayed"	"Spiele"
"DOTA_ProfileCard_StatTitle_FirstMatchDate"	"Erstes Spiel"
"DOTA_ProfileCard_StatValue_Int"	"{d:stat_value}"
"DOTA_ProfileCard_StatValue_Date"	"{t:s:stat_value}"
"DOTA_ProfileCard_StatValue_String"	"{s:stat_value}"
"DOTA_ProfileCard_SlotTab_Trophies"	"Trophäen"
"DOTA_ProfileCard_SlotTab_Items"	"Arsenal"
"DOTA_ProfileCard_SlotTab_Heroes"	"Helden"
"DOTA_ProfileCard_SlotTab_Emoticons"	"Emoticons"
"DOTA_ProfileCard_NoTrophies"	"Keine Trophäen verfügbar."
"DOTA_ProfileCard_NoItems"	"Keine Gegenstände verfügbar."
"DOTA_ProfileCard_HeroOnly"	"Nur Helden"
"DOTA_ProfileCard_HeroShowWins"	"Siege anzeigen"
"DOTA_ProfileCard_HeroShowWinsAndLosses"	"Sieg-Niederlage anzeigen"
"DOTA_ProfileCard_ItemSearchPrefix"	"Suchen nach:"
"DOTA_ProfileCard_ItemSearchPlaceholder"	"Gegenstände nach Namen"
"DOTA_ProfileCard_ItemArmoryLink"	"Gesamtes Arsenal anzeigen"
"DOTA_HeroTooltip_HeroName"	"{s:hero_name}"
"DOTA_HeroTooltip_HeroRecord"	"{s:hero_wins_string}, {s:hero_losses_string}"
"DOTA_ProfileCard_HeroSearchPlaceholder"	"Nach Heldennamen suchen"
"DOTA_Wins_Singular"	"1 Sieg"
"DOTA_Wins_Plural"	"{d:hero_wins} Siege"
"DOTA_Losses_Singular"	"1 Niederlage"
"DOTA_Losses_Plural"	"{d:hero_losses} Niederlagen"
"DOTA_Profile_TotalGames"	"Spiele gesamt"
"DOTA_Profile_Solo_MMR"	"Solo-MMW"
"DOTA_Profile_Team_MMR"	"Team-MMW"
"DOTA_Profile_Party_MMR"	"Gruppen-MMW"
"DOTA_Profile_VictoryCount"	"Siege"
"DOTA_Profile_ProfilePage"	"Profil"
"DOTA_Profile_RecentGamesPage"	"Letzte Spiele"
"DOTA_Profile_HeroPage"	"Helden"
"DOTA_Profile_PlayStyle"	"Spielstil"
"DOTA_Profile_MostRecent"	"Letzte(s) {s:num_style_games} Spiel(e)"
"DOTA_Profile_RecentActivity"	"Kürzliche Aktivitäten"
"DOTA_Profile_Fighting"	"Kampf"
"DOTA_Profile_Fighting_TooltipTitle"	"Kampf"
"DOTA_Profile_Fighting_Tooltip"	"Sucht die Konfrontation mit gegnerischen Helden."
"DOTA_Profile_Farming"	"Farm"
"DOTA_Profile_Farming_TooltipTitle"	"Farm"
"DOTA_Profile_Farming_Tooltip"	"Sammelt Gold durch das Töten von Kreaturen."
"DOTA_Profile_Supporting"	"Support"
"DOTA_Profile_Supporting_TooltipTitle"	"Support"
"DOTA_Profile_Supporting_Tooltip"	"Unterstützt sein Team mit Heilung, Wards und Gegenständen."
"DOTA_Profile_Pushing"	"Push"
"DOTA_Profile_Pushing_TooltipTitle"	"Push"
"DOTA_Profile_Pushing_Tooltip"	"Greift gegnerische Türme an und schafft damit mehr sicheren Raum für sein Team."
"DOTA_Profile_Versatility"	"Flexibilität"
"DOTA_Profile_Versatility_TooltipTitle"	"Flexibilität"
"DOTA_Profile_Versatility_Tooltip"	"Flexibel und kann viele verschiedene Helden spielen."
"DOTA_Profile_Tooltip_Value"	"{s:CurrentStatValue}"
"DOTA_Profile_Tooltip_Comparison"	"{s:CurrentComparisonValue}"
"DOTA_Profile_StatsCompare"	"Mit meinen Statistiken vergleichen"
"DOTA_Profile_Self"	"Ich"
"DOTA_Profile_GPM"	"GPM (Durschnitt)"
"DOTA_Profile_XPM"	"EPM (Durchschnitt)"
"DOTA_Profile_LH"	"Last Hits (Durchschnitt)"
"DOTA_Profile_Rampages"	"Völlig außer Kontrolle"
"DOTA_Profile_TripleKills"	"Triple-Kills"
"DOTA_Profile_FirstBlood"	"First Bloods"
"DOTA_Profile_CourierKills"	"Getötete Kuriere"
"DOTA_Profile_Aegises"	"Gestohlene Aegis"
"DOTA_Profile_CheeseEaten"	"Cheese gegessen"
"DOTA_Profile_CreepStack"	"Gestapelte Lager"
"DOTA_Profile_GPMValue"	"{s:GPM}"
"DOTA_Profile_XPMValue"	"{s:XPM}"
"DOTA_Profile_LHValue"	"{s:LH}"
"DOTA_Profile_RampagesValue"	"{d:Rampages}"
"DOTA_Profile_TripleKillsValue"	"{d:TripleKills}"
"DOTA_Profile_FirstBloodValue"	"{d:FirstBlood}"
"DOTA_Profile_FirstBledValue"	"{d:FirstBled}"
"DOTA_Profile_CourierKillsValue"	"{d:CourierKills}"
"DOTA_Profile_AegisesValue"	"{d:Aegises}"
"DOTA_Profile_CheeseEatenValue"	"{d:CheeseEaten}"
"DOTA_Profile_CreepStackValue"	"{d:CreepStack}"
"DOTA_Profile_GPMLocalValue"	"{s:GPMLocal}"
"DOTA_Profile_XPMLocalValue"	"{s:XPMLocal}"
"DOTA_Profile_LHLocalValue"	"{s:LHLocal}"
"DOTA_Profile_RampagesLocalValue"	"{d:RampagesLocal}"
"DOTA_Profile_TripleKillsLocalValue"	"{d:TripleKillsLocal}"
"DOTA_Profile_FirstBloodLocalValue"	"{d:FirstBloodLocal}"
"DOTA_Profile_FirstBledLocalValue"	"{d:FirstBledLocal}"
"DOTA_Profile_CourierKillsLocalValue"	"{d:CourierKillsLocal}"
"DOTA_Profile_AegisesLocalValue"	"{d:AegisesLocal}"
"DOTA_Profile_CheeseEatenLocalValue"	"{d:CheeseEatenLocal}"
"DOTA_Profile_CreepStackLocalValue"	"{d:CreepStackLocal}"
"DOTA_RecentGames_Title"	"Letzte Spiele"
"DOTA_RecentGames_TimeStamp"	"Datum/Zeit"
"DOTA_RecentGames_HeroSelection"	"Gespielter Held"
"DOTA_RecentGames_GameResult"	"Ergebnis"
"DOTA_RecentGames_GameLength"	"Dauer"
"DOTA_RecentGames_Team"	"Team"
"DOTA_RecentGames_GameType"	"Typ"
"DOTA_RecentGames_Items"	"Gegenstände"
"DOTA_RecentGame_Timestamp_Entry"	"{t:s:timestamp} {t:t:timestamp}"
"DOTA_RecentGame_Duration"	"{t:d:duration}"
"DOTA_RecentGame_Downloading"	"{s:DownloadPercent} heruntergeladen"
"DOTA_RecentGame_Watch"	"Aufnahme anschauen"
"DOTA_RecentGame_NoReplay"	"Keine Aufnahme"
"DOTA_RecentGame_Expired"	"Aufnahme abgelaufen"
"DOTA_RecentGame_Finding"	"Suchen..."
"DOTA_RecentGame_Download"	"Partie herunterladen"
"DOTA_RecentGame_Pending"	"Aufnahme ausstehend"
"DOTA_RecentGame_Unavailable"	"Aufnahme nicht verfügbar"
"DOTA_RecentGame_MatchID"	"SPIEL-ID: #{s:match_id}"
"DOTA_No_Team_Name"	"--"
"DOTA_TrophyCount"	"{d:trophy_count} Trophäe"
"DOTA_TrophiesCount"	"{d:trophy_count} Trophäen"
"DOTA_TrophyCount_Number"	"{d:trophy_count}"
"DOTA_TrophyCount_NoNum"	"Trophäe"
"DOTA_TrophiesCount_NoNum"	"Trophäen"
"DOTA_TrophyName"	"{s:trophy_name}"
"DOTA_TrophyCategory"	"{s:trophy_category}"
"DOTA_TrophyDescription"	"{s:trophy_description}"
"DOTA_NextTrophy"	"Nächste Auszeichnung"
"DOTA_NewPlayerQuestion_Title"	"WILLKOMMEN BEI DOTA 2"
"DOTA_PlayerOriginQuestion_Question"	"Zur Verbesserung Ihres Spielerlebnisses, sagen Sie uns bitte, wie vertraut Sie mit Dota 2 und ähnlichen Spielen sind:"
"DOTA_PlayerOriginQuestion_BeginnerButton"	"Ich bin Anfänger."
"DOTA_PlayerOriginQuestion_RTSButton"	"Ich habe bereits RTS-Spiele gespielt."
"DOTA_PlayerOriginQuestion_MOBAButton"	"Ich habe bereits ein Spiel gespielt, das so ähnlich wie Dota 2 war."
"DOTA_PlayerOriginQuestion_Dota2Button"	"Ich habe bereits Dota 2 gespielt."
"DOTA_PlayerOriginQuestion_MOBAExplanation"	"Wählen Sie das Spiel, mit dem Sie am vertrautesten sind:"
"DOTA_OtherGames_LOL"	"League of Legends"
"DOTA_OtherGames_DOTA"	"DotA 1"
"DOTA_OtherGames_HON"	"Heroes of Newerth"
"DOTA_OtherGames_Smite"	"Smite"
"DOTA_OtherGames_Other"	"Anderes Spiel"
"DOTA_PlayerOriginQuestion_ConfirmationButton"	"LOS GEHT'S"
"DOTA_PlayerOriginQuestion_ConfirmationTutorial"	"Als Neuling in Dota könnten Sie vielleicht die Tutorials interessieren, welche Sie in der Trainingssektion unter dem Tab \"Spielen\" finden. Diese bilden den ersten Schritt, um später Spieler aus aller Welt zu dominieren."
"DOTA_PlayerOriginQuestion_ConfirmationSettings"	"Ihre Tastenbelegungen und Optionen sind jetzt auf die am meisten verwendeten Einstellungen für Spieler Ihrer Erfahrungsstufe festgelegt worden. Sie können diese jederzeit durch Klicken auf das Einstellungssymbol anpassen."
"DOTA_Tutorial_SkipButton"	"Tutorial überspringen"
"DOTA_ConfirmSkip"	"Dota 2-Einführung überspringen?"
"DOTA_ConfirmSkipDesc"	"Sind Sie sicher, dass Sie die Tutorials für Dota 2 überspringen möchten?"
"DOTA_Tutorial_Start_Quest"	"QUEST STARTEN"
"DOTA_Tutorial_Quest0_Title"	"QUEST 1"
"DOTA_Tutorial_Quest0_TitleDesc"	"FERNKAMPFHELD"
"DOTA_Tutorial_Quest0DetailsDesc"	"Diese Quest benötigt etwa\n10 Minuten zum Abschließen."
"DOTA_Tutorial_QuestDetailsLearn"	"Sie lernen:"
"DOTA_Tutorial_Quest0DetailsLesson"	"Helden bewegen\nHeldenlevel\nBenutzen von Fähigkeiten\nGegenstände\nGrundlagen des Kampfes\nLast Hits"
"DOTA_Tutorial_Quest1_Title"	"QUEST 2"
"DOTA_Tutorial_Quest1_TitleDesc"	"LANE-KAMPF"
"DOTA_Tutorial_Quest1DetailsDesc"	"Diese Quest benötigt etwa\n10 Minuten zum Abschließen."
"DOTA_Tutorial_Quest1DetailsLesson"	"Fernkampf\nFähigkeiten mit Wirkungsbereich\nDie Minikarte\nTürme\nKuriere und Ihr Lager\nTeleportation Scrolls"
"DOTA_Tutorial_Quest2_Title"	"QUEST 3"
"DOTA_Tutorial_Quest2_TitleDesc"	"LANE-KAMPF"
"DOTA_Tutorial_Quest2DetailsDesc"	"Diese Quest benötigt etwa\n10 - 15 Minuten zum Abschließen."
"DOTA_Tutorial_Quest2DetailsLesson"	"Lane-Kampf\nTürme verteidigen und angreifen\nAnfangsgegenstände"
"DOTA_Challenges_Title"	"Lernen"
"DOTA_ChallengeGroup_0_Title"	"Mechaniken"
"DOTA_ChallengeGroup_1_Desc"	"Hier starten!"
"DOTA_ChallengeGroup_More"	"Es folgt noch mehr"
"DOTA_ChallengeGroup_Locked"	"Gesperrt"
"DOTA_LearnMechanics_Title"	"Mechaniken"
"DOTA_Mechanics_0_Title"	"Mechaniken 1"
"DOTA_Mechanics_0_Desc"	"Helden bewegen\nHeldenlevel\nBenutzen von Fähigkeiten\nGegenstände\nGrundlagen des Kampfes\nLast Hits"
"DOTA_Mechanics_1_Title"	"Mechaniken 2"
"DOTA_Mechanics_1_Desc"	"Fernkampf\nFähigkeiten mit Wirkungsbereich\nDie Minikarte\nTürme\nKuriere und Ihr Lager\nTeleportation Scrolls"
"DOTA_GuidedBotMatches_0_Title"	"Luna"
"DOTA_GuidedBotMatches_0_Desc"	"Kurze Reichweite\nHoher Angriffsschaden\nSchnelle Fortbewegung\nModerat verletzbar\nNutzt Agilität-Attribut"
"DOTA_GuidedBotMatches_1_Title"	"Sven"
"DOTA_GuidedBotMatches_1_Desc"	"Nahkampf\nBurst-Angriffsschaden\nHohe Ausdauer\nVerwundbarkeit gegen Verlangsamungen\nNutzt Stärke-Attribut"
"DOTA_GuidedBotMatches_2_Title"	"Lina"
"DOTA_GuidedBotMatches_2_Desc"	"Hohe Reichweite\nBurst-Fähigkeitenschaden\nKurze Abklingzeiten\nSehr fragil\nNutzt Intelligenz-Attribut"
"DOTA_BotMatches_0_Title"	"Einfache Bots"
"DOTA_BotMatches_0_Desc"	"Lernen Sie einen neuen Held kennen."
"DOTA_BotMatches_1_Title"	"Mittlere Bots"
"DOTA_BotMatches_2_Title"	"Schwere Bots"
"DOTA_BotMatches_3_Title"	"Wahnsinnige Bots"
"FileOpenDialog_Open"	"Öffnen"
"FileOpenDialog_Save"	"Speichern"
"FileOpenDialog_Select"	"Auswählen"
"FileOpenDialog_FileType_Folder"	"Ordner"
"DOTA_FindMatch"	"Partie suchen"
"DOTA_FindMatchTime"	"{s:find_match_time}"
"DOTA_Searching"	"Suche läuft"
"DOTA_StartSoloBotMatch"	"Bot-Spiel starten"
"DOTA_Create_Lobby"	"Lobby erstellen"
"DOTA_Join_Lobby"	"Lobby beitreten"
"DOTA_LobbyStartGame"	"Spiel starten"
"DOTA_ReturnToLobby"	"Zurück zur Lobby"
"DOTA_FindMatchStatus"	"{s:searching_matchtype} / {s:searching_gamemodes} / {s:searching_region}"
"DOTA_FindGameModesMany"	"Spielmodi: "
"DOTA_FindRegionsMany"	"Regionen:"
"DOTA_GameMode_AllPick"	"All Pick"
"DOTA_GameMode_SingleDraft"	"Single Draft"
"DOTA_GameMode_CaptainsMode"	"Captains Mode"
"DOTA_GameMode_RandomDraft"	"Random Draft"
"DOTA_GameMode_AbilityDraft"	"Ability Draft"
"DOTA_GameMode_LeastPlayed"	"Least Played"
"DOTA_GameMode_AllRandom"	"All Random"
"DOTA_GameMode_LimitedHeroes"	"Limited Heroes"
"DOTA_GameMode_CaptainsDraft"	"Captains Draft"
"DOTA_GameMode_AllRandomDeathMatch"	"All Random Deathmatch"
"DOTA_ImmediatePurchase_SendFailed"	"Senden der Kaufanfrage fehlgeschlagen. Die Dota-Server sind möglicherweise offline. Bitte versuchen Sie es später erneut."
"DOTA_ImmediatePurchase_Timeout"	"Zeitüberschreitung der Kaufanfrage. Bitte versuchen Sie es später erneut."
"DOTA_ImmediatePurchase_InitFailed"	"Wir konnten mit Perfect World zu diesem Zeitpunkt keinen Kauf initiieren. Bitte versuchen Sie es später erneut."
"DOTA_ImmediatePurchase_InsufficientFundsPW"	"Ihr Perfect World-Account verfügt nicht über ausreichend Guthaben, um diesen Kauf abschließen zu können. Bitte laden Sie Ihr Guthaben auf und versuchen Sie es erneut."
"DOTA_ImmediatePurchase_Success_Title"	"Erfolg"
"DOTA_ImmediatePurchase_Success_Text"	"Kauf erfolgreich abgeschlossen! Ihre Gegenstände erscheinen in Kürze in Ihrem Arsenal."
"DOTA_ImmediatePurchase_Cancelled_Title"	"Abgebrochen"
"DOTA_ImmediatePurchase_UnbundleTimeout"	"Zeitüberschreitung bei der Anfrage zum Auspacken des Pakets. Bitte versuchen Sie es später erneut."
"DOTA_ConfirmPurchaseTitle"	"Kauf bestätigen"
"DOTA_ConfirmPurchaseText"	"Möchten Sie diesen Gegenstand kaufen?"
"DOTA_PurchaseInProgress_Title"	"Kauf in Bearbeitung"
"DOTA_PurchaseInProgress_Text"	"Ihre Kaufanfrage wird bearbeitet."
"DOTA_UnbundleInProgress_Title"	"Auspacken wird durchgeführt"
"DOTA_UnbundleInProgress_Text"	"Ihr Paket wurde ausgepackt."
"DOTA_ConfirmUnbundleTitle"	"Auspacken bestätigen"
"DOTA_ConfirmUnbundleText"	"Sie müssen das Paket auspacken, um die Gegenstände darin anzulegen. Fortfahren?"
"DOTA_PartnerPurchase_Purchase"	"{g:dota_item_price:item_def}"
"DOTA_PartnerPurchase_Recharge"	"Account aufladen"
"DOTA_PartnerPurchase_Balance"	"Guthaben: {m:balance}"
"DOTA_PartnerRecharge_Close"	"Zurück zum Kauf"
"StoreCheckout_Error_Title"	"Fehler"
"StoreCheckout_NoItems"	"Ihr Warenkorb ist leer!"
"StoreCheckout_TooManyItems"	"Sie haben zu viele Artikel in Ihrem Warenkorb!"
"StoreCheckout_Loading"	"Bezahlvorgang läuft..."
"StoreCheckout_Unavailable"	"Kasse momentan nicht verfügbar."
"StoreCheckout_Cancelling"	"Abbrechen..."
"StoreCheckout_Fail"	"Der Shop ist momentan geschlossen."
"StoreCheckout_InvalidParam"	"Programmierfehler! Es wurde ein ungültiger Parameter gesendet. Bitte versuchen Sie den Einkauf erneut durchzuführen."
"StoreCheckout_InternalError"	"Beim Initialisieren oder Aktualisieren Ihrer Transaktion ist ein Fehler aufgetreten. Bitte warten Sie eine Minute und versuchen Sie es dann erneut oder kontaktieren Sie den Support für Unterstützung."
"StoreCheckout_ContactSupport"	"Es ist ein Transaktionsfehler aufgetreten. Bitte kontaktieren Sie den Steam-Support für Unterstützung."
"StoreCheckout_NotApproved"	"Ihre Transaktion mit Steam konnte nicht bestätigt werden. Bitte versuchen Sie später den Einkauf erneut durchzuführen."
"StoreCheckout_NotLoggedin"	"Sie müssen in Steam angemeldet sein, um einen Kauf abschließen zu können."
"StoreCheckout_WrongCurrency"	"Die Währung dieser Transaktion stimmt nicht mit der Ihres Guthabens überein."
"StoreCheckout_NoAccount"	"Ihr Steam-Account ist momentan nicht verfügbar. Bitte versuchen Sie den Einkauf später erneut durchzuführen."
"StoreCheckout_InsufficientFunds"	"Sie haben nicht genug Guthaben, um den Kauf abzuschließen."
"StoreCheckout_TimedOut"	"Die Zeit für diese Transaktion ist abgelaufen. Bitte versuchen Sie erneut, den Einkauf durchzuführen."
"StoreCheckout_SteamAccountDisabled"	"Ihr Steam-Account ist deaktiviert und kann keinen Einkauf durchführen."
"StoreCheckout_SteamAccountNoPurchase"	"Transaktionen mit Steam-Guthaben wurden für diesen Account deaktiviert."
"StoreCheckout_OldPriceSheet"	"Ihre lokale Produktliste ist veraltet, eine neue wird abgerufen."
"StoreCheckout_TransactionNotFound"	"Die ID dieser Transaktion wurde nicht gefunden. Bitte versuchen Sie den Einkauf erneut durchzuführen."
"StoreCheckout_TransactionCancelled"	"Transaktion abgebrochen. Ihr Konto wurde nicht belastet."
"StoreCheckout_CompleteButUnfinalized"	"Der Erfolg der Transaktion konnte nicht bestätigt werden. Wenn die Transaktion erfolgreich war, erhalten Sie Ihre Artikel zu einem späteren Zeitpunkt."
"StoreCheckout_NotEnoughRoom"	"Sie haben nicht genug Platz in Ihrem Arsenal, um so viele Gegenstände zu kaufen."
"StoreCheckout_ContactSupport_Dialog_Title"	"Warnung"
"StoreCheckout_ContactSupport_Dialog_Btn"	"Kontakt"
"StoreCheckout_LimitedQuantityItemsUnavailable"	"Einer der Artikel, die Sie versuchen zu erwerben, ist zwischenzeitlich nicht mehr vorrätig oder derzeit nicht verfügbar."
"StoreCheckout_Nexon_InsufficientFunds"	"Sie haben nicht genug Guthaben, um den Kauf abzuschließen."
"StoreCheckout_Nexon_FundsLocked"	"Nexon Cash-Sperre ist aktiviert."
"DOTA_AbilityTooltip_Name"	"{s:name}"
"DOTA_AbilityTooltip_Level"	"Level {s:level}"
"DOTA_AbilityTooltip_TargetType"	"BETRIFFT: {s:targettype}"
"DOTA_AbilityTooltip_CastType"	"FÄHIGKEIT: {s:casttype}"
"DOTA_AbilityTooltip_DamageType"	"SCHADENSTYP: {s:damagetype}"
"DOTA_AbilityTooltip_SpellImmunityType"	"ZAUBERIMMUNITÄT: {s:spellimmunity}"
"DOTA_AbilityTooltip_Description"	"{s:description}"
"DOTA_AbilityTooltip_ScepterDescription"	"{s:scepterdescription}"
"DOTA_AbilityTooltip_ExtraDescription"	"{s:extradescription}"
"DOTA_AbilityTooltip_Attributes"	"{s:attributes}"
"DOTA_AbilityTooltip_Cooldown"	"{s:cooldown}"
"DOTA_AbilityTooltip_ManaCost"	"{s:manacost}"
"DOTA_AbilityTooltip_Lore"	"{s:lore}"
"DOTA_AbilityTooltip_UpgradeLevel"	"Nächstes Upgrade bei Heldenlevel {d:upgradelevel}"
"DOTA_AbilityTooltip_BuildHeader"	"Fähigkeitenhandbuch"
"DOTA_AbilityTooltip_BuildComment"	"{s:buildcomment}"
"DOTA_PersonaTooltip_Title"	"{g:dota_persona:account_id}"
"DOTA_PersonaTooltip_TitlePro"	"{g:dota_persona_pro:account_id}"
"DOTA_PendingInvites"	"Gruppeneinladungen"
"DOTA_PendingInvitesTooltip_None"	"Keine ausstehenden Einladungen"
"DOTA_PendingInvitesTooltip_1"	"1 ausstehende Einladung"
"DOTA_PendingInvitesTooltip_N"	"{d:pending_invite_count} ausstehende Einladungen"
"DOTA_PendingInvitesTooltip_Leader"	"Klicken, um Einladungen zu verwalten."
"DOTA_PendingInvitesTooltip_NonLeader"	"Klicken, um Einladungen anzuzeigen."
"DOTA_PendingInvitesCancelAll"	"Alle Einladungen abbrechen"
"DOTA_PendingInvitesNotPartyLeader"	"Nur der Gruppenleiter kann Einladungen verwalten."
"DOTA_ChatTab_NotInChannelMessage"	"Niemand hört Sie."
"DOTA_ChatTab_ToggleGlobal"	"Nachrichten aus diesem Kanal in allen Tabs anzeigen."
"DOTA_ChatTab_Close"	"Diesen Tab schließen."
"DOTA_ChatTab_Leave"	"Diesen Kanal verlassen."
"DOTA_JoinChatChannel_Title"	"Kanal beitreten"
"DOTA_JoinChatChannel_Description"	"Kanal erstellen oder beitreten."
"DOTA_JoinChatChannel_AddToCurrentTab"	"Zum aktuellen Tab \"{s:current_tab_name}\" hinzufügen"
"DOTA_Chat_ChannelName"	"{s:channel_name}"
"DOTA_Chat_ChannelMemberCount_Singular"	"1 Mitglied"
"DOTA_Chat_ChannelMemberCount_Plural"	"{d:channel_member_count} Mitglieder"
"DOTA_EditChatTab_Description"	"Wählen Sie aus, welche Nachrichten in diesem Tab angezeigt werden sollen."
"DOTA_EditChatTab_AddNewChannel"	"Einen neuen Kanal hinzufügen..."
"DOTA_EditChatTab_TabName"	"Name des Tabs:"
"DOTA_EditChatTab_ChannelToggleDisabled"	"{s:target} muss immer in mindestens einem Tab sein."
"DOTA_EditChatTab_Target"	"{s:target}"
"DOTA_Chat_TimestampFormat"	"{t:t:timestamp}"
"DOTA_Chat_Autocomplete_Title"	"{s:autocomplete_title}"
"DOTA_Chat_Autocomplete_NoMatches"	"Keine Spiele"
"DOTA_Chat_Autocomplete_WhisperFriends"	"Freund anflüstern"
"DOTA_Chat_Autocomplete_InviteFriends"	"Freund einladen"
"DOTA_Chat_Autocomplete_Channels"	"Kanäle"
"DOTA_Chat_Autocomplete_Commands"	"Befehle"
"DOTA_Chat_Autocomplete_CommandName"	"/{s:command_name}"
"DOTA_Chat_Autocomplete_CommandDescription"	"{s:command_description}"
"dota_suggest_invite_format"	"Bitte {s:invite_persona} zur Gruppe einladen."
"dota_suggest_invite_format_leader"	"Bitte {s:invite_persona} zur Gruppe einladen. ( <a href=\"event:DOTAInviteToParty({s:invite_persona_steamid})\" class=\"InviteButton\">Einladung senden</a> )"
"dota_suggest_invite_format_lobby"	"Bitte {s:invite_persona} zur Lobby einladen."
"DOTA_ChatTarget_Format_Default"	"{s:target}"
"DOTA_ChatTarget_Prompt_Default"	"An ({s:target}):"
"DOTA_ChatTarget_Format_Whisper"	"{s:persona}"
"DOTA_ChatTarget_Prompt_Whisper"	"An [{s:persona}]:"
"DOTA_ChatTarget_Party"	"Gruppe"
"DOTA_ChatTarget_Lobby"	"Lobby"
"DOTA_ChatTarget_Team"	"Team"
"DOTA_ChatTarget_Guild"	"Gilde"
"DOTA_ChatTarget_Fantasy"	"Fantasie"
"DOTA_ChatTarget_Console"	"Konsole"
"DOTA_ChatTarget_Whisper"	"Flüstern"
"DOTA_ChatTarget_Invalid"	"Kein Kanal"
"DOTA_ChatTarget_GameAll"	"Alle"
"DOTA_ChatTarget_GameAllies"	"Verbündete"
"DOTA_ChatTarget_GameCoaching"	"Mentoren"
"DOTA_ChatTarget_GameSpectator"	"Zuschauer"
"DOTA_ChatTargetMenu_Title"	"{s:target}"
"DOTA_ChatTargetMenu_ToggleEnabled"	"{s:toggle_enabled}"
"DOTA_ChatTargetMenu_NotActive"	"(Nicht aktiv)"
"DOTA_Chat_MissedMessages"	"{s:missed_message_count}"
"DOTA_ChatCommand_Party"	"p"
"DOTA_ChatCommand_Party_Name"	"Gruppe"
"DOTA_ChatCommand_Party_Description"	"Mit Ihrer aktuellen Gruppe chatten."
"DOTA_ChatCommand_Lobby"	"l"
"DOTA_ChatCommand_Lobby_Name"	"Lobby"
"DOTA_ChatCommand_Lobby_Description"	"Mit Ihrer aktuellen Lobby chatten."
"DOTA_ChatCommand_Channel"	"c"
"DOTA_ChatCommand_Channel_Name"	"Kanal"
"DOTA_ChatCommand_Whisper"	"w"
"DOTA_ChatCommand_Whisper_Name"	"Flüstern"
"DOTA_ChatCommand_Reply"	"r"
"DOTA_ChatCommand_Reply_Name"	"Antwort"
"DOTA_ChatCommand_Help"	"?"
"DOTA_ChatCommand_Help_Name"	"Hilfe"
"DOTA_ChatCommand_Help_Description"	"Hilfe für Chatbefehle anzeigen."
"DOTA_ChatCommand_InviteToParty"	"partyinvite"
"DOTA_ChatCommand_InviteToParty_Name"	"Zur Gruppe einladen"
"DOTA_ChatCommand_LeaveParty"	"leaveparty"
"DOTA_ChatCommand_LeaveParty_Name"	"Gruppe verlassen"
"DOTA_ChatCommand_JoinChannel"	"joinchannel"
"DOTA_ChatCommand_JoinChannel_Name"	"Kanal beitreten"
"DOTA_ChatCommand_LeaveChannel"	"leavechannel"
"DOTA_ChatCommand_LeaveChannel_Name"	"Kanal verlassen"
"DOTA_ChatCommand_GameAll"	"all"
"DOTA_ChatCommand_GameAll_Name"	"Alle"
"DOTA_ChatCommand_GameAllies"	"allies"
"DOTA_ChatCommand_GameAllies_Name"	"Verbündete"
"DOTA_ChatCommand_GameCoaching"	"coach"
"DOTA_ChatCommand_GameSpectator"	"spectator"
"DOTA_ChatCommand_GameSpectator_Name"	"Zuschauer"
"DOTA_ChatCommand_Clear"	"clear"
"DOTA_ChatCommand_Clear_Name"	"Löschen"
"DOTA_ChatCommand_Clear_Description"	"Alle sichtbaren Chatnachrichten in diesem Tab löschen."
"DOTA_Chat_UnknownCommandMessage"	"Unbekannter Chatbefehl \"{s:chat_command}\""
"DOTA_ChatHelp_Targets"	"Ziele"
"DOTA_ChatHelp_Commands"	"Befehle"
"DOTA_ChatHelp_NameFormat"	"{s:command_name}:"
"DOTA_ChatHelp_CommandFormat"	"/{s:command}"
"DOTA_Chat_JoinedParty"	"Ist einer Gruppe beigetreten: {s:party_members}"
"DOTA_Chat_LeftParty"	"Gruppe aufgelöst."
"DOTA_Chat_MemberJoinedParty"	"Spieler ist der Gruppe beigetreten: {s:party_members}"
"DOTA_Chat_MemberLeftParty"	"Spieler hat die Gruppe verlassen: {s:party_members}"
"DOTA_Chat_InvitedToJoinParty"	"Eingeladen: {s:party_members}"
"DOTA_Chat_RequestedToJoinParty"	"Beitritt angefordert: {s:party_members}"
"DOTA_Chat_PartyMemberSeparator"	", "
"DOTA_Feature_Under_Construction_Title"	"In Entwicklung"
"DOTA_Feature_Under_Construction_Text"	"Dieses Feature wird noch entwickelt und ist nicht verfügbar."
"DOTA_PartyJoinRequest_Title"	"Gruppe beitreten"
"DOTA_PartyJoinRequest_Description"	"{g:dota_persona:b:inviter} möchte Ihrer Gruppe beitreten."
"DOTA_PartyMergeRequest_Description"	"{g:dota_persona:b:inviter} möchte seine Gruppe mit Ihrer Gruppe zusammenlegen."
"DOTA_PartyInvite_Title"	"Gruppeneinladung"
"DOTA_Invite_IOfN"	"{d:received_invite_index} von {d:received_invite_count}"
"DOTA_PartyInvite_Description"	"{g:dota_persona:b:inviter} hat Sie in eine Gruppe eingeladen."
"DOTA_PartyInvite_LowPriority_Title"	"Gruppeneinladung mit geringerer Priorität"
"DOTA_PartyInvite_LowPriority_Description"	"{g:dota_persona:b:inviter} hat Sie zu einer Gruppe mit niedriger Priorität eingeladen."
"DOTA_LobbyInvite_BlockInviter"	"Jegliche Kommunikation von diesem Spieler blockieren"
"DOTA_PartyInvite_BlockNonFriendInvites"	"Einladungen von Spielern, die nicht in der Freundesliste sind, blockieren"
"DOTA_PartyInvite_Expired"	"Die Anfrage wurde zurückgezogen oder ist nicht mehr gültig."
"DOTA_PartyInvite_Coach"	"Mentor:"
"DOTA_PartyVisTooltip_TitleOpen"	"Suche nach Gruppenmitgliedern"
"DOTA_PartyVisTooltip_TitleNotOpen"	"Nicht auf der Suche nach Gruppenmitgliedern"
"DOTA_PartyVisTooltip_SoloNotOpen"	"Klicken, um Ihren Status zu ändern."
"DOTA_PartyVisTooltip_SoloOpen"	"Freunde können Ihnen Beitrittsanfragen senden.<br/>Klicken Sie hier, um Ihren Status zu ändern."
"DOTA_PartyVisTooltip_LeaderOpen"	"Beitrittsanfragen von Freunden werden automatisch angenommen.<br/>Klicken Sie hier, um den Status der offenen Gruppe zu deaktivieren."
"DOTA_PartyVisTooltip_LeaderOpenManualAccept"	"Freunde von Gruppenmitgliedern können Beitrittsanfragen senden.<br/>Klicken Sie hier, um den Status der offenen Gruppe zu deaktivieren."
"DOTA_PartyVisTooltip_NonLeaderOpen"	"Beitrittsanfragen von Freunden.<br/>Klicken Sie hier, um den Status der offenen Gruppe zu deaktivieren."
"DOTA_TogglePartyOpenMic_Tooltip"	"Offenes Mikro in Gruppe umschalten"
"DOTA_PartySettings"	"Gruppeneinstellungen"
"DOTA_PartySettings_OpenParty"	"Beitrittsanfragen erlauben"
"DOTA_PartySettings_BroadcastToFriends"	"Meinen Freunden anzeigen, wenn ich in einer Gruppe bin"
"DOTA_LobbyInvite_Title"	"Lobbyeinladung"
"DOTA_LobbyInvite_Description"	"{g:dota_persona:inviter} hat Sie in eine Lobby eingeladen."
"DOTA_PartyJoinedLobby_Title"	"Lobby beigetreten"
"DOTA_PartyJoinedLobby_Generic"	"{s:party_leader} hat Sie in eine Lobby verschoben."
"DOTA_PartyJoinedLobby_Custom"	"{s:party_leader} hat Sie in eine {s:custom_game}-Lobby verschoben."
"DOTA_PartyLeader"	"Gruppenleiter"
"DOTA_LobbyKicked_Header"	"Aus der Lobby entfernt"
"DOTA_LobbyKicked_Message"	"Sie wurden vom Lobbyleiter aus der Lobby entfernt."
"DOTA_PlayerContextMenu_ViewProfile"	"Profil anzeigen"
"DOTA_PlayerContextMenu_ChatWithPlayer"	"Nachricht senden"
"DOTA_PlayerContextMenu_InviteToParty"	"Zur Gruppe einladen"
"DOTA_PlayerContextMenu_SuggestInviteToParty"	"Einladung zur Gruppe vorschlagen"
"DOTA_PlayerContextMenu_KickFromParty"	"Aus Gruppe entfernen"
"DOTA_PlayerContextMenu_LeaveParty"	"Gruppe verlassen"
"DOTA_PlayerContextMenu_CoachParty"	"Diese Gruppe trainieren"
"DOTA_PlayerContextMenu_StopCoachingParty"	"Trainieren der Gruppe beenden"
"DOTA_PlayerContextMenu_AddFriend"	"Freund hinzufügen"
"DOTA_PlayerContextMenu_RemoveFriend"	"Freund entfernen"
"DOTA_PlayerContextMenu_AcceptFriendRequest"	"Freundschaftsanfrage annehmen"
"DOTA_PlayerContextMenu_IgnoreFriendRequest"	"Freundschaftsanfrage ignorieren"
"DOTA_PlayerContextMenu_Spectate"	"Spiel zuschauen"
"DOTA_PlayerContextMenu_InviteToLobby"	"In Lobby einladen"
"DOTA_PlayerContextMenu_SuggestInviteToLobby"	"Einladung zur Lobby vorschlagen"
"DOTA_PlayerContextMenu_KickFromLobby"	"Aus Lobby entfernen"
"DOTA_FeaturedHero_ViewGrid"	"Rasteransicht"
"DOTA_FeaturedHero_HeroName"	"{s:hero_name}"
"DOTA_FeaturedHero_ItemName"	"{g:dota_item_name:item_def}"
"DOTA_FeaturedHeroReason_NewHero"	"Kürzlich veröffentlichter Held"
"DOTA_FeaturedHeroReason_FeaturedItem"	"Ausgestellter Gegenstand"
"DOTA_FeaturedHeroReason_PopularItem"	"Topseller"
"DOTA_FeaturedHeroReason_SaleItem"	"Jetzt im Angebot"
"DOTA_HeroSelectorCategory_Default"	"Alle Helden"
"DOTA_HeroSelectorCategory_NewItems"	"Neue Gegenstände"
"DOTA_HeroSelectorCategory_Favorites"	"Favoriten"
"DOTA_HeroSelectorCategory_MostPlayed"	"Am häufigsten gespielt"
"DOTA_HeroSelectorCategory_LeastPlayed"	"Am wenigsten gespielt"
"DOTA_HeroSelectorCategory_HaveItems"	"Ich besitze Gegenstände für"
"DOTA_HeroSelectorCategory_PrimaryAttribute_Strength"	"Stärke"
"DOTA_HeroSelectorCategory_PrimaryAttribute_Agility"	"Agilität"
"DOTA_HeroSelectorCategory_PrimaryAttribute_Intelligence"	"Intelligenz"
"DOTA_HeroSelectorCategory_AttackRange_Melee"	"Nahkampf"
"DOTA_HeroSelectorCategory_AttackRange_Ranged"	"Fernkampf"
"DOTA_HeroSelector_SelectHero_Label"	"Wählen"
"DOTA_HeroSelector_ClearFilters"	"Filter zurücksetzen"
"DOTA_OwnedItemSet_Selector_Title"	"Im Besitz"
"DOTA_EquippedItemSet_Selector_Title"	"Ausgerüstet"
"DOTA_OwnedItemSet_Available_Title"	"Verfügbar"
"DOTA_FeaturedItemSet_Selector_Title"	"Angesagt"
"DOTA_AllItemSet_Selector_Title"	"Alle"
"DOTA_ConfirmLANLobby_title"	"LOKALE LOBBY"
"DOTA_ConfirmLANLobby_desc"	"Ein lokales Spiel wird auf Ihrem Computer gehostet. Die Systemanforderungen sind dabei höher als normal."
"DOTA_ConfirmLANLobbyDisconnect_title"	"Lokale Lobby verlassen?"
"DOTA_ConfirmLANLobbyDisconnect_desc"	"Dieses Lobbyspiel wird auf Ihrem Computer gehostet. Wenn Sie die Verbindung trennen, wird das Spiel für alle Spieler beendet. Fortfahren?"
"DOTA_ConfirmLANLobbyDisconnect_ok"	"Ja, Verbindung trennen"
"DOTA_Lobby_Settings_General"	"ALLGEMEINE LOBBYEINSTELLUNGEN"
"DOTA_Lobby_Settings_Required"	"ERFORDERLICH"
"DOTA_Lobby_Settings_Confirm"	"{s:lobby_confirm_label}"
"DOTA_Lobby_Settings_Game_Mode"	"SPIELMODUS"
"DOTA_Lobby_Settings_Region"	"SERVERSTANDORT"
"DOTA_Lobby_Settings_Password"	"LOBBYPASSWORT"
"DOTA_Lobby_Settings_Game_Name"	"SPIELNAME"
"DOTA_Lobby_Settings_Advanced"	"ERWEITERTE LOBBYEINSTELLUNGEN"
"DOTA_Lobby_Settings_Competitive"	"WETTKAMPF"
"DOTA_Lobby_Settings_Starting_Team"	"STARTTEAM"
"DOTA_Lobby_Settings_Starting_Team_Random"	"ZUFÄLLIG"
"DOTA_Lobby_Settings_Starting_Team_Radiant"	"RADIANT"
"DOTA_Lobby_Settings_Starting_Team_Dire"	"DIRE"
"DOTA_Lobby_Settings_Series_Best_of_3"	"BEST-OF-3"
"DOTA_Lobby_Settings_Series_Best_of_5"	"BEST-OF-5"
"DOTA_Lobby_Settings_Gameplay_Rules"	"SPIELREGELN"
"DOTA_Lobby_Settings_Enable_Cheats"	"CHEATS AKTIVIEREN"
"DOTA_Lobby_Settings_All_Chat"	"CHAT (ALLE)"
"DOTA_Lobby_Settings_Fill_Bots"	"LEERE SLOTS MIT BOTS AUFFÜLLEN"
"DOTA_Lobby_Settings_Bot_Difficulty_Passive"	"PASSIV"
"DOTA_Lobby_Settings_Bot_Difficulty_Easy"	"EINFACH"
"DOTA_Lobby_Settings_Bot_Difficulty_Medium"	"MITTEL"
"DOTA_Lobby_Settings_Bot_Difficulty_Hard"	"SCHWER"
"DOTA_Lobby_Settings_Bot_Difficulty_Unfair"	"UNFAIR"
"DOTA_Lobby_Settings_Version"	"VERSION"
"DOTA_Lobby_Settings_Version_Latest"	"AKTUELLSTE"
"DOTA_Lobby_Settings_Version_Tournament"	"TURNIER"
"DOTA_Lobby_Settings_Spectator_Section"	"ZUSCHAUER"
"DOTA_Lobby_Settings_Dota_TV_Delay"	"DOTA TV-VERZÖGERUNG"
"DOTA_Lobby_Settings_Dota_TV_Delay_2_Minutes"	"2 Minuten"
"DOTA_Lobby_Settings_Dota_TV_Delay_5_Minutes"	"5 Minuten"
"DOTA_Lobby_Settings_Dota_TV_Delay_10_Seconds"	"10 Sekunden"
"DOTA_Lobby_Settings_Spectators"	"ZUSCHAUER"
"DOTA_Lobby_Settings_Spectators_Enabled"	"AKTIVIERT"
"DOTA_Lobby_Settings_Spectators_Disabled"	"DEAKTIVIERT"
"dota_lobby_settings_hide_password"	"Passwort verbergen"
"dota_lobby_settings_local_host"	"Lokaler Host"
"DOTA_Lobby_Settings_Visibility"	"Lobbysichtbarkeit"
"DOTA_Lobby_Settings_Visibility_Public"	"Öffentlich"
"DOTA_Lobby_Settings_Visibility_Friends"	"Freunde"
"DOTA_Lobby_Settings_Visibility_Unlisted"	"Nicht gelistet"
"DOTA_Lobby_Settings_Visibility_Tooltip"	"Bestimmt, wo die Lobby sichtbar ist. Öffentliche Lobbys sind in der Lobbyliste sowie der Freundesliste sichtbar. Freundeslobbys sind nur für Freunde sichtbar, andere Spieler können trotzdem eingeladen werden. Nicht gelistete Lobbys sind weder in der Lobbyliste noch der Freundesliste sichtbar."
"DOTA_TeamUnsetHeader"	"Kein Team gewählt"
"DOTA_TeamUnsetMessage"	"Mindestens ein Team verfügt über keinen Namen/Logo. Die Partie wirklich starten?"
"DOTA_LeagueUnsetHeader"	"Keine Liga ausgewählt"
"DOTA_LeagueUnsetMessage"	"Für diese Lobby wurde keine Liga festgelegt, obwohl Sie eine festlegen können. Die Partie wirklich starten?"
"DOTA_LobbyAllowSpectatingHeader"	"Lobbyspiel kann nicht gestartet werden"
"DOTA_LobbyAllowSpectatingMessage"	"Das Spiel muss sichtbar gemacht werden, solange sich Zuschauer in der Lobby befinden. Aktivieren Sie die Zuschauen-Funktion im Einstellungsfenster."
"dota_radiant"	"Die Radiant"
"dota_dire"	"Die Dire"
"dota_lobby_team_name_radiant"	"{s:team_name_good_guys}"
"dota_lobby_team_name_dire"	"{s:team_name_bad_guys}"
"dota_lobby_no_team"	"Kein Team"
"dota_lobby_broadcast_default_channel_name"	"Kanalname"
"dota_lobby_broadcast_join"	"Beitreten"
"dota_lobby_broadcast_leave"	"Verlassen"
"dota_lobby_broadcast_create"	"Neuen Kanal erstellen"
"dota_lobby_broadcast_no_channels"	"Es wurden keine Übertragungskanäle erstellt"
"dota_popup_broadcast_channel_edit_title"	"Übertragungskanal anpassen"
"dota_lobby_broadcast_default_channel_name_custom"	"{s:custom_title}"
"dota_popup_broadcast_channel_edit_channel_name"	"Kanaltitel"
"dota_popup_broadcast_channel_edit_country"	"Land"
"dota_popup_broadcast_channel_edit_language"	"Sprache"
"dota_popup_broadcast_channel_edit_save"	"Als Standardeinstellungen speichern und beim Beitreten auf leere Kanäle anwenden"
"DOTA_Lobby_Broadcaster_Channel_Other_Language"	"Andere Sprache"
"lobby_slot_error_header"	"Slot wechseln nicht möglich"
"generic_gc_timeout"	"Zeitüberschreitung beim Senden der Nachricht."
"lobby_slot_success_header"	"Erfolgreich"
"lobby_slot_denied"	"Sie haben keine Berechtigung, diesen Slot einzunehmen."
"lobby_slot_cameramanalready"	"Übertragungskanäle können nur einen Kameramann haben"
"lobby_slot_cameramanon"	"Sie sind nun ein Kameramann"
"lobby_slot_cameramanoff"	"Sie sind kein Kameramann mehr"
"lobby_slot_error"	"Lobbyplatz konnte nicht gewechselt werden."
"lobby_create_timeout"	"Erstellen der Lobby fehlgeschlagen."
"DOTA_DialogVariableTest1"	"Einfach: {s:var}"
"DOTA_DialogVariableTest2"	"Geldwert: {m:money}"
"DOTA_DialogVariableTest3"	"Link zum Gegenstand: {g:dota_item_link:item_def}"
"DOTA_DialogVariableTest4"	"Preis des Gegenstands: {g:dota_item_price:item_def}"
"DOTA_DialogVariableTest6"	"Einfach mit Abstand: <span class=\"TextSpan\">{s:var}</span>"
"LobbySetting_GameMode"	"Spielmodus"
"LobbySetting_GameMode_Value"	"{s:lobbysetting_gamemode}"
"LobbySetting_Bots"	"Bots"
"LobbySetting_Bots_Value"	"{s:lobbysetting_bots}"
"LobbySetting_Password"	"Passwort"
"LobbySetting_Password_Value"	"{s:lobbysetting_password}"
"LobbySetting_Server"	"Server"
"LobbySetting_Server_Value"	"{s:lobbysetting_server}"
"LobbySetting_Cheats"	"Cheats"
"LobbySetting_Cheats_Value"	"{s:lobbysetting_cheats}"
"LobbySetting_Spectators"	"Zuschauer"
"LobbySetting_Spectators_Value"	"{s:lobbysetting_spectators}"
"LobbySetting_Visibility"	"Sichtbarkeit"
"LobbySetting_Visibility_Value"	"{s:lobbysetting_visibility}"
"dota_lobby_lan_title"	"Lokaler Server"
"dota_lobby_coaches_none"	"Mentoren: Keine"
"dota_lobby_coaches"	"Mentoren:"
"DOTA_Custom_Game"	"Angepasstes Spiel"
"DOTA_Custom_Game_Info"	"Info"
"DOTA_Custom_Game_View_Details"	"Spieldetails anzeigen"
"DOTA_Custom_Game_Author"	"von {g:dota_persona:author}"
"DOTA_Custom_Game_Lobby_Count"	"{d:lobby_count} Lobby"
"DOTA_Custom_Game_Lobby_Count_Plural"	"{d:lobby_count} Lobbys"
"DOTA_Custom_Game_View_Lobbies"	"Lobbys anzeigen"
"DOTA_Custom_Game_Find_Lobby"	"Lobby suchen"
"DOTA_Custom_Game_Create_Lobby"	"Lobby erstellen"
"DOTA_Custom_Game_Game_Page"	"Spielseite"
"DOTA_Custom_Game_Download_Queued"	"Download in Warteschlange"
"DOTA_Custom_Game_Downloading"	"Download läuft..."
"DOTA_Custom_Game_Downloading_Percent"	"Download läuft - {d:lobby_download_percent} %"
"DOTA_Custom_Game_Needs_Update"	"Update erforderlich"
"DOTA_Custom_Game_Play"	"{s:game_mode_name} spielen"
"DOTA_Custom_Game_Uninstall"	"Deinstallieren"
"DOTA_Custom_Game_Install"	"Installieren"
"DOTA_Custom_Game_Installed"	"Installiert"
"DOTA_Custom_Game_Not_Installed"	"Nicht installiert"
"DOTA_Custom_Game_Connect"	"Lobby beitreten"
"DOTA_Custom_Game_FileSize"	"{d:file_size} MB"
"DOTA_Custom_Game_Name"	"{s:game_mode_name}"
"DOTA_Custom_Game_Released_By"	"Veröffentlicht am {s:release_date}</b> von <b>{g:dota_persona:author}</b>"
"DOTA_Custom_Game_Subscription"	"{s:subscriptions_count} Abonnent"
"DOTA_Custom_Game_Subscriptions"	"{s:subscriptions_count} Abonnenten"
"DOTA_Custom_Game_Rating"	"Bewertung"
"DOTA_Custom_Game_Release_Date"	"Veröffentlichungsdatum"
"DOTA_Custom_Game_Playing_Now"	"{s:player_count} spielen gerade"
"DOTA_Custom_Game_Ratings_Count"	"({d:ratings_count})"
"DOTA_Custom_Game_Description"	"{s:game_description}"
"DOTA_Custom_Game_Last_Updated"	"Zuletzt aktualisiert am {s:last_updated_date}"
"DOTA_Custom_Game_Update_Note_Title"	"{s:timestamp}"
"DOTA_Custom_Game_Screenshots"	"Screenshots"
"DOTA_Custom_Game_Map_Label"	"Karte"
"DOTA_Custom_Game_Map_Any"	"Beliebig"
"DOTA_Custom_Game_Spectate"	"Zuschauen"
"DOTA_Custom_Game_Already_In_Lobby"	"Beenden Sie Ihr derzeitiges Spiel, um diesen Spielmodus zu starten."
"DOTA_Custom_Game_Friends_Playing"	"Freunde in angepassten Spielen"
"DOTA_Custom_Game_Friends_In_Lobbies"	"{d:friends_in_open_lobbies} in offenen Lobbys"
"DOTA_Custom_Game_Friends_In_Game"	"{d:friends_in_game} Freunde in angepassten Spielen"
"DOTA_Custom_Games_Friends_Play"	"Angepasste Spiele Ihrer Freunde"
"DOTA_Custom_Game_Invite_Friend"	"Freund einladen"
"DOTA_Custom_Game_Tooltip_Subscribers"	"{d:subscriber_count} Abonnenten"
"DOTA_Custom_Game_Tooltip_Subscriber"	"{d:subscriber_count} Abonnent"
"DOTA_Custom_Game_Most_Popular"	"Beliebteste"
"DOTA_Custom_Game_Installed_Games"	"Installierte Spiele"
"DOTA_Custom_Game_Favorite_Games"	"Nur Favoriten anzeigen"
"DOTA_Custom_Game_Add_Favorite"	"Favorit"
"DOTA_Custom_Game_VotePrompt"	"Sollten wir mehr Leuten dieses Spiel zeigen?"
"DOTA_Custom_Game_Vote_Box_Title"	"Workshop-Abstimmung"
"DOTA_Custom_Game_Vote_Start"	"Wahl starten"
"DOTA_Custom_Game_VoteThanks"	"Danke für Ihre Stimme!"
"DOTA_Custom_Game_Vote_PrevLabel"	"Voriges Spiel"
"DOTA_Custom_Game_Vote_NextLabel"	"Nächstes Spiel"
"DOTA_Custom_Game_Vote_YesLabel"	"Ja, ist super!"
"DOTA_Custom_Game_Vote_NoLabel"	"Nö, sollte noch verbessert werden."
"DOTA_Custom_Game_Vote_Up"	"Gutes Spiel"
"DOTA_Custom_Game_Vote_Down"	"Überarbeitung notwendig"
"DOTA_Custom_Game_Leave_Lobby"	"Diese Lobby verlassen"
"DOTA_Custom_Game_Suggested_Title"	"Vorgeschlagene Spiele"
"DOTA_Custom_Lobby_Settings_Title"	"Lobby erstellen"
"DOTA_Custom_Lobby_Settings_Mode"	"Spielmodus"
"DOTA_Custom_Lobby_Settings_Map"	"Karte"
"DOTA_Custom_Lobby_LobbyName"	"Optionale Beschreibung"
"DOTA_Custom_Lobby_Public"	"Öffentlich"
"DOTA_Custom_Lobby_Join_Failed_Title"	"Beitreten fehlgeschlagen"
"DOTA_Custom_Lobby_Join_Failed_Reason"	"{s:join_error}"
"DOTA_Custom_Lobby_Join_Failed_Prompt"	"Möchten Sie jetzt nach einer offenen \"{s:game_name}\"-Lobby suchen?"
"DOTA_Custom_Lobby_Create_Private_Button"	"Private Lobby erstellen"
"DOTA_Custom_Lobby_Find_Private_Button"	"Private Lobby suchen"
"DOTA_Custom_Lobby_Find_Private_Title"	"Private Lobby suchen"
"DOTA_Custom_Lobby_List_Game_Header"	"Spiel"
"DOTA_Custom_Lobby_List_Name_Header"	"Beschreibung"
"DOTA_Custom_Lobby_List_Players_Header"	"Spieler"
"DOTA_Custom_Lobby_List_Map_Header"	"Karte"
"DOTA_Custom_Lobby_List_Region_Header"	"Region"
"DOTA_Custom_Lobby_List_Connection_Header"	"Verbindung"
"DOTA_Custom_Lobby_List_Status_Header"	"Lokaler Status"
"DOTA_Custom_Lobby_List_Game"	"{s:lobby_game}"
"DOTA_Custom_Lobby_List_Lobby_Name"	"{s:lobby_name}"
"DOTA_Custom_Lobby_List_Players"	"{s:lobby_players} / {s:lobby_max_players}"
"DOTA_Custom_Lobby_List_Map"	"{s:lobby_map}"
"DOTA_Custom_Lobby_List_Region"	"{s:lobby_region}"
"DOTA_Custom_Lobby_List_Connection"	"..."
"DOTA_Custom_Lobby_List_Status"	"{s:lobby_status}"
"DOTA_Custom_Lobby_List_Connect"	"{s:connect_button_text}"
"DOTA_Custom_Lobby_Game_Name"	"{s:game_name}"
"DOTA_Custom_Lobby_Map_Name"	"Karte: {s:map_name}"
"DOTA_Custom_Lobby_Player_Count"	"Spieler: {d:player_count} / {d:max_player_count}"
"DOTA_Custom_Lobby_Player_Count_Short"	"{d:player_count} / {d:max_player_count}"
"DOTA_Custom_Lobby_Visibility"	"Lobbysichtbarkeit"
"DOTA_Custom_Join_Chat"	"Chat beitreten"
"DOTA_Custom_Join_Chat_Member_Count"	"({d:ChatMemberCount})"
"DOTA_Custom_Leave_Chat"	"Chat verlassen"
"DOTA_Page_Number"	"Seite: {d:current_page} / {d:num_pages}"
"DOTA_TabName_ModsOverview"	"Übersicht"
"DOTA_TabName_ModsSubscribed"	"Bibliothek"
"DOTA_TabName_ModsWorkshop"	"Workshop"
"DOTA_TabName_ModsBrowse"	"Durchsuchen"
"DOTA_WatchTabName_Live"	"Live"
"DOTA_WatchTabName_Featured"	"Angesagt"
"DOTA_WatchTabName_Replays"	"Aufnahmen"
"DOTA_WatchTabName_Tournaments"	"Turniere"
"DOTA_WatchTabName_Downloads"	"Downloads"
"DOTA_WatchLive_HeroFilter"	"Filter: {s:hero_filter_name}"
"DOTA_WatchLive_CountSpec"	"{i:num_spectating} Zuschauer"
"DOTA_WatchLive_CountSpecFriend"	"{i:num_friends_spectating} Freund und {i:num_spectating} Zuschauer"
"DOTA_WatchLive_CountSpecFriends"	"{i:num_friends_spectating} Freunde und {i:num_spectating} Zuschauer"
"DOTA_WatchLive_CountFriends"	"{i:num_friends_playing} Freunde spielen"
"DOTA_WatchLive_ParticipantsUnranked"	"Ungewertet"
"DOTA_WatchLive_Participants1"	"{s:friend_1}"
"DOTA_WatchLive_Participants2"	"{s:friend_1} und {s:friend_2}"
"DOTA_WatchLive_Participants3"	"{s:friend_1}, {s:friend_2} und {s:friend_3}"
"DOTA_WatchLive_Participants4Plus"	"{s:friend_1}, {s:friend_2}, {s:friend_3} und {i:friend_count_over_3} weitere..."
"DOTA_WatchLive_MatchType_MM_Kills"	"{s:game_mode}"
"DOTA_WatchLive_MatchType_MM"	"{s:game_mode}"
"DOTA_WatchLiveSpectatorFriends1"	"{g:dota_persona:spectator_friend_1} schaut zu"
"DOTA_WatchLiveSpectatorFriends2"	"{g:dota_persona:spectator_friend_1} und {g:dota_persona:spectator_friend_2} schauen zu"
"DOTA_WatchLiveSpectatorFriends3"	"{g:dota_persona:spectator_friend_1}, {g:dota_persona:spectator_friend_2} und {g:dota_persona:spectator_friend_3} schauen zu"
"DOTA_WatchLiveSpectatorFriends4Plus"	"{g:dota_persona:spectator_friend_1}, {g:dota_persona:spectator_friend_2}, {g:dota_persona:spectator_friend_3} und {i:spectator_friend_count_over_3} weitere Freunde schauen zu"
"DOTA_WatchLiveSpectatorCount"	"{i:spectator_count} schauen zu"
"DOTA_WatchReplays_Popular"	"BELIEBTE PARTIEN"
"DOTA_WatchReplays_ParticipantsVs"	"{s:team_1} vs. {s:team_2}"
"DOTA_WatchReplays_MatchType_League"	"{s:league_name}"
"DOTA_WatchReplays_MatchType_Public"	"Partie {s:match_id} - {s:game_mode}"
"DOTA_WatchReplays_Recommendations"	"{i:recommendations}"
"DOTA_WatchReplays_Recommendations1"	"{g:dota_persona:friend_1} + {i:recommendations}"
"DOTA_WatchReplays_Recommendations2"	"{g:dota_persona:friend_1}, {g:dota_persona:friend_2} + {i:recommendations}"
"DOTA_WatchReplays_Recommendations3Plus"	"{g:dota_persona:friend_1} + {i:friend_count_over_1} weitere Freunde + {i:recommendations}"
"DOTA_WatchReplays_Views"	"{i:views} Aufrufe"
"DOTA_WatchReplays_SharedMatch"	"{g:dota_persona:shared_by} hat geteilt: \"{s:shared_text}\""
"DOTA_WatchReplays_SharedHighlight"	"{g:dota_persona:shared_by} hat ein Highlight geteilt"
"DOTA_WatchReplays_Duration"	"{s:minutes}:{s:seconds}"
"DOTA_WatchReplays_Tag"	"\"{s:recommendation_text}\""
"DOTA_WatchTournaments_FeaturedTitle"	"{s:tournament_featured_title}"
"DOTA_WatchTournaments_FeaturedDates"	"{s:tournament_featured_start} - {s:tournament_featured_end}"
"DOTA_WatchTournaments_FeaturedDescription"	"{s:tournament_featured_description}"
"DOTA_WatchTournaments_FeaturedTeams"	"Teams"
"DOTA_WatchTournaments_PrizePool"	"Preisgeld:"
"DOTA_WatchTournaments_PrizePoolAmt"	"{s:tournament_featured_prize_pool}"
"DOTA_WatchTournaments_Purchase"	"Turnierpass - {s:tournament_featured_price}"
"DOTA_WatchTournament_TournamentName"	"{s:tournament_name}"
"DOTA_WatchTournament_Price"	"{s:price}"
"DOTA_Watch_Unavailable"	"Diesem Spiel kann zurzeit nicht zugesehen werden."
"DOTA_Watch_LobbyNotFound"	"Lobby nicht gefunden."
"vs"	"vs."
"dota_matchmaking_language_primary_label"	"Ihre primäre Matchmaking-Sprache ist:"
"dota_matchmaking_language_primary"	"{s:environment_language}"
"dota_matchmaking_language_select_primary"	"Bitte wählen Sie eine Matchmaking-Sprache:"
"dota_matchmaking_language_no_selection"	"Keine Auswahl"
"dota_matchmaking_language_english"	"Englisch"
"dota_matchmaking_language_russian"	"Russisch"
"dota_matchmaking_language_chinese"	"Chinesisch"
"dota_matchmaking_language_schinese"	"Chinesisch"
"dota_matchmaking_language_korean"	"Koreanisch"
"dota_matchmaking_language_koreana"	"Koreanisch"
"dota_matchmaking_language_spanish"	"Spanisch"
"dota_matchmaking_language_portuguese"	"Portugiesisch"
"GameUI_Language_English"	"Englisch"
"GameUI_Language_German"	"Deutsch"
"GameUI_Language_French"	"Französisch"
"GameUI_Language_Italian"	"Italienisch"
"GameUI_Language_Korean"	"Koreanisch"
"GameUI_Language_Spanish"	"Spanisch"
"GameUI_Language_Simplified_Chinese"	"Vereinfachtes Chinesisch"
"GameUI_Language_Traditional_Chinese"	"Traditionelles Chinesisch"
"GameUI_Language_Russian"	"Russisch"
"GameUI_Language_Thai"	"Thai"
"GameUI_Language_Japanese"	"Japanisch"
"GameUI_Language_Portuguese"	"Portugiesisch"
"GameUI_Language_Polish"	"Polnisch"
"GameUI_Language_Danish"	"Dänisch"
"GameUI_Language_Dutch"	"Niederländisch"
"GameUI_Language_Finnish"	"Finnisch"
"GameUI_Language_Norwegian"	"Norwegisch"
"GameUI_Language_Swedish"	"Schwedisch"
"GameUI_Language_Hungarian"	"Ungarisch"
"GameUI_Language_Czech"	"Tschechisch"
"GameUI_Language_Romanian"	"Rumänisch"
"GameUI_Language_Turkish"	"Türkisch"
"GameUI_Language_Brazilian"	"Brasilianisches Portugiesisch"
"GameUI_Language_Bulgarian"	"Bulgarisch"
"GameUI_Language_Greek"	"Griechisch"
"GameUI_Language_Ukrainian"	"Ukrainisch"
"client_version_out_of_date_title"	"Update erforderlich"
"client_version_out_of_date"	"Die Spielversion ist veraltet. Bitte schließen Sie Dota 2 und starten Sie es neu, um die neueste Version zu erhalten."
"limited_heroes_abandon_header"	"Limitierte-Helden-Modus"
"limited_heroes_abandon_explanation"	"Es gibt keine Strafe für das Verlassen eines Spiels im Limitierte-Helden-Modus, da Ihr Held durch einen Bot ersetzt wird. Das Verlassen eines anderen Spielmodus kann zu einer Platzierung in Spielen mit niedriger Priorität führen."
"dota_abandon_dialog_yes"	"Ja, Spiel aufgeben."
"dota_leave_dialog_title"	"Spiel verlassen"
"dota_leave_dialog_confirm"	"Sind Sie sicher, dass Sie dieses Spiel verlassen möchten?"
"dota_leave_dialog_yes"	"Ja, Spiel verlassen."
"dota_accept_match_title"	"Ihr Spiel ist bereit"
"dota_accept_match_readyup_title"	"Warten auf Spieler"
"dota_accept_match_accept"	"Annehmen"
"dota_accept_match_accept_low_pri"	"Partie mit niedriger Priorität annehmen"
"dota_accept_match_accept_button"	"{s:accept}"
"dota_accept_match_decline"	"Ablehnen"
"dota_accept_match_subtitle"	"{s:subtitle}"
"dota_finding_match_players"	"({s:searching_player_count} Suchende)"
"dota_finding_match_time"	"Suchzeit der Partie: {s:find_match_time}"
"dota_finding_match_team"	"Team-Ranglistenspiel"
"dota_finding_1v1_match_casual"	"1vs1-Spiel"
"dota_finding_match_practice_lobby"	"Lobbyspiel"
"dota_safe_to_abandon_inline"	"Spiel kann sicher verlassen werden"
"dota_match_connected"	"Mit Spiel verbunden"
"dota_match_local_game"	"Mit lokalem Spiel verbunden"
"dota_match_connecting"	"Verbindung zum Spiel wird aufgebaut..."
"dota_match_in_progress"	"Spiel läuft"
"dota_match_finished"	"Spiel ist beendet"
"matchmaking_waiting_for_players"	"Warten auf andere Spieler"
"matchmaking_player_declined"	"Ein Spieler hat das Spiel abgelehnt"
"dota_match_find_server"	"Server wird gesucht"
"ranked_mmr"	"Ihr Matchmaking-Rang"
"ranked_mmr_solo_label"	"Solo"
"ranked_mmr_solo_value"	"{i:solo_mmr}"
"ranked_mmr_solo_calibrating"	"Unbekannt - noch {i:solo_calibrating_games} Spiele"
"ranked_mmr_solo_no_data"	"{i:solo_calibrating_required_games} Spiele zum Kalibrieren erforderlich"
"ranked_mmr_party_label"	"Gruppe"
"ranked_mmr_party_value"	"{i:party_mmr}"
"ranked_mmr_party_calibrating"	"Unbekannt - noch {i:party_calibrating_games} Spiele"
"ranked_mmr_party_no_data"	"{i:party_calibrating_required_games} Spiele zum Kalibrieren erforderlich"
"dota_ready_up_count"	"{s:ready_up_ready} / {s:ready_up_lobby_members}"
"dota_play_normal_match"	"Normales Spiel"
"dota_play_ranked_match"	"Ranglistenspiel"
"dota_play_practice_with_bots"	"Übungsspiel mit Bots"
"dota_play_1v1_desc"	"Trainieren Sie Ihre Solo-Mid-Lane gegen einen anderen Spieler. Das Training endet, wenn ein Spieler zweimal gestorben ist oder einen Turm verliert."
"dota_play_button_label"	"{s:play_button_label}"
"dota_play"	"Dota spielen"
"dota_play_searching"	"Partie suchen"
"dota_play_connecting"	"Host lädt..."
"dota_play_lobby_find_server"	"Server wird gesucht"
"dota_play_find_match_label"	"{s:find_match_label}"
"dota_reconnect"	"Verbindung wiederherstellen"
"dota_abandon_game"	"Aufgeben"
"dota_safe_leave_game"	"Spiel verlassen"
"dota_disconnect"	"Verbindung trennen"
"dota_play_unavailable"	"Nicht verfügbar"
"dota_leaver_consequence_tooltip_header"	"Konsequenzen"
"dota_leaver_consequences"	"{s:leaver_consequences}"
"dota_leaver_consequences_details"	"{s:leaver_consequences_details}"
"dota_leaver_view_tooltip"	"Details anzeigen"
"dota_leaver_consequence_header_failure_to_reconnect"	"Das Fehlschlagen einer Wiederverbindung wird die folgenden Konsequenzen haben:"
"dota_leaver_consequence_header_leave_match"	"Das Verlassen dieses Spiels wird die folgenden Konsequenzen haben:"
"dota_leaver_consequence_LetDownTeammates"	"Ihre Mitspieler werden für den Rest des Spiels im Nachteil sein."
"dota_leaver_consequence_SmallMatchmakingCooldown"	"Sie werden eine Zeit lang vom Matchmaking ausgeschlossen."
"dota_leaver_consequence_CreditWithAbandon"	"Ihnen wird eine Aufgabe angerechnet."
"dota_leaver_consequence_ForcedLossForLeaver"	"Ihnen wird eine Niederlage angerechnet."
"dota_leaver_consequence_ForcedLossForLeaversParty"	"Jedem Gruppenmitglied wird eine Niederlage angerechnet."
"dota_leaver_consequence_ForcedLossForLeaversTeam"	"Ihrem Team \"%s1\" wird eine Niederlage angerechnet."
"dota_leaver_consequence_MMRLossForLeaver"	"Ihre MMW wird sinken."
"dota_leaver_consequence_MMRLossForLeaversParty"	"Die MMW jedes Ihrer Gruppenmitglieder wird sinken."
"dota_leaver_consequence_MMRLossForLeaversTeam"	"Die MMW Ihres Teams \"%s1\" wird sinken."
"dota_leaver_consequence_MatchDiscardedForOtherPlayers"	"Das Spiel wird für andere Spieler nicht gewertet."
"dota_leaver_consequence_NotDecrementLowPriGamesRemaining"	"Ihnen wird das Spiel nicht als \"abgeschlossen\" angerechnet."
"dota_reconnect_popup_title"	"Wiederverbinden?"
"dota_reconnect_popup_message"	"Platzhaltertext - möchten Sie sich mit dem Spiel wiederverbinden?"
"dota_matchmaking_regions_refresh"	"Pings aktualisieren"
"dota_matchmaking_region_ping"	"{s:region_ping}"
"dota_matchmaking_region_offline"	"Offline wegen Wartungsarbeiten"
"dota_matchmaking_region_unknown_ping"	"Ping: Unbekannt"
"dota_matchmaking_region_ping_time"	"Ping: {i:ping_ms}ms"
"DOTA_VAC_Verification_Header"	"Valve-Anti-Cheat (VAC)"
"DOTA_VAC_Verification_Header_Solo"	"Kann Matchmaking nicht beitreten, da ein Problem mit Ihrem Computer das VAC-System blockiert. Bitte stellen Sie sicher, dass keine Programme ausgeführt werden, die mit VAC interferieren, und dass Steam korrekt installiert wurde."
"DOTA_VAC_Verification_Button1"	"Weitere Informationen"
"DOTA_VAC_Verification_Button2"	"Schließen"
"dota_matchmaking_regions_button"	"{s:regions_selected}"
"dota_region_automatic"	"Region: Automatisch"
"dota_regions_selected"	"Regionen:"
"dota_lobby_region_invalid"	"Keine"
"dota_play_no_language_selected"	"SPRACHE AUSWÄHLEN"
"dota_play_language"	"{s:match_language}"
"dota_play_language_many"	"SPRACHEN: {i:match_language_count}"
"dota_ready_fail"	"BEREITMACHEN FEHLGESCHLAGEN"
"dota_ready_fail_desc"	"Ihre Partie war bereit, Sie haben jedoch nicht reagiert und wurden deswegen aus der Matchmaking-Liste entfernt."
"dota_all_chat_label"	"[ALLE]"
"dota_chatwheel_label_Ok"	"Okay"
"dota_chatwheel_label_Care"	"Vorsicht"
"dota_chatwheel_label_GetBack"	"Komm zurück"
"dota_chatwheel_label_NeedWards"	"Brauchen Wards"
"dota_chatwheel_label_Stun"	"Stunnen"
"dota_chatwheel_label_Help"	"Hilfe"
"dota_chatwheel_label_Push"	"Pushen"
"dota_chatwheel_label_GoodJob"	"Gut gespielt"
"dota_chatwheel_label_Missing"	"Fehlt"
"dota_chatwheel_label_Missing_Top"	"Top fehlt"
"dota_chatwheel_label_Missing_Mid"	"Mid fehlt"
"dota_chatwheel_label_Missing_Bottom"	"Bottom fehlt"
"dota_chatwheel_label_Go"	"Los!"
"dota_chatwheel_label_Initiate"	"Initiieren!"
"dota_chatwheel_label_Follow"	"Mir nach!"
"dota_chatwheel_label_Group_Up"	"Sammeln"
"dota_chatwheel_label_Spread_Out"	"Schwärmt aus"
"dota_chatwheel_label_Split_Farm"	"Aufteilen und farmen"
"dota_chatwheel_label_Attack"	"Jetzt angreifen!"
"dota_chatwheel_label_BRB"	"Bin gleich zurück"
"dota_chatwheel_label_Dive"	"Rein da!"
"dota_chatwheel_label_OMW"	"Bin unterwegs"
"dota_chatwheel_label_Get_Ready"	"Bereit machen"
"dota_chatwheel_label_Bait"	"Falle"
"dota_chatwheel_label_Heal"	"Heilen"
"dota_chatwheel_label_Mana"	"Mana"
"dota_chatwheel_label_OOM"	"Kein Mana mehr"
"dota_chatwheel_label_Skill_Cooldown"	"Abklingzeit"
"dota_chatwheel_label_Ulti_Ready"	"Ulti bereit"
"dota_chatwheel_label_Enemy_Returned"	"Gegner zurück"
"dota_chatwheel_label_All_Missing"	"Alle fehlen"
"dota_chatwheel_label_Enemy_Incoming"	"Im Anmarsch"
"dota_chatwheel_label_Invis_Enemy"	"Unsichtbarer Gegner"
"dota_chatwheel_label_Enemy_Had_Rune"	"Gegner hat die Rune"
"dota_chatwheel_label_Split_Push"	"Aufteilen und pushen"
"dota_chatwheel_label_Coming_To_Gank"	"Komme ganken"
"dota_chatwheel_label_Request_Gank"	"Erbitte Gank"
"dota_chatwheel_label_Fight_Under_Tower"	"Beim Turm"
"dota_chatwheel_label_Deny_Tower"	"Turm denyen"
"dota_chatwheel_label_Buy_Courier"	"Kurier kaufen"
"dota_chatwheel_label_Upgrade_Courier"	"Kurier upgraden"
"dota_chatwheel_label_Need_Detection"	"Wir brauchen Aufdeckung"
"dota_chatwheel_label_They_Have_Detection"	"Sie haben Aufdeckung"
"dota_chatwheel_label_Buy_TP"	"Teleportation kaufen"
"dota_chatwheel_label_Reuse_Courier"	"Kurier erneut benutzen"
"dota_chatwheel_label_Deward"	"Dewarden"
"dota_chatwheel_label_Building_Mek"	"Baue Meka"
"dota_chatwheel_label_Building_Pipe"	"Baue Pipe"
"dota_chatwheel_label_Stack_And_Pull"	"Stacken und pullen"
"dota_chatwheel_label_Pull"	"Creeps pullen"
"dota_chatwheel_label_Pulling"	"Pulle die Creeps"
"dota_chatwheel_label_Stack"	"Neutrals stacken"
"dota_chatwheel_label_Jungling"	"Dschungel"
"dota_chatwheel_label_Roshan"	"Roshan"
"dota_chatwheel_label_Affirmative"	"Jawohl"
"dota_chatwheel_label_Wait"	"Wartet"
"dota_chatwheel_label_Pause"	"Pause"
"dota_chatwheel_label_Current_Time"	"Aktuelle Zeit"
"dota_chatwheel_label_Check_Runes"	"Prüfe Runen"
"dota_chatwheel_label_Smoke_Gank"	"Smoke-Gank!"
"dota_chatwheel_label_GLHF"	"Viel Glück!"
"dota_chatwheel_label_Nice"	"Schön"
"dota_chatwheel_label_Thanks"	"Danke"
"dota_chatwheel_label_Sorry"	"Sorry"
"dota_chatwheel_label_No_Give_Up"	"Nicht aufgeben"
"dota_chatwheel_label_Just_Happened"	"Passiert"
"dota_chatwheel_label_Game_Is_Hard"	"Schweres Spiel"
"dota_chatwheel_label_New_Meta"	"Neues Meta"
"dota_chatwheel_label_My_Bad"	"Mein Fehler"
"dota_chatwheel_label_Regret"	"Bereuen"
"dota_chatwheel_label_Relax"	"Entspann dich"
"dota_chatwheel_label_GG"	"GG"
"dota_chatwheel_label_GGWP"	"GGWP"
"dota_chatwheel_label_All_GG"	"(Alle) GG"
"dota_chatwheel_label_All_GGWP"	"(Alle) GGWP"
"dota_chatwheel_label_What_To_Buy"	"Was soll ich kaufen?"
"dota_chatwheel_label_Im_Retreating"	"Ich ziehe mich zurück"
"dota_chatwheel_label_Space_Created"	"Freiraum geschaffen"
"dota_chatwheel_label_Whoops"	"Ups"
"dota_chatwheel_label_Tower_then_Back"	"Turm, danach zurück"
"dota_chatwheel_label_Barracks_then_Back"	"Barracke, danach zurück"
"dota_chatwheel_label_Ward_Bottom_Rune"	"Bottom-Rune warden"
"dota_chatwheel_label_Ward_Top_Rune"	"Top-Rune warden"
"dota_chatwheel_label_Zeus_Ult"	"Zeus: Ulti"
"dota_chatwheel_header_positioning"	"Positionierung"
"dota_chatwheel_header_status"	"Status"
"dota_chatwheel_header_enemy"	"Gegner"
"dota_chatwheel_header_lane"	"Lane"
"dota_chatwheel_header_items"	"Gegenstände"
"dota_chatwheel_header_neutrals"	"Neutrale Einheiten"
"dota_chatwheel_header_misc"	"Sonstiges"
"dota_chatwheel_header_flavor"	"Teamgeist"
"dota_chatwheel_message_Ok"	"Okay."
"dota_chatwheel_message_Care"	"Sei vorsichtig!"
"dota_chatwheel_message_GetBack"	"Komm zurück!"
"dota_chatwheel_message_NeedWards"	"Wir brauchen Wards."
"dota_chatwheel_message_Stun"	"Los, stunnen!"
"dota_chatwheel_message_Help"	"Hilfe!"
"dota_chatwheel_message_Push"	"Jetzt alle pushen"
"dota_chatwheel_message_GoodJob"	"Gut gespielt!"
"dota_chatwheel_message_Missing"	"Fehlt!"
"dota_chatwheel_message_Missing_Top"	"Top fehlt!"
"dota_chatwheel_message_Missing_Mid"	"Mid fehlt!"
"dota_chatwheel_message_Missing_Bottom"	"Bottom fehlt!"
"dota_chatwheel_message_Go"	"Los!"
"dota_chatwheel_message_Initiate"	"Initiieren!"
"dota_chatwheel_message_Follow"	"Mir folgen"
"dota_chatwheel_message_Group_Up"	"Sammeln"
"dota_chatwheel_message_Spread_Out"	"Verteilt euch"
"dota_chatwheel_message_Split_Farm"	"Aufteilen und farmen"
"dota_chatwheel_message_Attack"	"Jetzt angreifen!"
"dota_chatwheel_message_BRB"	"Bin gleich zurück"
"dota_chatwheel_message_Dive"	"Prescht vor!"
"dota_chatwheel_message_OMW"	"Auf dem Weg"
"dota_chatwheel_message_Get_Ready"	"Macht euch bereit"
"dota_chatwheel_message_Bait"	"Falle"
"dota_chatwheel_message_Heal"	"Heilen"
"dota_chatwheel_message_Mana"	"Mana"
"dota_chatwheel_message_OOM"	"Kein Mana"
"dota_chatwheel_message_Skill_Cooldown"	"Fähigkeiten auf Abklingzeit"
"dota_chatwheel_message_Ulti_Ready"	"Ultimate bereit"
"dota_chatwheel_message_Enemy_Returned"	"Gegner ist zurück"
"dota_chatwheel_message_All_Missing"	"Alle gegnerischen Helden fehlen!"
"dota_chatwheel_message_Enemy_Incoming"	"Gegner im Anmarsch!"
"dota_chatwheel_message_Invis_Enemy"	"Unsichtbarer Gegner in der Nähe!"
"dota_chatwheel_message_Enemy_Had_Rune"	"Gegner hat Rune"
"dota_chatwheel_message_Split_Push"	"Aufteilen und pushen"
"dota_chatwheel_message_Coming_To_Gank"	"Komme ganken"
"dota_chatwheel_message_Request_Gank"	"Erbitte einen Gank"
"dota_chatwheel_message_Fight_Under_Tower"	"Kämpft beim Turm"
"dota_chatwheel_message_Deny_Tower"	"Deny den Turm!"
"dota_chatwheel_message_Buy_Courier"	"Kauft bitte einen Kurier"
"dota_chatwheel_message_Upgrade_Courier"	"Kann jemand den Kurier upgraden?"
"dota_chatwheel_message_Need_Detection"	"Wir brauchen Aufdeckung"
"dota_chatwheel_message_They_Have_Detection"	"Sie haben Aufdeckung"
"dota_chatwheel_message_Buy_TP"	"Kauf eine Teleport Scroll"
"dota_chatwheel_message_Reuse_Courier"	"Nutze Kurier erneut"
"dota_chatwheel_message_Deward"	"Dewarden bitten"
"dota_chatwheel_message_Building_Mek"	"Ich baue Mekansm"
"dota_chatwheel_message_Building_Pipe"	"Ich baue Pipe of Insight"
"dota_chatwheel_message_Stack_And_Pull"	"Stacken und pullen bitte"
"dota_chatwheel_message_Pull"	"Bitte Creeps pullen"
"dota_chatwheel_message_Pulling"	"Pulle die Creeps"
"dota_chatwheel_message_Stack"	"Neutrals stacken"
"dota_chatwheel_message_Jungling"	"Gehe in den Dschungel"
"dota_chatwheel_message_Roshan"	"Roshan"
"dota_chatwheel_message_Affirmative"	"Bestätigt!"
"dota_chatwheel_message_Wait"	"Wartet"
"dota_chatwheel_message_Pause"	"Pause, bitte!"
"dota_chatwheel_message_Current_Time"	"Aktuelle Spielzeit"
"dota_chatwheel_message_Check_Runes"	"Bitte Runen prüfen"
"dota_chatwheel_message_Smoke_Gank"	"Lasst uns smoke-ganken!"
"dota_chatwheel_message_GLHF"	"Viel Glück, habt Spaß"
"dota_chatwheel_message_Nice"	"Schön"
"dota_chatwheel_message_Thanks"	"Danke!"
"dota_chatwheel_message_Sorry"	"Sorry"
"dota_chatwheel_message_No_Give_Up"	"Nicht aufgeben!"
"dota_chatwheel_message_Just_Happened"	"Das ist einfach passiert"
"dota_chatwheel_message_Game_Is_Hard"	"Das Spiel ist schwer"
"dota_chatwheel_message_New_Meta"	"Neues Meta"
"dota_chatwheel_message_My_Bad"	"Mein Fehler"
"dota_chatwheel_message_Regret"	"Ich habe meine Entscheidung sofort bereut"
"dota_chatwheel_message_Relax"	"Entspann dich, du machst das schon"
"dota_chatwheel_message_MissingHero"	"%s1 fehlt!"
"dota_chatwheel_message_ReturnedHero"	"%s1 ist zurück!"
"dota_chatwheel_message_GG"	"Gutes Spiel"
"dota_chatwheel_message_GGWP"	"Gutes Spiel, gut gespielt"
"dota_chatwheel_message_All_GG"	"Gutes Spiel"
"dota_chatwheel_message_All_GGWP"	"Gutes Spiel, gut gespielt"
"dota_chatwheel_message_What_To_Buy"	"Was soll ich kaufen?"
"dota_chatwheel_message_Im_Retreating"	"Ich ziehe mich zurück"
"dota_chatwheel_message_Space_Created"	"Freiraum geschaffen"
"dota_chatwheel_message_Whoops"	"Ups"
"dota_chatwheel_message_Tower_then_Back"	"Zerstört den Turm, danach zieht euch zurück"
"dota_chatwheel_message_Barracks_then_Back"	"Zerstört die Barracke, danach zieht euch zurück"
"dota_chatwheel_message_Ward_Bottom_Rune"	"Wardet die Bottom-Rune"
"dota_chatwheel_message_Ward_Top_Rune"	"Wardet die Top-Rune"
"dota_chatwheel_message_Zeus_Ult"	"Zeus, Ultimate, jetzt!"
"dota_settings_hotkeys"	"Hotkeys"
"dota_settings_options"	"Optionen"
"dota_settings_audio"	"Audio"
"dota_settings_voice"	"Sprache"
"dota_settings_voice_level"	"Aktuelles Aufnahmelevel"
"dota_settings_volume"	"Lautstärke"
"dota_settings_video"	"Grafik"
"dota_settings_resetkeys"	"Hotkeys zurücksetzen..."
"dota_settings_legacykeys"	"Klassische Tastenbelegung verwenden"
"dota_settings_abilities"	"Fähigkeiten"
"dota_settings_abilities_hero"	"Held"
"dota_settings_abilities_neutrals"	"Neutrale Einheiten"
"dota_settings_abilities_courier"	"Kurier"
"dota_settings_abilities_primary1"	"1"
"dota_settings_abilities_primary2"	"2"
"dota_settings_abilities_primary3"	"3"
"dota_settings_abilities_secondary1"	"4"
"dota_settings_abilities_secondary2"	"5"
"dota_settings_abilities_neutral1"	"1"
"dota_settings_abilities_neutral2"	"2"
"dota_settings_abilities_neutral3"	"3"
"dota_settings_abilities_neutral4"	"4"
"dota_settings_abilities_courier1"	"1"
"dota_settings_abilities_courier2"	"2"
"dota_settings_abilities_courier3"	"3"
"dota_settings_abilities_courier4"	"4"
"dota_settings_abilities_courier5"	"5"
"dota_settings_abilities_courier6"	"6"
"dota_settings_abilities_ultimate"	"U"
"dota_settings_cast"	"Zauber"
"dota_settings_autocast"	"Autozauber"
"dota_settings_quickcast"	"Schnellzauber"
"dota_settings_abilitylearn"	"Fähigkeit lernen"
"dota_settings_upgradestats"	"Attribute aufwerten"
"dota_settings_unitactions"	"Einheiten"
"dota_settings_attack"	"Angreifen / Angriff erzwingen"
"dota_settings_move"	"Bewegen"
"dota_settings_stop"	"Stopp"
"dota_settings_holdposition"	"Position halten"
"dota_settings_selecthero"	"Helden auswählen"
"dota_settings_selectall"	"Alle Einheiten auswählen"
"dota_settings_selectallothers"	"Alle anderen Einheiten auswählen"
"dota_settings_selectcourier"	"Kurier auswählen"
"dota_settings_courierdeliver"	"Kurier: Gegenstände überbringen"
"dota_settings_courierhaste"	"Kurier: Geschwindigkeitsschub"
"dota_settings_useactionitem"	"Aktionsgegenstand"
"dota_settings_herotaunt"	"Spottgegenstand"
"dota_settings_items"	"Gegenstände"
"dota_settings_openshop"	"Shop öffnen"
"dota_settings_purchasequickbuy"	"Durch Schnellkauf erwerben"
"dota_settings_purchasesticky"	"Sticky erwerben"
"dota_settings_grabstashitems"	"Gegenstände nehmen"
"dota_settings_camera"	"Kamera"
"dota_settings_cameraactions"	"Kameraaktionen"
"dota_settings_cameraup"	"Kamera nach vorne"
"dota_settings_cameradown"	"Kamera nach hinten"
"dota_settings_cameraleft"	"Kamera nach links"
"dota_settings_cameraright"	"Kamera nach rechts"
"dota_settings_cameragrip"	"Kameraführung"
"dota_settings_recentevent"	"Zum letzten Ereignis springen"
"dota_settings_inspectheroinworld"	"Showcase-Ansicht"
"dota_settings_chat"	"Chat"
"dota_settings_phrases"	"Phrasen"
"dota_settings_chatwheel_page"	"Chatrad"
"dota_settings_chatteam"	"Teamchat"
"dota_settings_chatglobal"	"Chat (Alle)"
"dota_settings_chatvoice_party"	"Sprachchat (Gruppe)"
"dota_settings_chatvoice_team"	"Sprachchat (Team)"
"dota_settings_chatwheel_show"	"Chatrad"
"dota_settings_playeractions"	"Spieleraktionen"
"dota_settings_activateglyph"	"Glyphe aktivieren"
"dota_settings_scoreboardtoggle"	"Punktestand"
"dota_settings_pause"	"Pause"
"dota_settings_screenshot"	"Screenshot"
"dota_settings_console"	"Konsole"
"dota_settings_controlgroups"	"Gruppen steuern"
"dota_settings_controlgroupsadditional"	"Weitere Gruppen steuern"
"dota_settings_controlgroupcycle"	"Zwischen Gruppen wechseln"
"dota_settings_group1"	"Gruppe 1"
"dota_settings_group2"	"Gruppe 2"
"dota_settings_group3"	"Gruppe 3"
"dota_settings_group4"	"Gruppe 4"
"dota_settings_group5"	"Gruppe 5"
"dota_settings_group6"	"Gruppe 6"
"dota_settings_group7"	"Gruppe 7"
"dota_settings_group8"	"Gruppe 8"
"dota_settings_group9"	"Gruppe 9"
"dota_settings_group10"	"Gruppe 10"
"dota_settings_advancedpanel_goto"	"Erweitert"
"dota_settings_standardpanel_goto"	"Standard"
"dota_settings_spectatorandreplay"	"Zuschauer-/Aufnahmesteuerung"
"dota_settings_spectatorcameraup"	"Zuschauer - Kamera vorwärts"
"dota_settings_spectatorcameradown"	"Zuschauer - Kamera zurück"
"dota_settings_spectatorcameraleft"	"Zuschauer - Kamera nach links"
"dota_settings_spectatorcameraright"	"Zuschauer - Kamera nach rechts"
"dota_settings_spectatorcameragrip"	"Zuschauer - Kameraführung"
"dota_settings_spectatorpause"	"Zuschauerpause"
"dota_settings_spectatorchat"	"Zuschauer - Chat"
"dota_settings_spectatorscoreboard"	"Zuschauer - Punktetabelle"
"dota_settings_spectatorbroadcastermenu"	"Kommentatorenmenü öffnen"
"dota_settings_spectatorincreasereplayspeed"	"Aufnahmegeschwindigkeit erhöhen"
"dota_settings_spectatordecreasereplayspeed"	"Aufnahmegeschwindigkeit reduzieren"
"dota_settings_spectatorstatsharvest"	"Zuschauer - Gold- & Erfahrungsstatistik"
"dota_settings_spectatorstatsitem"	"Zuschauer - Gegenstandsstatistik"
"dota_settings_spectatorstatsgold"	"Zuschauer - Golddiagramm"
"dota_settings_spectatorstatsxp"	"Zuschauer - EP-Diagramm"
"dota_settings_spectatorstatsfantasy"	"Zuschauer - Fantasiestatistiken"
"dota_settings_spectatorfowboth"	"Zuschauer - Nebel: Beide Teams"
"dota_settings_spectatorfowradient"	"Zuschauer - Nebel: Radiant"
"dota_settings_spectatorfowdire"	"Zuschauer - Nebel: Dire"
"dota_settings_statsdropdown"	"Statistikmenü"
"dota_settings_spectatordropdown_sort"	"Sortierung ändern"
"dota_settings_spectatordropdown_close"	"Kategorie zurücksetzen"
"dota_settings_spectatordropdown_kda"	"Kills/Tode/Assists"
"dota_settings_spectatordropdown_lasthits_denies"	"Last Hits/Denys"
"dota_settings_spectatordropdown_level"	"Heldenlevel"
"dota_settings_spectatordropdown_xp_per_min"	"EP pro Minute"
"dota_settings_spectatordropdown_gold"	"Aktuelles Gold"
"dota_settings_spectatordropdown_totalgold"	"Vermögen"
"dota_settings_spectatordropdown_gold_per_min"	"Gold pro Minute"
"dota_settings_spectatordropdown_buyback"	"Rückkauf-Status"
"dota_settings_spectatordropdown_fantasy"	"Fantasiepunkte"
"dota_settings_coaching"	"Mentoren"
"dota_settings_spectatorcoach_viewtoggle"	"Mentor-/Schülerperspektive umschalten"
"dota_settings_keyboardtemplate"	"Tastaturvorlage auswählen"
"dota_settings_or"	"oder"
"dota_settings_cancel"	"Abbrechen"
"dota_settings_apply"	"Anwenden"
"dota_settings_game"	"Spiel"
"dota_settings_autoattack"	"Automatisch angreifen"
"dota_settings_attackafterspell"	"Autom. Angriff nach Zauber"
"dota_settings_autopurchase"	"Autom. Gegenstände kaufen"
"dota_settings_autoselect"	"Auto-Auswahl beschworener Einheiten"
"dota_settings_doubletapself"	"Selbstzauber bei Doppelklick"
"dota_settings_unifiedorders"	"Einheitliche Gruppenbefehle"
"dota_settings_teleportrequireshalt"	"Teleport benötigt Stoppbefehl"
"dota_settings_herofinder"	"Alt-Taste hebt den Helden hervor"
"dota_settings_alwaysshownames"	"Spielernamen über Lebensbalken anzeigen"
"dota_settings_showhitpoints"	"Gesundheit als Zahl über Lebensbalken anzeigen"
"dota_settings_forceshophotkeys"	"Shop erlaubt Hotkeys"
"dota_settings_usebroadcastermenu"	"Kommentatoreinblendungen"
"dota_settings_colorblind"	"Farbenblindmodus"
"dota_settings_reducedflash"	"Reduzierte Blitzeffekte"
"dota_settings_minimap"	"Minikarte"
"dota_settings_minimapsimplecolors"	"Einfache Farben für Minikarte verwenden"
"dota_settings_minimaphidebackground"	"Minikarte-Hintergrund verstecken"
"dota_settings_minimapshowheroicon"	"Heldensymbole auf Minikarte anzeigen"
"dota_settings_minimapalwaysshowname"	"Namen/Symbole immer in Minikarte anzeigen"
"dota_settings_minimapflip"	"Minikarte auf der rechten Seite anzeigen"
"dota_settings_cameradecel"	"Kameraabbremsung"
"dota_settings_cameraspeed"	"Kamerageschwindigkeit"
"dota_settings_camerareversegrip"	"Kameraführung invertieren"
"dota_settings_cameraedgepan"	"Kameraschwenk am Rand"
"dota_settings_camerascreenshake"	"Bildschüttern aktivieren"
"dota_settings_cameraresetonspawn"	"Kamera zum Respawn bewegen"
"dota_settings_cameradeadcolorshift"	"Kamera ändert Farbe bei Tod"
"dota_settings_profile"	"Profil"
"dota_settings_hideprofile"	"Dota- und Steam-Profil verbergen"
"dota_settings_exposematchdata"	"Öffentliche Spieldaten freigeben"
"dota_settings_ignorenonfriendparties"	"Gruppeneinladungen von Fremden blockieren"
"dota_settings_allowtradeinvitesheader"	"Handelsangebote von:"
"dota_settings_trade_guildandfriends"	"Gildenmitglieder und Freunde"
"dota_settings_trade_friends"	"Nur Freunde"
"dota_settings_trade_anyone"	"Jeder"
"dota_settings_network"	"Netzwerk"
"dota_settings_networkquality"	"Netzwerkqualität"
"dota_settings_networkquality_low"	"Niedrig"
"dota_settings_networkquality_high"	"Hoch"
"dota_settings_usenativeresolution"	"Derzeitige Auflösung verwenden"
"dota_settings_customresolution"	"Erweiterte Einstellungen verwenden"
"dota_settings_resolution"	"Auflösung"
"dota_settings_rendering"	"Rendering"
"dota_settings_aspectratio"	"Bildformat"
"dota_settings_aspectratio43"	"4:3"
"dota_settings_aspectratio169"	"16:9"
"dota_settings_aspectratio1610"	"16:10"
"dota_settings_resolution_size"	"Größe"
"dota_settings_resolution_display_mode"	"Anzeigemodus"
"dota_settings_window"	"Fenstermodus"
"dota_settings_borderless"	"Rahmenloses Fenster"
"dota_settings_videodefaults"	"Auf Standard zurücksetzen"
"dota_settings_basicvideosettings"	"Grundeinstellungen verwenden"
"dota_settings_fastestvideo"	"Beste Leistung"
"dota_settings_appearancevideo"	"Bestes Aussehen"
"dota_settings_advancedvideosettings"	"Erweiterte Einstellungen verwenden"
"dota_settings_antialiasing"	"Antialiasing"
"dota_settings_specular"	"Reflexion"
"dota_settings_bloom"	"Licht- und Reflexions-Bloom"
"dota_settings_waterquality"	"Hohe Wasserqualität"
"dota_settings_fog"	"Atmosphärischer Nebel"
"dota_settings_animateportrait"	"Animiertes Porträt"
"dota_settings_additivelight"	"Additive Lichtberechnung"
"dota_settings_worldlight"	"Weltbeleuchtung"
"dota_settings_ambientocclusion"	"Umgebungsverdeckung"
"dota_settings_ambientcreatures"	"Umgebungskreaturen"
"dota_settings_normal_maps"	"Normal-Maps"
"dota_settings_vsync"	"VSync"
"dota_settings_renderquality"	"Anzeigequalität im Spiel"
"dota_settings_shadowquality"	"Schattenqualität"
"dota_settings_shadowquality_low"	"Niedrig"
"dota_settings_shadowquality_med"	"Mittel"
"dota_settings_shadowquality_high"	"Hoch"
"dota_settings_texturequality"	"Texturqualität"
"dota_settings_texturequality_low"	"Niedrig"
"dota_settings_texturequality_med"	"Mittel"
"dota_settings_texturequality_high"	"Hoch"
"dota_settings_mastervolume"	"Gesamtlautstärke"
"dota_settings_gamevolume"	"Spiellautstärke"
"dota_settings_musicvolume"	"Musik"
"dota_settings_voicevolume"	"Sprachchat"
"dota_settings_gamevoicevolume"	"Einheitensprache"
"dota_settings_openmic"	"Offenes Mikrofon aktivieren, um mit Gruppenmitgliedern zu kommunizieren"
"dota_settings_openmicthreshold"	"Mikrofonschwellenwert"
"dota_settings_audiodefaults"	"Audio-Standardeinstellungen"
"dota_settings_defaultaudio"	"Standard"
"dota_settings_sounddevice"	"Audiogerät:"
"dota_settings_speakerconfig"	"Lautsprecherkonfiguration:"
"dota_settings_headphones"	"Kopfhörer"
"dota_settings_2speakers"	"2 Lautsprecher"
"dota_settings_4speakers"	"4 Lautsprecher"
"dota_settings_5speakers"	"5.1 Lautsprecher"
"dota_settings_7speakers"	"7.1 Lautsprecher"
"dota_settings_captions"	"Untertitel anzeigen"
"dota_settings_playsoundinbackground"	"Audio auf Desktop abspielen"
"dota_settings_chatsounds"	"Chatnachrichten-Sound"
"dota_settings_mutecobroadcasters"	"Co-Kommentatoren stummschalten"
"dota_settings_highqualityaudio"	"Hohe Audioqualität"
"dota_settings_enhancestereo"	"Verbessertes Stereo"
"dota_settings_unitspeeh"	"Einheitensprache"
"dota_settings_unitspeech_off"	"Aus"
"dota_settings_unitspeech_events"	"Events"
"dota_settings_unitspeech_all"	"Alle"
"OS_Default_Device"	"Standardgerät"
"DOTA_Keybind_ARROW"	"Pfeiltasten (Standard)"
"DOTA_Keybind_WASD"	"WASD"
"DOTA_Keybind_MMO"	"MMO"
"DOTA_Keybind_LEGACY"	"Klassische Tastenbelegung"
"DOTA_Keybind_LOL"	"League of Legends"
"DOTA_Keybind_HON"	"Heroes of Newerth"
"DOTA_Keybind_SMITE"	"Smite"
"DOTA_Hotkeys_Tooltip_LearnAbility"	"Lernmodus aktivieren, wenn Fähigkeitspunkte verfügbar sind."
"DOTA_Hotkeys_Tooltip_LearnStats"	"Erhöht jedes Ihrer Attribute um zwei Punkte, wenn Sie Fähigkeitspunkte zum Vergeben haben."
"DOTA_Hotkeys_Tooltip_HeroAttack"	"Bewegen Sie sich zu einem Ort und greifen Sie unterwegs jede gegnerische Einheit an / Greifen Sie eine freundliche Einheit an, wenn Sie diese dadurch denyen können."
"DOTA_Hotkeys_Tooltip_HeroMove"	"Zu einem bestimmten Ort bewegen oder einer Einheit folgen, ohne sie anzugreifen."
"DOTA_Hotkeys_Tooltip_HeroStop"	"Unterbricht Ihre derzeitige Aktion."
"DOTA_Hotkeys_Tooltip_HeroHold"	"Unterbricht Ihre derzeitige Aktion und bleibt an Ort und Stelle."
"DOTA_Hotkeys_Tooltip_HeroSelect"	"Ihren Helden auswählen."
"DOTA_Hotkeys_Tooltip_SelectAll"	"Alle Einheiten unter Ihrer Kontrolle auswählen."
"DOTA_Hotkeys_Tooltip_SelectAllOthers"	"Alle anderen Einheiten unter Ihrer Kontrolle auswählen. (Ihr Held wird nicht ausgewählt.)"
"DOTA_Hotkeys_Tooltip_CourierSelect"	"Kurier auswählen."
"DOTA_Hotkeys_Tooltip_CourierDeliver"	"Lässt den Kurier die Gegenstände aus Ihrem Lager zu Ihnen bringen."
"DOTA_Hotkeys_Tooltip_CourierHaste"	"Aktiviert einen Geschwindigkeitsschub auf Ihrem Kurier, falls verfügbar."
"DOTA_Hotkeys_Tooltip_UseActionItem"	"Aktionsgegenstand benutzen."
"DOTA_Hotkeys_Tooltip_HeroTaunt"	"Heldenverspottung benutzen. Als ausrüstbarer Gegenstand verfügbar."
"DOTA_Hotkeys_Tooltip_ShopToggle"	"Öffnet das Shopfenster."
"DOTA_Hotkeys_Tooltip_PurchaseQuickbuy"	"Sofern Sie genügend Gold haben, können Sie hiermit den nächsten Gegenstand in Ihrem Schnellkauffeld kaufen."
"DOTA_Hotkeys_Tooltip_PurchaseSticky"	"Sofern Sie genügend Gold haben, können Sie hiermit den Gegenstand im Schnellkauffeld kaufen."
"DOTA_Hotkeys_Tooltip_GrabStashItems"	"Überträgt alle Gegenstände von Ihrem Lager zu Ihrem Helden."
"DOTA_Hotkeys_Tooltip_RecentEvent"	"Bewegen Sie die Kamera zum letzten Ereignis in der Welt."
"DOTA_Hotkeys_Tooltip_InspectHeroInWorld"	"Schauen Sie sich eine Einheit von einer Nahansicht an."
"DOTA_Hotkeys_Tooltip_ChatTeam"	"Sendet allen Spielern Ihres Teams eine Nachricht."
"DOTA_Hotkeys_Tooltip_ChatGlobal"	"Senden Sie eine Nachricht an alle Mitspieler Ihres laufenden Spiels. (Dies fügt dem \"Chat (Team)\"-Tastaturkürzel eine Alternative per Umschalttaste zu.)"
"DOTA_Hotkeys_Tooltip_ChatVoiceTeam"	"Nutzen Sie Ihr Mikrofon, um mit allen Teammitgliedern zu kommunizieren."
"DOTA_Hotkeys_Tooltip_ChatWheel"	"Öffnet Chatrad, zur einfachen Kommunikation mittels oft benutzer Phrasen."
"DOTA_Hotkeys_Tooltip_CameraGrip"	"Halten Sie die Taste gedrückt und ziehen Sie an der Welt, um die Kameraansicht zu bewegen. Dies kann ebenso über die mittlere Maustaste erreicht werden."
"DOTA_Hotkeys_Tooltip_ActivateGlyph"	"Aktiviert die Glyphe der Verstärkung, um Ihre Gebäude für 5 Sekunden unverwundbar zu machen."
"DOTA_Hotkeys_Tooltip_ScoreboardToggle"	"Punktetabelle während des Spiels öffnen."
"DOTA_Hotkeys_Tooltip_Pause"	"Pausiert ein laufendes Spiel bzw. hebt die Pause auf."
"DOTA_Hotkeys_Tooltip_ScreenshotSettings"	"Screenshot der aktuellen Spielansicht aufnehmen."
"DOTA_Hotkeys_Tooltip_Console"	"Öffnet die Konsole. (Nur für fortgeschrittene Nutzer)"
"DOTA_Hotkeys_Tooltip_ControlGroupCycle"	"Zwischen den Einheiten der ausgewählten Gruppe wechseln."
"DOTA_Hotkeys_Tooltip_Group"	"Definieren Sie ein Tastaturkürzel für eine Gruppe von Einheiten. Um ein Tastaturkürzel festzulegen, müssen Sie die gewünschte Gruppe auswählen, die \"Strg\"-Taste gedrückt halten und eine der Gruppen-Hotkeys drücken."
"DOTA_Hotkeys_Tooltip_Legacy"	"Diese Tastenbelegung orientiert sich an Dota 1. Die Hotkeys der Fähigkeiten unterscheiden sich je nach Held."
"DOTA_Hotkeys_Tooltip_Quickcast"	"Bei Drücken der Schnellzaubertaste wird die entsprechende Fähigkeit sofort an der aktuellen Position des Mauszeigers angewendet."
"DOTA_Hotkeys_Tooltip_Autocast"	"Umschalten, um automatisch Fähigkeiten zu zaubern, sobald sie bereit sind. Wirkt nur bei einer begrenzten Anzahl an Fähigkeiten."
"DOTA_Hotkeys_Tooltip_Cast"	"Hotkeys, um eine Heldenfähigkeit zu benutzen."
"DOTA_Hotkeys_Tooltip_ItemCast"	"Hotkeys, um einen Gegenstand in Ihrem Inventar zu benutzen."
"DOTA_Hotkeys_Tooltip_ItemQuickcast"	"Bei Drücken der Schnellzaubertaste wird der entsprechende Gegenstand sofort an der aktuellen Position des Mauszeigers benutzt."
"DOTA_Settings_Tooltip_Autoattack"	"Automatisch zu nahen Gegner bewegen und diese angreifen."
"DOTA_Settings_Tooltip_AutoattackAfterSpell"	"Falls nicht angewählt, bleibt der Held nach dem Einsetzen einer Fähigkeit an Ort und Stelle und wartet auf neue Befehle."
"DOTA_Settings_Tooltip_AutoPurchase"	"Kauft automatisch den nächsten Gegenstand aus der Liste empfohlener Gegenstände, sobald genug Gold vorhanden ist."
"DOTA_Settings_Tooltip_AutoSelectSummons"	"Sobald der Held neue Einheiten beschwört, werden diese zur aktuellen Auswahl hinzugefügt."
"DOTA_Settings_Tooltip_DoubleTap"	"Bei Doppelklick auf eine Fähigkeit oder einen Gegenstand bzw. bei doppeltem Drücken des Hotkeys wird der Effekt auf den eigenen Helden angewendet."
"DOTA_Settings_Tooltip_UnifiedOrders"	"Ist die Strg-Taste gedrückt während ein Befehl gesendet wird, so wird dieser an alle kontrollierten Einheiten gesendet."
"DOTA_Settings_Tooltip_TeleportStop"	"Bewegungs- und Zauberbefehle brechen laufende Teleportationen nicht ab. Nur Teleport Scrolls und Boots of Travel."
"DOTA_Settings_Tooltip_BroadcasterStats"	"Zeigt beim Zuschauen eines Spiels das aktuelle Statistikmenü des Kommentators."
"DOTA_Settings_Tooltip_Deceleration"	"Die Geschwindigkeit, mit der die Kamera nach einer Bewegung zum Stillstand kommt. Höhere Werte führen zu einem schnelleren Stopp."
"DOTA_Settings_Tooltip_Screenshake"	"Manche Zauber und Betäubungen lassen die Kamera wackeln."
"DOTA_Settings_Tooltip_CameraRespawn"	"Bewegt die Kamera zu Ihrem Helden bei dessen Wiederbelebung."
"DOTA_Settings_Tooltip_HideProfile"	"Ihr Dota 2-Profil wird niemandem zugänglich sein. Ihr Steam-Profil kann von Dota 2 aus nicht aufgerufen werden."
"DOTA_Settings_Tooltip_ShareMatchData"	"Stellt die Spieldaten Ihrer öffentlichen Spiele Drittanbieter-Anwendungen zur Verfügung."
"DOTA_Settings_Tooltip_NetworkQuality"	"Bei einer langsamen Internetverbindung könnte die Einstellung \\\"NIEDRIG\\\" Ihre Spielerfahrung verbessern."
"DOTA_Settings_Tooltip_MinimapSimple"	"Die Farben auf der Minikarte orientieren sich am Team und nicht an den einzelnen Spielern."
"DOTA_Settings_Tooltip_MinimapDrawHeroes"	"Wenn Sie die \"Alt\"-Taste gedrückt halten, wird anstelle des Heldennamens ein Heldensymbol in der Minikarte angezeigt."
"DOTA_Settings_Tooltip_MinimapNamesIcon"	"Immer das Heldensymbol oder den Heldennamen auf der Minikarte zeigen. Durch Drücken der \"Alt\"-Taste wird temporär X und O angezeigt."
"DOTA_Settings_Tooltip_ShopHotkeys"	"Shop-Hotkeys überschreiben alle anderen Tastenbelegungen, solange das Shopfenster geöffnet ist."
"DOTA_create_bot_practice_desc"	"Spielen Sie ein Spiel gegen Bots. Sie können das Matchmaking-System verwenden, um mit anderen menschlichen Teammitgliedern zu spielen oder die leeren Plätze in Ihrem Team mit Bots auffüllen."
"DOTA_Lobby_BotDifficulty_passive"	"Passiv"
"DOTA_Lobby_BotDifficulty_easy"	"Einfach"
"DOTA_Lobby_BotDifficulty_medium"	"Mittel"
"DOTA_Lobby_BotDifficulty_hard"	"Schwer"
"DOTA_Lobby_BotDifficulty_unfair"	"Unfair"
"DOTA_Lobby_BotTeam"	"Team wählen"
"DOTA_create_bot_practice_solo"	"Solo"
"DOTA_create_bot_practice_solo_desc"	"Üben Sie in einem lokalen Spiel gegen Bots. Matchmaking wird nicht benötigt, und Sie können das Spiel jederzeit verlassen."
"DOTA_create_bot_practice_coop"	"Koop"
"DOTA_Lobby_BotDifficulty_bot_passive"	"Passiver Bot"
"DOTA_Lobby_BotDifficulty_bot_easy"	"Einfacher Bot"
"DOTA_Lobby_BotDifficulty_bot_medium"	"Mittlerer Bot"
"DOTA_Lobby_BotDifficulty_bot_hard"	"Schwerer Bot"
"DOTA_Lobby_BotDifficulty_bot_unfair"	"Unfairer Bot"
"dota_lobby_title"	"{s:lobby_name}"
"dota_lobby_title_local_game"	"Lokale Lobby"
"dota_lobby_title_default"	"Lobby"
"lobby_row_player_name"	"{s:player_name}"
"dota_lobby_row_game_name"	"{s:game_name}"
"dota_lobby_row_slots"	"{s:slots}"
"dota_lobby_row_game_mode"	"{s:game_mode}"
"dota_lobby_row_join"	"Beitreten"
"dota_lobby_row_leave"	"Verlassen"
"dota_lobby_coaches_title"	"Mentoren"
"dota_lobby_browser_all_game_modes"	"Alle Spielmodi"
"dota_lobby_browser_num_available"	"({d:lobbies_available} verfügbar)"
"dota_lobby_browser_no_lobbies"	"Keine Lobbys gefunden"
"dota_lobby_browser_no_matching_lobbies"	"Keine Lobbys gefunden, die Ihren Suchkriterien entspechen"
"dota_lobby_browser_updating"	"Lobbyliste wird aktualisiert..."
"dota_lobby_browser_search_placeholder"	"Lobbys suchen"
"dota_lobby_browser_game_mode"	"Spielmodus"
"dota_lobby_browser_refresh"	"Aktualisieren"
"dota_lobby_browser_filter_title"	"Lobbys filtern"
"dota_lobby_submit_filter"	"Absenden"
"dota_popup_lobby_password_title"	"Lobbypasswort eingeben"
"DOTA_AttackCapability_Melee"	"Nahkampf"
"DOTA_AttackCapability_Ranged"	"Fernkampf"
"DOTA_Item_OnMarket"	"Markt"
"DOTA_Items_DefaultSet"	"Standardset"
"DOTA_Items_SetEquipped_Label"	"Ausgerüstet"
"DOTA_EquippedItem_Label"	"Ausgerüstet"
"DOTA_PreviewingItem_Label"	"Vorschau"
"DOTA_EquippedItem_Rarity"	"{s:equipped_econ_set_rarity}"
"DOTA_EquippedItem_SetName"	"{s:equipped_econ_set_name}"
"DOTA_EquippedItem_DefaultSet"	"Standardset"
"DOTA_EquippedItem_PartialSet"	"Teilset"
"DOTA_EquippedItem_Style"	"{i:equipped_econ_set_style_count} Stil(e)"
"DOTA_EquippedItem_Button_Details"	"{s:equipped_details_button_text}"
"DOTA_EquippedItem_Customize"	"Anpassen"
"DOTA_EquippedItem_CustomSet"	"Angepasstes Set"
"DOTA_EquippedItem_Equip"	"Ausrüsten"
"DOTA_EquippedItem_Unpack_And_Equip"	"Auspacken und ausrüsten"
"DOTA_EquippedItem_Details"	"{s:equipped_econ_set_type_name} - Details"
"DOTA_EquippedItem_Purchase_Button"	"Kaufen"
"DOTA_EquippedItem_Marketplace_Button"	"Markt"
"DOTA_EquippedItem_BundleName"	"Im Paket \"{s:equipped_econ_set_bundle}\""
"DOTA_EquippedItem_FilterText"	"Vorschau"
"DOTA_EquippedItem_SaleAmount"	"-{i:equipped_econ_set_sale_amount} %"
"DOTA_EquippedItem_RegularSetPrice"	"{s:equipped_econ_regular_set_price}"
"DOTA_EquippedItem_SetPrice"	"{s:equipped_econ_set_price}"
"DOTA_EquippedItem_TreasurePrice"	"{s:equipped_econ_treasure_price}"
"DOTA_HeroDemo_Button"	"{s:econ_item_category_name}-Demo"
"DOTA_HeroDemo_Button_Tooltip"	"Starten Sie den Demo-Modus, um sich dieses Gegenstandsset oder die Fähigkeiten dieses Helden anzusehen"
"DOTA_HeroDemo_Button_Return"	"Zurück zur Demo"
"DOTA_HeroDemo_Button_DBQuit"	"Demo verlassen"
"DOTA_EquippedItem_Bundle"	"Paket"
"DOTA_EquippedItem_ItemSet"	"Set"
"DOTA_EquippedItem_Item"	"Gegenstand"
"DOTA_EconItemSet_Name"	"{s:econ_set_name}"
"DOTA_EconItemSet_Rarity"	"{s:econ_set_rarity}"
"DOTA_EconItemSet_Status"	"{s:econ_set_status}"
"DOTA_EconItemSet_Price"	"{s:econ_set_price}"
"DOTA_EconItemSet_SaleAmount"	"-{i:econ_sale_amount} %"
"DOTA_EconItemSet_DeveloperOnly"	"Nicht öffentlich"
"DOTA_EconItemSet_Tooltip_InBundle"	"Dieses Set ist in einem Paket enthalten"
"DOTA_EconItemSet_Tooltip_PartialSet"	"Enthält nur einen Teil des vollständigen Gegenstandssets"
"DOTA_EconItemSet_Tooltip_MultipleStyles"	"Enthält mehrere Stile"
"DOTA_HeroRole_Carry"	"Carry"
"DOTA_HeroRole_Support"	"Support"
"DOTA_HeroRole_Nuker"	"Nuker"
"DOTA_HeroRole_Disabler"	"Disabler"
"DOTA_HeroRole_Jungler"	"Jungler"
"DOTA_HeroRole_Durable"	"Durable"
"DOTA_HeroRole_Escape"	"Escape"
"DOTA_HeroRole_LaneSupport"	"Lane Support"
"DOTA_HeroRole_Pusher"	"Pusher"
"DOTA_HeroRole_Initiator"	"Initiator"
"DOTA_HeroRole_Description_Carry"	"Wird sehr stark im späteren Verlauf des Spiels, falls bis dahin ein signifikanter Goldvorteil erlangt werden konnte."
"DOTA_HeroRole_Description_Support"	"Sollte sich weniger auf das Ansammeln von Gold und Gegenständen konzentrieren, als darauf, seine Fähigkeiten einzusetzen, um dem eigenen Team einen Vorteil zu verschaffen."
"DOTA_HeroRole_Description_Nuker"	"Kann gegnerische Helden schnell töten, da die Fähigkeiten hohen Schaden verursachen mit geringer Abklingzeit."
"DOTA_HeroRole_Description_Disabler"	"Einer oder mehrere Zauber können einen gegnerischen Helden handlungsunfähig machen."
"DOTA_HeroRole_Description_Jungler"	"Kann in der Anfangsphase des Spiels effektiv neutrale Creeps im Wald farmen."
"DOTA_HeroRole_Description_Durable"	"Hat die Fähigkeit in Kämfen länger zu überleben."
"DOTA_HeroRole_Description_Escape"	"Hat die Fähigkeit, schnell dem Tod zu entkommen."
"DOTA_HeroRole_Description_LaneSupport"	"Eignet sich in der Anfangsphase eines Spiels gut zum Schutz des Carrys des eigenen Teams, um diesem das Farmen zu ermöglichen."
"DOTA_HeroRole_Description_Pusher"	"Kann jederzeit Türme und Kasernen schnell belagern und zerstören."
"DOTA_HeroRole_Description_Initiator"	"Eignet sich gut zum Einleiten von Kämpfen."
"DOTA_HeroGrid_OptionCategory_Role"	"Rollen:"
"DOTA_HeroGrid_OptionCategory_Attributes"	"Attribute:"
"DOTA_HeroGrid_OptionCategory_AttackType"	"Angriffstyp:"
"DOTA_HeroLoadout_PreviousHeroName"	"{s:previous_hero_name}"
"DOTA_HeroLoadout_NextHeroName"	"{s:next_hero_name}"
"DOTA_HeroLoadout_CurrentHeroName"	"{s:hero_name}"
"DOTA_HeroLoadout_AttackType"	"{s:hero_attack_type}"
"DOTA_HeroLoadout_HeroFilterName"	"Held"
"DOTA_HeroLoadout_Search"	"Suche nach Gegenständen für {s:hero_name}"
"DOTA_HeroCustomize_Title"	"Helden anpassen"
"DOTA_HeroCustomize_OwnedItems"	"Gegenstände im Besitz"
"DOTA_HeroCustomize_Slot"	"Slot"
"DOTA_HeroCustomize_SlotName"	"{s:slot_name}"
"DOTA_HeroCustomize_SlotEquippedItemName"	"{s:equipped_item_name}"
"DOTA_HeroCustomize_DefaultItemName"	"Standardgegenstand"
"DOTA_HeroCustomize_PreviewItemName"	"{s:preview_item_name}"
"DOTA_HeroCustomize_PreviewStyle"	"{s:preview_style_name}"
"DOTA_HeroCustomize_PreviewItemSlot"	"{s:preview_item_slot}"
"DOTA_HeroCustomize_Rarity"	"{s:preview_item_rarity}"
"DOTA_UIEconItem_StyleIndex"	"{i:style_index}"
"dota_ready_up_num_accepted"	"{i:num_accepted} / {i:total_players} angenommen"
"returning_top_of_queue"	"Kehre zum Matchmaking mit hoher Priorität zurück..."
"GC_reconnecting"	"Verbindung zum Dota 2-Netzwerk wird wiederhergestellt..."
"GC_nosteam"	"Keine Verbindung zu Steam"
"GC_searching"	"Dota 2-Netzwerk wird gesucht..."
"GC_noconnection"	"Keine Verbindung zum Dota 2-Netzwerk."
"GC_connecting"	"Verbinde zum Dota 2-Netzwerk..."
"GC_connected"	"Verbindung mit dem Dota 2-Netzwerk hergestellt."
"GC_down"	"Der Dota 2-Spielkoordinator ist zurzeit offline."
"GC_Network_Full"	"Der Dota 2-Spielkoordinator ist zurzeit voll."
"GC_Queue_Position"	"Der Dota 2-Spielkoordinator ist zurzeit voll. Position in Warteschlange: {i:gc_queue_position}"
"GC_Queue_Wait_Time"	"Der Dota 2-Spielkoordinator ist zurzeit voll. Position in Warteschlange: {i:gc_queue_position}, geschätzte Wartezeit: {s:gc_queue_wait_time}"
"GC_Wait_Time"	"Geschätzte Wartezeit: %s1"
"GC_Wait_Time_Unknown"	"Unbekannt"
"dota_practice_vs_bots"	"Übung vs. Bots beginnen"
"dota_practice_vs_bots_desc"	"Spielen Sie eine Übungspartie gegen Bots. Es wird kein Matchmaking verwendet und Sie können die Partie jederzeit verlassen"
"dota_practice_vs_bots_team"	"Als welches Team spielen?"
"DOTA_practice_vs_bots_team_radiant"	"Radiant"
"DOTA_practice_vs_bots_team_dire"	"Dire"
"DOTA_practice_vs_bots_team_random"	"Zufällig"
"DOTA_EmoticonUpsell"	"Emoticons werden durch den Kauf bestimmter Heldengegenstände oder Ligatickets freigeschaltet."
"DOTA_CurrentTime"	"{t:t:current_time}"
"DOTA_MonthlyPlayers"	"{s:users_last_month}"
"DOTA_MonthlyPlayersLabel"	"Spieler im letzten Monat"
"DOTA_CurrentPlayers"	"{s:current_users}"
"DOTA_Search_NoResults"	"Keine Ergebnisse"
"DOTA_Search_ItemShortDescription"	"<span class=\"ItemRarityColor\">{s:item_rarity}</span> {s:item_slot}"
"join_error_already_in_game"	"Beitreten der Übungslobby nicht möglich, da Sie sich bereits in einem Spiel befinden."
"join_error_generic"	"
"
"join_error_in_team_party"	"Übungslobby kann nicht beigetreten werden. Sie müssen Ihre Teamgruppe zuerst auflösen, bevor Sie einem Übungsspiel beitreten können."
"join_error_lobby_full"	"Lobby ist voll."
"DOTA_Friends_Ready_To_Play"	"Offene Spiele"
"DOTA_Friend_In_Match"	"Im Spiel"
"DOTA_Friend_Solo_Open_Party"	"{s:player_name} möchte spielen"
"DOTA_Friend_In_Party_Open"	"{s:player_name} ist in einer offenen Gruppe"
"DOTA_Friend_Solo_Open_Party_Self"	"Sie suchen nach Gruppenmitgliedern"
"DOTA_Friend_In_Open_Party_Self"	"Sie sind in einer offenen Gruppe"
"DOTA_Friends_In_Party_Open"	"{d:num_friends} Freunde in offenen Gruppen"
"DOTA_Friend_Lobby_Mode_Self"	"Sie sind in einer \"{s:game_mode}\"-Lobby"
"DOTA_Friend_Lobby_Mode_1_Friend"	"{s:player_name} in \"{s:game_mode}\"-Lobbys"
"DOTA_Friend_Lobby_Mode_N_Friends"	"{d:num_friends} Freunde in \"{s:game_mode}\"-Lobbys"
"DOTA_Friend_Lobby_Mode_Small"	"\"{s:game_mode}\"-Lobby"
"DOTA_Friend_Lobby_Players"	"{d:player_count} / {d:max_player_count}"
"DOTA_Friend_Lobby_Join_Button"	"{s:join_button_text}"
"DOTA_Friend_Lobby_Friend_Count"	"+{d:extra_friend_count}"
"DOTA_Friend_Invite_To_Party"	"In Gruppe einladen"
"DOTA_Friend_SuggestInviteToParty"	"Gruppeneinladung vorschlagen"
"DOTA_Feed_Timestamp_Recently"	"Gerade eben"
"DOTA_Feed_Timestamp_MinutesAgo"	"vor {i:value} Minuten"
"DOTA_Feed_Timestamp_HourAgo"	"vor {i:value} Stunde"
"DOTA_Feed_Timestamp_HoursAgo"	"vor {i:value} Stunden"
"DOTA_Feed_Timestamp_Yesterday"	"Gestern"
"DOTA_Feed_Timestamp_Date"	"{s:day} {s:month}"
"dota_lobby_type_general"	"Ungewertet"
"dota_lobby_type_practice"	"Übungsspiel"
"dota_lobby_type_practice_game_mode_custom"	"Angepasstes Spiel"
"dota_lobby_type_tournament"	"Turnierspiel"
"dota_lobby_type_coop_bot"	"Koop-Bot"
"dota_lobby_type_competitive"	"Ranglistenspiel"
"dota_lobby_type_casual_1v1"	"1 vs 1-Partie"
"dota_lobby_unknown"	"Unbekannt"
"DOTA_Lobby_No_Players_Title"	"KEINE SPIELER IN EINEM TEAM"
"DOTA_Lobby_No_Players_Desc"	"Es muss mindestens ein Spieler im Radiant- oder Dire-Team sein."
"dota_match_result_won"	"Gewonnen"
"dota_match_result_lost"	"Verloren"
"dota_match_result_none"	"???"
"dota_social_feed_loading"	"Ladevorgang läuft..."
"DOTA_LoadingPlayerUnknown"	"-"
"DOTA_LoadingPlayerLoading"	"Ladevorgang läuft..."
"DOTA_LoadingPlayerFullyConnected"	"Bereit"
"DOTA_LoadingPlayerFailed"	"Fehlgeschlagen"
"LoadingScreenTimer"	"{t:d:countdown_timer_seconds}"
"HeroSelectionTimer"	"{i:timer_seconds}"
"LoadingScreenMapInfo"	"Karte: {s:map_name}"
"LoadingScreenPlayersInfo"	"Spieler: {i:players_loaded}/{i:players_total}"
"LoadingScreenSpectatorsInfo"	"Zuschauer: {i:spectators_loaded}/{i:spectators_total}"
"custom_end_screen_victory_message"	"Sieg für {s:winning_team_name}"
"custom_end_screen_legend_player"	"Spieler"
"custom_end_screen_legend_level"	"Level"
"custom_end_screen_legend_hero"	"Held"
"custom_end_screen_legend_kills"	"K"
"custom_end_screen_legend_assists"	"A"
"custom_end_screen_legend_items"	"Gegenstände"
"custom_end_screen_legend_gold"	"Gold"
"custom_end_screen_legend_team_score"	"Punkte"
"custom_scoreboard_hero_name_and_desc"	"Lvl {i:hero_level} {s:hero_name}"
"CustomEndScreenClose"	"Schließen"
"DOTA_Armory_Category_Heroes"	"Helden"
"DOTA_Armory_Category_Couriers"	"Kuriere"
"DOTA_Armory_Category_Pets"	"Haustiere"
"DOTA_Armory_Category_World"	"Welt"
"DOTA_Armory_Category_Wards"	"Wards"
"DOTA_Armory_Category_Weather"	"Wettereffekte"
"DOTA_Armory_Category_Effigies"	"Statuen"
"DOTA_Armory_Category_Interface"	"Oberfläche"
"DOTA_Armory_Category_Emoticons"	"Emoticons"
"DOTA_Armory_Category_LoadingScreens"	"Ladebildschirme"
"DOTA_Armory_Category_HUDs"	"HUDs"
"DOTA_Armory_Category_CursorPacks"	"Cursorpakete"
"DOTA_Armory_Category_Audio"	"Audio"
"DOTA_Armory_Category_VoicePacks"	"Sprachpakete"
"DOTA_Armory_Category_AnnouncerPacks"	"Ansagerpakete"
"DOTA_Armory_Category_Music"	"Musik"
"DOTA_Armory_Category_All"	"Alle"
"DOTA_Armory_Category_Other"	"Sonstiges"
"DOTA_Armory_Category_View"	"Gruppenansicht"
"DOTA_Armory_Filter"	"Filter festlegen"
"DOTA_Armory_SortBy"	"Sortieren nach:"
"DOTA_Armory_SortBy_Rarity"	"Seltenheit"
"DOTA_Armory_SortBy_Quality"	"Qualität"
"DOTA_Armory_SortBy_Name"	"Name"
"DOTA_Armory_SortBy_Recent"	"Kaufdatum"
"DOTA_Armory_SortBy_Sockets"	"Anzahl der Fassungen"
"DOTA_Armory_Search"	"Nach Arsenalgegenständen suchen"
"DOTA_Armory_ContextMenu_Preview"	"Gegenstandsvorschau"
"DOTA_Armory_ContextMenu_PreviewSet"	"Setvorschau"
"DOTA_Armory_ContextMenu_Equip"	"Ausrüsten"
"DOTA_Armory_ContextMenu_Unequip"	"Ablegen"
"DOTA_Armory_ContextMenu_Socketing"	"Einfassen"
"DOTA_Armory_ContextMenu_GiftWrap"	"Als Geschenk verpacken"
"DOTA_Armory_ContextMenu_Delete"	"Löschen"
"dota_page_match_details_loading"	"Partie wird geladen..."
"dota_page_match_details_victory"	"Sieger: {s:winner}"
"dota_page_match_details_legend_player"	"Spieler"
"dota_page_match_details_legend_level"	"Level"
"dota_page_match_details_legend_hero"	"Held"
"dota_page_match_details_legend_deaths"	"T"
"dota_page_match_details_legend_items"	"Gegenstände"
"dota_page_match_details_legend_gold"	"Gold"
"dota_page_match_details_header_league_name"	"Liganame"
"dota_page_match_details_header_custom_game_map_name"	"Kartenname"
"dota_page_match_details_header_match_id"	"Spiel-ID"
"dota_page_match_details_header_game_mode"	"Spielmodus"
"dota_page_match_details_header_duration"	"Dauer"
"dota_page_match_details_header_timestamp"	"Datum / Zeit"
"dota_page_match_details_voting_votes"	"{i:num_votes} Stimmen"
"dota_page_match_details_match_discussion"	"Partiediskussion"
"dota_page_match_details_comment_placeholder"	"Kommentar verfassen..."
"dota_page_match_details_comment_loading_comments"	"Kommentare werden geladen..."
"dota_page_match_details_comment_no_comments"	"Zu dieser Partie wurden keine Kommentare verfasst"
"dota_page_match_details_replay_existence_unknown"	"Suche nach Aufnahme..."
"dota_page_match_details_replay_existence_cdn_found"	"Aufnahme herunterladen"
"dota_page_match_details_replay_existence_not_found"	"Aufnahme nicht verfügbar"
"dota_page_match_details_replay_existence_downloading"	"Download läuft..."
"dota_page_match_details_replay_existence_disk_found_replay"	"Aufnahme anschauen"
"dota_page_match_details_replay_existence_disk_found_highlights"	"Highlights anschauen"
"dota_page_match_details_replay_existence_wrong_engine"	"Source 1-Aufnahmen sind in Source 2 nicht verfügbar"
"dota_profile_content_tab_activity_feed"	"Aktivitäten-Feed"
"dota_profile_content_tab_recent_games"	"Letzte Spiele"
"dota_profile_recent_games_option_show_practice_matches"	"Übungsspiele anzeigen"
"dota_profile_recent_game_header_timestamp"	"Datum / Zeit"
"dota_profile_recent_game_header_hero_name"	"Gespielter Held"
"dota_profile_recent_game_header_result"	"Ergebnis"
"dota_profile_recent_game_header_duration"	"Dauer"
"dota_profile_recent_game_header_type"	"Typ"
"dota_profile_recent_game_result_win"	"Sieg"
"dota_profile_recent_game_result_loss"	"Niederlage"
"dota_profile_recent_game_result_abandon"	"Aufgabe"
"dota_profile_recent_game_icon_source1"	"S1"
"dota_profile_hero_with_index"	"{d:hero_index} {s:hero_name}"
"dota_profile_hero"	"{s:hero_name}"
"dota_replay_manager_error_not_found"	"Aufnahme konnte im CDN nicht gefunden werden."
"dota_replay_manager_error_chunk_failed"	"Fehler beim Herunterladen der Aufnahmedatei."
"DOTA_tooltip_econ_item_name"	"{s:item_name}"
"DOTA_tooltip_econ_item_description"	"{s:item_description}"
"DOTA_tooltip_econ_item_rarity_label"	"Seltenheit: "
"DOTA_tooltip_econ_item_rarity"	"{s:item_rarity}"
"DOTA_tooltip_econ_item_slot"	"Slot: {s:item_slot}"
"DOTA_tooltip_econ_item_gifter"	"{g:dota_persona:gifter_name}"
"DOTA_tooltip_econ_item_gift_received_date"	"Erhalten: {t:T:gift_received_date_time}"
"DOTA_tooltip_econ_item_trade_restriction_permanent"	"Nicht handelbar"
"DOTA_tooltip_econ_item_trade_restriction_date"	"Nicht handelbar bis: {t:T:tradable_after_date_time} {t:s:tradable_after_date_time}"
"DOTA_tooltip_econ_item_market_restriction_permanent"	"Nicht marktfähig"
"DOTA_tooltip_econ_item_gift_restriction_permanent"	"Nicht verschenkbar"
"DOTA_tooltip_econ_item_gift_restriction_date"	"Nicht verschenkbar bis: {t:T:giftable_after_date_time} {t:s:giftable_after_date_time}"
"DOTA_tooltip_econ_item_gem_type"	"{s:gem_type}"
"DOTA_tooltip_econ_item_gem_strange_count"	"{d:strange_count}"
"DOTA_tooltip_econ_item_gem_description"	"{s:gem_description}"
"DOTA_tooltip_econ_item_partner"	"{s:partner}"
"DOTA_econ_item_details_item_name"	"{s:item_name}"
"DOTA_econ_item_details_item_creation_date"	"ERSTELLUNGSDATUM: {t:l:creation_date}"
"DOTA_econ_item_details_set_includes"	"Beinhaltet Folgendes:"
"DOTA_econ_item_details_item_set"	"Teil von: <font color='#dddddd'>{s:item_set}</font>"
"DOTA_econ_item_details_rarity_label"	"Seltenheit: "
"DOTA_econ_item_details_item_rarity"	"{s:item_rarity}"
"DOTA_econ_item_details_item_slot"	"Slot: {s:item_slot}"
"DOTA_econ_item_details_item_description"	"{s:item_description}"
"DOTA_econ_item_details_gem_type"	"{s:gem_type}"
"DOTA_econ_item_details_gem_strange_count"	"{d:strange_count}"
"DOTA_econ_item_details_gem_description"	"{s:gem_description}"
"DOTA_Treasure_Name"	"{s:treasure_name}"
"DOTA_Treasure_Rarity"	"<span class=\"ItemRarityColor\">{s:treasure_rarity}</span>-Schatz"
"DOTA_Voice_Party"	"Sprachgruppe"
"custom_game_team_select"	"Teamauswahl"
"custom_game_team_select_timer"	"{i:countdown_timer_seconds}"
"custom_game_team_select_shuffle"	"Mischen"
"custom_game_team_select_auto_start"	"Auto-Start"
"custom_game_team_select_starting"	"Starten"
"custom_game_team_select_unassigned_players"	"Nicht zugewiesen"
"custom_game_team_select_lock_start"	"Schließen + Starten"
"custom_game_team_select_cancel_unlock"	"Abbrechen + Freischalten"
"custom_game_team_select_join"	"Beitreten"
"custom_game_team_select_empty_slot"	"Leerer Slot"
"custom_game_team_select_auto_assign"	"Autom. zuweisen"
"custom_game_default_gameinfo_text"	"Kommen Sie bald wieder, um mehr Informationen über dieses angepasste Spiel zu erhalten!"
"CouldntFindCompendium"	"Die Kompendium-Testdatei konnte nicht geladen werden: {s:s1}"
"CompendiumPageError_Unknown"	"Interner Kompendium-Logikfehler. Kontaktieren Sie Valve, um dies zu beheben."
"DOTA_GlobalItems_Couriers"	"Kuriere"
"DOTA_GlobalItems_World"	"Welt"
"DOTA_GlobalItems_Wards"	"Wards"
"DOTA_GlobalItems_Effigies"	"Statuen"
"DOTA_GlobalItems_Weather"	"Wettereffekte"
"DOTA_GlobalItems_Interface"	"Oberfläche"
"DOTA_GlobalItems_Emoticons"	"Emoticons"
"DOTA_GlobalItems_LoadingScreens"	"Ladebildschirme"
"DOTA_GlobalItems_HUDs"	"HUDs"
"DOTA_GlobalItems_Audio"	"Audio"
"DOTA_GlobalItems_Announcers"	"Ansagerpakete"
"DOTA_GlobalItems_Music"	"Musik"
"DOTA_Search"	"Suchen"
"DOTA_Start"	"Start"
"DOTA_PleaseWait"	"Bitte warten..."
"DOTA_ChatTab_ToggleSounds"	"Ton abspielen, wenn in diesem Kanal eine Nachricht eingeht."
"dota_lobby_balanced_shuffle"	"Teams ausgleichen"
"dota_lobby_swap_teams"	"Teams tauschen"
"dota_lobby_unassigned_players"	"Nicht zugewiesene Spieler"
"dota_lobby_broadcast_channels"	"Zwischen Übertragungskanälen wechseln"
"dota_lobby_settings"	"Lobbyeinstellungen"
"dota_lobby_settings_edit"	"Bearbeiten"
"dota_lobby_leave"	"Lobby verlassen"
"DOTA_Custom_Game_View_Lobby_List"	"Lobbyliste anzeigen"
"DOTA_Custom_Game_Lobby_List_Title"	"Lobbyliste"
"DOTA_Custom_Game_Browse_All"	"Alle Spiele anzeigen"
"DOTA_Custom_Game_Friends_Who_Play"	"Freunde, die spielen"
"DOTA_Custom_Game_Friends_Playing_Now"	"Freunde, die im Spiel sind"
"DOTA_Custom_Game_Browse_Sort"	"Sortieren:"
"DOTA_Custom_Game_Sort_Popular_Today"	"Bestbewertete (Heute)"
"DOTA_Custom_Game_Sort_Popular_Week"	"Bestbewertete (Diese Woche)"
"DOTA_Custom_Game_Sort_Top_Rated"	"Bestbewertete (Aller Zeiten)"
"DOTA_Custom_Game_Sort_Date"	"Veröffentlichungsdatum"
"DOTA_WatchLive_Steam"	"STEAM"
"DOTA_WatchLive_InGame"	"IM SPIEL"
"DOTA_WatchLive_Broadcaster1"	"{g:dota_persona:b:broadcaster_account_id_1} zuschauen"
"DOTA_WatchLive_Broadcaster2"	"{g:dota_persona:b:broadcaster_account_id_2} zuschauen"
"DOTA_WatchLive_Broadcaster3"	"{g:dota_persona:b:broadcaster_account_id_3} zuschauen"
"DOTA_WatchLive_Broadcaster4"	"{g:dota_persona:b:broadcaster_account_id_4} zuschauen"
"DOTA_WatchLive_Broadcaster5"	"{g:dota_persona:b:broadcaster_account_id_5} zuschauen"
"DOTA_WatchLive_Broadcaster6"	"{g:dota_persona:b:broadcaster_account_id_6} zuschauen"
"DOTA_WatchLive_Broadcaster7"	"{g:dota_persona:b:broadcaster_account_id_7} zuschauen"
"DOTA_WatchLive_Broadcaster8"	"{g:dota_persona:b:broadcaster_account_id_8} zuschauen"
"DOTA_WatchLive_Broadcaster9"	"{g:dota_persona:b:broadcaster_account_id_9} zuschauen"
"dota_matchmaking_region_title_confirm"	"Macthmaking-Regionen bestätigen"
"dota_play_lobby_games"	"Lobbys anzeigen"
"dota_play_connecting_to_server"	"Wird verbunden..."
"dota_reconnecting"	"Wird wiederverbunden..."
"dota_matchmaking_region_ping_calculating"	"Ping: Wird ermittelt..."
"dota_matchmaking_region_or"	"oder"
"dota_matchmaking_region_selected_unreachable"	"Verbindung zu den ausgewählten Regionen konnte nicht bestätigt werden."
"dota_matchmaking_region_all_unavailable"	"Es konnte keine Region erfolgreich angepingt werden. Überprüfen Sie bitte Ihre Internetverbindung."
"dota_matchmaking_region_check_internet"	"Überprüfen Sie bitte Ihre Internetverbindung."
"dota_settings_fullscreenbrightness"	"Helligkeit"
"dota_settings_dashboard_renderquality"	"Hochqualitatives Dashboard"
"dota_settings_lowlatency_audio"	"Audiolatenz automatisch erkennen"
"dota_settings_quicktargetattack"	"Schnellangriff"
"dota_lobby_browser_header_name"	"Lobbyname"
"dota_lobby_browser_header_slots"	"Slots"
"dota_lobby_browser_header_game_mode"	"Spielmodus"
"dota_lobby_browser_region"	"Region"
"dota_lobby_browser_lobby_name"	"Lobbyname"
"DOTA_Friend_Game_Mode_Self"	"Sie spielen {s:game_mode}"
"DOTA_Friend_Game_Mode_1_Friend"	"{s:player_name} spielt {s:game_mode}"
"DOTA_Friend_Game_Mode_N_Friends"	"{d:num_friends} Freunde spielen {s:game_mode}"
"Compendium_DefaultText_CD_Days"	"Tage"
"Compendium_DefaultText_CD_Hours"	"Stunden"
"Compendium_DefaultText_CD_Minutes"	"Minuten"
"Compendium_DefaultText_CD_Seconds"	"Sekunden"
"NetGraph_FPS"	"FPS: {d:fps}"
"NetGraph_Ping"	"Ping: {d:ping}ms"
"DOTA_Credits"	"Danksagungen"
"DOTA_ActorCredits_1_Name"	"Dee Bradley Baker"
"DOTA_ActorCredits_1_Heroes"	"Techies"
"DOTA_ActorCredits_2_Name"	"Dennis Bateman"
"DOTA_ActorCredits_2_Heroes"	"Invoker"
"DOTA_ActorCredits_3_Name"	"Tom Chantler"
"DOTA_ActorCredits_3_Heroes"	"Centaur, Lion, Obsidian Destroyer, Riki, Slark, Tusk, Witch Doctor"
"DOTA_ActorCredits_4_Name"	"Merle Dandridge"
"DOTA_ActorCredits_4_Heroes"	"Legion Commander, Winter Wyvern"
"DOTA_ActorCredits_5_Name"	"Barry Dennen"
"DOTA_ActorCredits_5_Heroes"	"Chaos Knight, Phantom Lancer, Rubick"
"DOTA_ActorCredits_6_Name"	"Dave Fennoy"
"DOTA_ActorCredits_6_Heroes"	"Batrider, Ember Spirit, Faceless Void, Jakiro, Venomancer, Skeleton King"
"DOTA_ActorCredits_7_Name"	"Jim French"
"DOTA_ActorCredits_7_Heroes"	"Elder Titan"
"DOTA_ActorCredits_8_Name"	"Michael Gregory"
"DOTA_ActorCredits_8_Heroes"	"Bounty Hunter, Clinkz, Silencer"
"DOTA_ActorCredits_9_Name"	"Gin Hammond"
"DOTA_ActorCredits_9_Heroes"	"Crystal Maiden, Drow Ranger, Enchantress, Mirana, Phantom Assassin, Spectre, Vengeful Spirit"
"DOTA_ActorCredits_10_Name"	"John Patrick Lowrie"
"DOTA_ActorCredits_10_Heroes"	"Ancient Apparition, Dark Seer, Doom Bringer, Earthshaker, Pudge, Nevermore, Storm Spirit"
"DOTA_ActorCredits_11_Name"	"Ellen McLain"
"DOTA_ActorCredits_11_Heroes"	"Broodmother, Death Prophet"
"DOTA_ActorCredits_12_Name"	"Bruce Miles"
"DOTA_ActorCredits_12_Heroes"	"Alchemist, Life Stealer, Omniknight"
"DOTA_ActorCredits_13_Name"	"Linda K. Morris"
"DOTA_ActorCredits_13_Heroes"	"Luna, Naga Siren, Queen of Pain, Templar Assassin"
"DOTA_ActorCredits_13_Extra"	"Ansager"
"DOTA_ActorCredits_14_Name"	"Sam A. Mowry"
"DOTA_ActorCredits_14_Heroes"	"Anti-Mage, Beastmaster, Rattletrap, Necrolyte, Slardar, Warlock"
"DOTA_ActorCredits_14_Extra"	"Secret Shopkeeper"
"DOTA_ActorCredits_15_Name"	"Eric Newsome"
"DOTA_ActorCredits_15_Heroes"	"Chen, Leshrac, Furion, Razor, Tidehunter, Tiny, Zuus"
"DOTA_ActorCredits_16_Name"	"Nolan North"
"DOTA_ActorCredits_16_Heroes"	"Brewmaster, Earth Spirit, Gyrocopter, Keeper of the Light, Lone Druid, Lycan, Meepo, Ogre Magi, Shadow Demon, Troll Warlord"
"DOTA_ActorCredits_17_Name"	"Dempsey Pappion"
"DOTA_ActorCredits_17_Heroes"	"Magnataur, Nyx Assassin, Visage"
"DOTA_ActorCredits_18_Name"	"TJ Ramini"
"DOTA_ActorCredits_18_Heroes"	"Abaddon, Bristleback, Skywrath Mage, Shredder"
"DOTA_ActorCredits_19_Name"	"Harry S. Robins"
"DOTA_ActorCredits_19_Heroes"	"Tinker"
"DOTA_ActorCredits_20_Name"	"Gary Schwartz"
"DOTA_ActorCredits_20_Heroes"	"Lich, Pugna"
"DOTA_ActorCredits_21_Name"	"David Scully"
"DOTA_ActorCredits_21_Heroes"	"Bane, Dazzle, Juggernaut, Morphling, Sand King, Sven, Weaver"
"DOTA_ActorCredits_22_Name"	"Mike Shapiro"
"DOTA_ActorCredits_22_Heroes"	"Oracle"
"DOTA_ActorCredits_23_Name"	"David Sobolov"
"DOTA_ActorCredits_23_Heroes"	"Terrorblade"
"DOTA_ActorCredits_24_Name"	"Jon St. John"
"DOTA_ActorCredits_24_Heroes"	"Axe, Bloodseeker, Enigma, Kunkka"
"DOTA_ActorCredits_25_Name"	"Fred Tatasciore"
"DOTA_ActorCredits_25_Heroes"	"Disruptor, Spirit Breaker, Treant, Undying, Ursa"
"DOTA_ActorCredits_25_Extra"	"Warlock's Golem"
"DOTA_ActorCredits_26_Name"	"Jen Taylor"
"DOTA_ActorCredits_26_Heroes"	"Lina, Medusa, Puck, Windranger"
"DOTA_ActorCredits_27_Name"	"Tony Todd"
"DOTA_ActorCredits_27_Heroes"	"Dragon Knight, Night Stalker, Viper"
"DOTA_ActorCredits_28_Name"	"
"
"DOTA_ActorCredits_28_Heroes"	"
"
"DOTA_PlayerContextMenu_Trade"	"Zum Handeln einladen"
"DOTA_Custom_Game_Finished_Vote_Skip"	"Überspringen"
"DOTA_TabName_ModsLobbyList"	"Lobbyliste"
"DOTA_WatchLive_Fullscreen"	"VOLLBILD"
"DOTA_JoinChatChannel_ChannelName"	"Kanalname"
"DOTA_JoinChatChannel_ChannelMemberCount"	"Mitglieder"
"DOTA_Chat_ChannelMemberCount"	"{d:channel_member_count}"
"dota_settings_coop_fullscreen"	"Desktopfreundlicher Vollbildmodus"
"DOTA_Trading_UI_Body_Outgoing"	"Warten auf Antwort von {s:player_name} auf Ihre Anfrage..."
"DOTA_GiftWrap_Item"	"{g:dota_item_name:gift_item_def} wird als Geschenk verpackt."
"DOTA_GiftWrap_ConfirmDedication_Title"	"Widmung bestätigen"
"DOTA_GiftWrap_Success_Header"	"Erfolg"
"DOTA_GiftWrap_Success"	"Ihr Geschenk wurde übergeben."
"DOTA_Custom_Game_Sort_Most_Played"	"Am beliebtesten (Diese Woche)"
"dota_settings_fullscreen_focus_behavior"	"Der Desktop-freundliche Vollbildmodus minimiert das Spiel bei Fokusverlust"
"DOTA_RecyclingCharm_Bonus"	"+25 Kompendium-Münzen"
"DOTA_Previous"	"Zurück"
"DOTA_PreviousShort"	"Zurück"
"DOTA_Next"	"Weiter"
"DOTA_Friends_Add_Friend_Tooltip"	"Freund hinzufügen"
"DOTA_Friends_Add_Friend_Your_ID"	"Ihre Freund-ID lautet:"
"DOTA_EconItemSet_Tooltip_MultipleTeams"	"Besitzt verschiedene Stile für Radiant und Dire"
"DOTA_Armory_ActiveFilter"	"{s:filter_field} {s:filter_op} {s:filter_value}"
"DOTA_Treasure_Purchase"	"Schatz kaufen"
"DOTA_Treasure_SearchPlaceholder"	"Nach Schätzen suchen"
"DOTA_Treasure_ViewAll"	"Alle Schätze anzeigen"
"DOTA_Treasure_OpenQuantity"	"{d:owned_quantity}"
"DOTA_Treasure_Owned"	"In Besitz"
"DOTA_Treasure_Received"	"Erhalten"
"DOTA_Treasure_Autographed"	"Autogramm:"
"DOTA_Treasure_AutographName"	"{s:treasure_autograph_name}"
"DOTA_OpenTreasureTooltip_ItemName"	" - {g:dota_item_name:item_def}"
"dota_profile_content_tab_official_info"	"Pro-Informationen"
"dota_profile_oi_player_name"	"ANZEIGENAME"
"dota_profile_oi_player_name_sub"	"Er sollte für Spieler aus der ganzen Welt wiedererkennbar sein und keine Team- oder Sponsorenzugehörigkeiten beinhalten."
"dota_profile_oi_team"	"TEAM"
"dota_profile_oi_team_sub"	"Bitte auswählen, falls Sie öffentlich für ein Dota-Team spielen. Das Kürzel dieses Teams wird vor Ihren Namen gestellt."
"dota_profile_oi_sponsor"	"SPONSOR"
"dota_profile_oi_country"	"LAND"
"dota_profile_oi_role"	"ROLLE"
"dota_profile_oi_role_sub"	"Wenn Sie eine bestimmte Rolle spielen, wählen Sie sie bitte aus. Core umfasst Spieler, die Carry, Mid- und Off-Lane spielen."
"dota_profile_oi_preview"	"So wird Ihr Name in Ranglisten und Ligaspielen angezeigt:"
"dota_profile_oi_preview_warning"	"Diese Information kann nur alle zwei Wochen geändert werden. Stellen Sie also sicher, dass sie korrekt ist, bevor Sie sie aktualisieren!"
"dota_profile_oi_submit_success"	"Erfolgreich!"
"dota_profile_oi_submit_failure"	"Fehler - Bitte erneut versuchen."
"dota_role_core"	"Core"
"dota_role_support"	"Support"
"Compendium_GenerateFail"	"Ressourcendatei \"{s:s1}\" konnte nicht generiert werden."
"Compendium_PublishError"	"\"{s:s1}\" konnte nicht in Kompendium-Ordner \"{s:s2}\" kopiert werden."
"Compendium_PublishFinishedTitle"	"Veröffentlichung erfolgreich"
"DOTA_SortOption_Price"	"Preis"
"DOTA_BadgeLevel"	"{d:badge_level}"
"DOTA_AHC_CurrentHero"	"Derzeitiger Held"
"DOTA_AHC_CurrentHeroName"	"{s:current_hero_name}"
"DOTA_AHC_NextHero"	"Nächster Held"
"DOTA_AHC_NextHeroName"	"{s:next_hero_name}"
"DOTA_AHC_HeroesCompletedValue"	"{d:heroes_completed} / {d:heroes_total}"
"DOTA_AHC_FullChallengesCompleted"	"Abgeschlossene Durchläufe:"
"DOTA_AHC_FullChallengesCompletedValue"	"{d:full_challenges_completed}"
"DOTA_AHC_BestFullChallenge"	"Bester Durchlauf"
"DOTA_AHC_FullChallengeAverage"	"Globaler Durchschnitt"
"DOTA_AHC_FullChallengeAverageValue"	"{s:full_challenge_average} Spiele"
"DOTA_AHC_ChallengeTrophyName"	"{s:challenge_trophy_name}"
"DOTA_Trophies_ViewEarned"	"Erreicht"
"DOTA_ItemSet_Count_text"	"{d:item_current_group} / {d:item_group_count}"
"DOTA_Custom_Game_Map_AnyNumbered"	"Zufällig ({d:map_choices})"
"dota_settings_enable_console"	"Konsole aktivieren"
"dota_settings_enable_console_tooltip"	"Wenn Sie Startparameter wie -dev oder -console haben, welche die Konsole öffnen, überschreiben sie diese Einstellung"
"DOTA_EffigyEditor_Animation"	"Animation:"
"DOTA_EffigyEditor_Frame"	"Frame auswählen:"
"DOTA_EffigyEditor_Error"	"Erstellen der Heldenstatue fehlgeschlagen."
"DOTA_EffigyEditor_ErrorPose"	"Posieren der Heldenstatue ist fehlgeschlagen."
"DOTA_EffigyEditor_Success"	"Ihre Heldenstatue wurde erfolgreich erstellt."
"DOTA_EffigyEditor_SuccessReforge"	"Ihre Heldenstatue wurde erfolgreich neu geschmiedet."
"DOTA_tooltip_econ_item_modifier_HUD"	"HUD"
"DOTA_tooltip_econ_item_modifier_weather"	"Wetter"
"DOTA_tooltip_econ_item_modifier_sound"	"Sound"
"Compendium_Error"	"Kompendium-Fehler"
"Compendium_level"	"LEVEL"
"DOTA_Workshop_TextureName_color"	"Farbe"
"DOTA_Workshop_TextureName_selfillummask"	"Selbstbeleuchtungsmaske"
"DOTA_Workshop_SaveSettings"	"Einstellungen speichern"
"DOTA_Workshop_LoadSettings"	"Einstellungen laden"
"DOTA_Workshop_Optional"	"Optional"
"DOTA_Workshop_Required"	"Erforderlich"
"DOTA_UI_LoadScreen_16_9"	"16:9"
"DOTA_UI_LoadScreen_16_10"	"16:10"
"DOTA_UI_LoadScreen_4_3"	"4:3"
"DOTA_Workshop_ImportChatEmoticon_Preview"	"Vorschau"
"DOTA_Workshop_Preview_Skin"	"Textur:"
"DOTA_Workshop_LD_Trueform_AbilityUlt_Desc"	"In die Druid-Form zurückverwandeln. Insgesamt 70 Frames, sollte bei Frame 58 im Boden verschwinden."
"DOTA_Workshop_BackgroundColor"	"Hintergrundfarbe"
"DOTA_Workshop_BackgroundTexture"	"Hintergrundtextur"
"DOTA_Workshop_Camera"	"Kamera"
"DOTA_Workshop_GameDay"	"Tag"
"DOTA_Workshop_GameNight"	"Nacht"
"DOTA_Workshop_PreviewInGame"	"Vorschau im Spiel"
"DOTA_Workshop_SpotLight"	"Spotlight"
"DOTA_Workshop_SpotlightSize"	"Spotlight-Größe"
"DOTA_Workshop_Texture"	"Textur"
"DOTA_Workshop_Err_InvalidFile"	"Ungültige Datei: \"%1\""
"DOTA_Workshop_LoadSession"	"Sitzung laden"
"DOTA_Workshop_SaveSession"	"Sitzung speichern"
"DOTA_Event_Level"	"Level"
"DOTA_View_Details"	"Details anzeigen"
"DOTA_TabName_Heroes"	"Helden"
"DOTA_Friends_ID"	"Freund-ID:"
"DOTA_Profile_Edit"	"Profil bearbeiten"
"DOTA_Profile_ViewSteamProfile"	"Steam-Profil anzeigen"
"DOTA_Profile_SendMessage"	"Nachricht senden"
"DOTA_Trophies_ViewAvailable"	"Verfügbar"
"DOTA_Lobby_Settings_Tournament"	"Liga"
"DOTA_WatchReplays_Game1"	"Spiel 1"
"DOTA_WatchReplays_Game2"	"Spiel 2"
"DOTA_WatchReplays_Game3"	"Spiel 3"
"DOTA_WatchReplays_Game4"	"Spiel 4"
"DOTA_WatchReplays_Game5"	"Spiel 5"
"DOTA_WatchTournaments_PrizePoolLabel"	"Preisgeld"
"DOTA_WatchTournaments_PrizePoolTicketPrice"	"Ticket {g:dota_item_price:ticket_itemdef}"
"DOTA_WatchTournaments_PrizePoolActivate"	"Ticket aktivieren"
"DOTA_WatchTournaments_Region_NA"	"Nordamerika"
"DOTA_WatchTournaments_Region_SA"	"Südamerika"
"DOTA_WatchTournaments_Region_EU"	"Europa"
"DOTA_WatchTournaments_Region_RU"	"Russland"
"DOTA_WatchTournaments_Region_CN"	"China"
"DOTA_WatchTournaments_Region_SEA"	"Südostasien"
"DOTA_WatchTournament_BestOf3"	"Best-of-Three"
"DOTA_WatchTournament_BestOf5"	"Best-of-Five"
"DOTA_WatchTournament_Compendium"	"Kompendium anzeigen"
"DOTA_WatchTournament_Page"	"Seite {i:page_cur} / {i:page_max}"
"DOTA_WatchTournament_Spectators"	"{i:spectators} Zuschauer"
"DOTA_EquippedItem_Button_SingleItemShuffle"	"Ausrüsten"
"DOTA_Armory_Category_Charms"	"Amulette"
"DOTA_Armory_Category_Treasures"	"Schätze"
"DOTA_Armory_Category_Gifts"	"Geschenke"
"DOTA_Armory_Category_Bundles"	"Pakete"
"DOTA_Armory_Category_Compendiums"	"Kompendien"
"DOTA_Armory_Category_Tools"	"Werkzeuge"
"DOTA_Armory_ActiveFilterLabel"	"Filter:"
"DOTA_Armory_EditFilter"	"Filter ändern"
"DOTA_Armory_Filter_Tradeable"	"HANDELBAR"
"DOTA_Armory_Filter_Equipped"	"AUSGERÜSTET"
"DOTA_Armory_Filter_Duplicate"	"DUPLIKAT"
"DOTA_Armory_Filter_WillExpire"	"LÄUFT AUS"
"DOTA_Armory_Filter_IsBundle"	"PAKET"
"DOTA_Armory_Filter_Rarity"	"SELTENHEIT"
"DOTA_Armory_Filter_Quality"	"QUALITÄT"
"DOTA_Armory_Filter_Tags"	"TAGS"
"DOTA_Armory_Filter_Delete"	"Filter löschen"
"DOTA_Armory_Filter_CreateNew"	"Neuer Filter..."
"DOTA_Armory_Filter_FilterName"	"Filtername"
"DOTA_Armory_Filter_Required"	"ERFORDERLICH"
"DOTA_tooltip_econ_item_tags"	"Tags"
"Compendium_LeagueID"	"Liga-ID"
"Compendium_InvalidLeagueID"	"Ungültige oder keine Liga-ID angegeben."
"Compendium_Unsupported"	"Kompendium nicht unterstützt"
"Compendium_Unsupported_Desc"	"Diese Kompendium-Version ist älter und wird derzeit nicht unterstützt."
"DOTA_GlobalItems_CursorPacks"	"Cursorpakete"
"DOTA_Workshop_Materials"	"Materialien"
"DOTA_Workshop_EditTarget"	"Ziel ändern"
"DOTA_Popup_Item_Received_Header_Unknown"	"Sie haben einen Gegenstand erhalten!"
"DOTA_Popup_Item_Received_Header_Dropped"	"Sie haben einen Gegenstand erhalten!"
"DOTA_Popup_Item_Received_Header_Crafted"	"Sie haben einen Gegenstand hergestellt!"
"DOTA_Popup_Item_Received_Header_Purchased"	"Sie haben einen Gegenstand gekauft!"
"DOTA_Popup_Item_Received_Header_FoundInCrate"	"Sie haben einen Gegenstand erhalten!"
"DOTA_Popup_Item_Received_Header_Gifted"	"Sie haben ein Geschenk erhalten!"
"DOTA_Popup_Item_Received_Header_Promotion"	"Sie haben einen Aktionsgegenstand erhalten!"
"DOTA_Popup_Item_Received_Header_Earned"	"Sie haben einen Gegenstand verdient!"
"DOTA_Popup_Item_Received_Header_Refunded"	"Ihr Gegenstand wurde rückerstattet!"
"DOTA_Popup_Item_Received_Header_GiftWrapped"	"Sie haben einen Gegenstand als Geschenk verpackt!"
"DOTA_Popup_Item_Received_Header_Foreign"	"Sie haben einen Gegenstand in einem anderen Spiel gefunden!"
"DOTA_Popup_Item_Received_Header_CollectionReward"	"Sie haben eine Kollektionsbelohnung eingelöst"
"DOTA_Popup_Item_Received_Header_PreviewItem"	"Sie testen einen neuen Gegenstand!"
"DOTA_Popup_Item_Received_Header_PreviewItemPurchased"	"Sie haben einen Gegenstand gekauft!"
"DOTA_Popup_Item_Received_Header_PeriodicScoreReward"	"Sie haben einen Gegenstand verdient!"
"DOTA_Popup_Item_Received_Header_Recycling"	"Sie haben einen Gegenstand hergestellt!"
"DOTA_Popup_Item_Received_Header_RecipeOutput"	"Sie haben einen Gegenstand hergestellt!"
"DOTA_Popup_Item_Received_Header_CommunityMarketPurchase"	"Sie haben einen Gegenstand gekauft!"
"DOTA_Popup_Item_Received_Header_GemExtract"	"Sie haben einen Gegenstand extrahiert!"
"DOTA_Popup_Item_Received_Header_CompendiumReward"	"Sie haben eine Kompendium-Belohnung erhalten!"
"DOTA_Popup_Item_Received_Header_CompendiumDrop"	"Sie haben einen Kompendium-Gegenstand erhalten!"
"DOTA_Popup_Item_Received_Label_IOfN"	"{d:item_i} von {d:item_n}"
"DOTA_Popup_Item_Received_Button_Accept"	"Annehmen"
"DOTA_Popup_Item_Received_Button_AcceptAll"	"Alle ({d:item_n}) annehmen"
"DOTA_WatchLive_Activate"	"Ticket aktivieren"
"DOTA_Workshop_TextureName_trans"	"Transparenz"
"DOTA_Workshop_TextureName_normal"	"Normal"
"DOTA_Tournament_Premium"	"Premium"
"DOTA_Tournament_Professional"	"Professionell"
"DOTA_Tournament_Amateur"	"Amateur"
"DOTA_Treasure_MarketPurchase"	"Auf dem Markt"
"DOTA_Treasure_HelpHeader"	"Jeder Schatz enthält {d:items_per_treasure} dieser Gegenstände"
"DOTA_Treasure_HelpDupe"	"Bis Sie ihn gekauft und geöffnet haben, wissen Sie nicht, welche Gegenstände er enthält. Wenn Sie mehr als einen kaufen, können Sie Duplikate erhalten."
"DOTA_Treasure_HelpRares"	"Wenn Sie viel Glück haben, erhalten Sie zusätzlich zu den normalen Gegenständen außerdem einen der seltenen Bonusgegenstände."
"DOTA_Treasure_FilterAvailable"	"Verfügbar"
"DOTA_Treasure_FilterOwned"	"Ungeöffnet ({d:treasures_owned_count})"
"DOTA_Treasure_FilterAll"	"Alle"
"DOTA_Workshop_ValveSelectItemID"	"Gegenstand-ID auswählen"
"DOTA_Workshop_Err_FailedToLoadMaterialTemplate"	"Materialvorlage konnte nicht geladen werden: \"%1\""
"DOTA_Workshop_Tags_SingleItem"	"Einzelner Gegenstand"
"DOTA_Profile_SaveChanges"	"Änderungen speichern"
"dota_settings_shadowquality_off"	"Aus"
"dota_lobby_row_region"	"{s:region}"
"dota_lobby_browser_header_region"	"Region"
"dota_lobby_browser_all_regions"	"Alle Regionen"
"DOTA_Armory_Category_CompendiumLevels"	"Level"
"DOTA_Armory_Category_CompendiumCoins"	"Münzen"
"dota_profile_recent_game_result_win_ranked"	"{i:ranked_mmr} (+{i:ranked_mmr_delta})"
"dota_profile_recent_game_result_loss_ranked"	"{i:ranked_mmr} ({i:ranked_mmr_delta})"
"DOTA_tooltip_econ_item_gift_dedication"	"{s:gift_dedication}"
"DOTA_econ_item_details_gift_header"	"Geschenk"
"DOTA_econ_item_details_style_name"	"{s:style_name}"
"DOTA_econ_item_details_tooltip_lock_reason"	"{s:style_lock_reason}"
"DOTA_econ_item_details_description_header"	"Beschreibung"
"DOTA_econ_item_details_description_reset"	"Zurücksetzen"
"DOTA_econ_item_details_description_edit"	"Bearbeiten"
"DOTA_CraftingResult_MissingLeague"	"Fehlgeschlagen: Sie müssen das Kompendium besitzen, um dieses Rezept zu benutzen."
"DOTA_Workshop_SubmitNew"	"Absenden"
"DOTA_Workshop_SelectImportType"	"Was veröffentlichen Sie?"
"DOTA_Workshop_SelectHero"	"Held auswählen"
"DOTA_Workshop_SelectSlot"	"Slot auswählen"
"DOTA_Workshop_NoSlots"	"Keine verfügbaren Slots"
"DOTA_Workshop_SelectHeroWearable"	"Tragbarer Gegenstand"
"DOTA_Workshop_SelectAbility"	"Fähigkeit auswählen"
"DOTA_Workshop_SubmissionTypeImagesTitle"	"Welche Art von Bild veröffentlichen Sie?"
"DOTA_Workshop_SubmissionType_Wearable"	"Tragbarer Gegenstand"
"DOTA_Workshop_SubmissionType_Wearable_Desc"	"Modellgeometrie, die an das jeweilige Basismodell des Helden angefügt wird."
"DOTA_Workshop_SubmissionType_Courier"	"Kurier"
"DOTA_Workshop_SubmissionType_Courier_Desc"	"Zwei Modelle, welche über sämtliche Animationen verfügen, die notwendig sind, um im Spiel als Kurier eines Teams zu fungieren."
"DOTA_Workshop_SubmissionType_Ward_Desc"	"Ein unabhängiges Modell mit den nötigen Animationen, um im Spiel als Observer & Sentry Ward zu agieren."
"DOTA_Workshop_SubmissionType_Other"	"Andere"
"DOTA_Workshop_SubmissionType_Other_Desc"	"Eine Einsendung, die keinem der anderen Typen entspricht."
"DOTA_Workshop_SubmissionType_Ability_Desc"	"Ein oder mehr Modelle mit den Animationen benötigt, um Modelle, die einem speziellen Helden Zauber oder Fähigkeit zugewiesen sind, zu ersetzen."
"DOTA_Workshop_SubmissionType_HudSkin_Desc"	"Eine Zusammenstellung von Grafiken, die die Benutzeroberfläche im Spiel ersetzen."
"DOTA_Workshop_SubmissionType_LoadingScreen"	"Ladebildschirm"
"DOTA_Workshop_SubmissionType_LoadingScreen_Desc"	"Ein Bild, das den Ladebildschirm ersetzt."
"DOTA_Workshop_SubmissionType_Animation"	"Animation"
"DOTA_Workshop_SubmissionType_Animation_Desc"	"Animationen, die eine oder mehrere Animationen eines Helden ersetzen."
"DOTA_Workshop_SubmissionType_Images"	"Bilder"
"DOTA_Workshop_SubmissionType_Images_Desc"	"Einsendungen, die aus Bildern wie Ladebidlschirmen, HUD-Skins, Fähigkeitssymbolen und Emoticons bestehen."
"DOTA_Workshop_SubmissionType_AbilityIcons"	"Fähigkeitensymbole"
"DOTA_Workshop_SubmissionType_AbilityIcons_Desc"	"Ein Bilderset, welches die Fähigkeitssymbole eine Helden ersetzt."
"DOTA_Workshop_SubmissionType_ChatEmoticon"	"Emoticon"
"DOTA_Workshop_SubmissionType_ChatEmoticon_Desc"	"Ein animiertes Emoticon."
"DOTA_Workshop_SubmissionType_CursorPack"	"Cursorpaket"
"DOTA_Workshop_SubmissionType_CursorPack_Desc"	"Ein Paket mit Mauszeigern, die den Standardcursor des HUDs ersetzen."
"DOTA_Workshop_Err_InvalidChars"	"Nicht unterstützte Zeichen (Nur Kleinbuchstaben, Zahlen und Unterstriche erlaubt)"
"DOTA_Workshop_BrowseForGeoFilter"	"Modelle"
"DOTA_Workshop_BrowseForImageFilter"	"Bild"
"DOTA_Workshop_BrowseForAnimFilter"	"Animationen"
"DOTA_Workshop_BrowseForPsdFilter"	"PSD"
"DOTA_Workshop_Imported_S1MaskOverwrite_Title"	"Dateien überschreiben?"
"DOTA_Workshop_Imported_S1MaskOverwrite_Text"	"WARNUNG\nSind Sie sicher, dass Sie die folgenden Dateien überschreiben möchten?\n%1"
"DOTA_Workshop_SaveSessionPrompt_Title"	"Sitzung speichern?"
"DOTA_Workshop_SaveSessionPrompt_Text"	"Ihre aktuelle Sitzung speichern?"
"DOTA_Workshop_Error_FailedToLoadTexture"	"Bilddatei konnte nicht geladen werden: %1"
"UI_File_Filter_PNG"	"PNG-Dateien (*.png)"
"DOTA_Teams_WindowTitle"	"TEAMS"
"DOTA_TeamManagement_Country"	"Land"
"DOTA_TeamManagement_URL"	"Team-URL"
"DOTA_TeamKickLabel"	"Rauswerfen"
"DOTA_TeamRoster"	"Kader"
"DOTA_TeamPlayerRoster"	"Spielerkader"
"DOTA_TeamLeaveTeam"	"Dieses Team verlassen"
"DOTA_TeamDisbandTeamTooltip"	"Teamkader muss leer sein, um Team aufzulösen"
"DOTA_ProfileCard_CompendiumPanel_ComingSoon"	"Herbstsaison 2015 Kompendium noch nicht veröffentlicht"
"DOTA_tooltip_econ_item_matchid"	"SPIEL-ID: {s:tournament_matchID}"
"DOTA_Workshop_ImportS1Normal_Details"	"Importiert eine Normale im Source1-Stil (invertiert grünen Kanal) und speichert sie neben dem Original in einer neuen Datei"
"DOTA_Workshop_ItemImport_CreateItem_Description"	"Beschreibung:"
"DOTA_Workshop_Items_Duplicate_Item_Label"	"Sie können keinen Gegenstand erstellen, der bereits existiert (die Gegenstände haben denselben Namen)."
"DOTA_GameMode_AllDraft"	"All Pick"
"DOTA_GameMode_22"	"All Pick"
"DOTA_PlayerContextMenu_Unignore"	"Nutzer nicht mehr ignorieren"
"DOTA_ProfileCard_Event_SpendCoins"	"Münzen ausgeben"
"DOTA_ProfileCard_CompendiumLevel"	"Kompendium-Level"
"DOTA_Crafting_Fall_2015"	"Herbst 2015"
"DOTA_Crafting_Compendium"	"Kompendium"
"DOTA_Workshop_Attachment_Reset"	"Zurücksetzen"
"DOTA_Workshop_PreviewAspectRatio"	"Bildformat"
"DOTA_Workshop_ImagePreview"	"Bildvorschau"
}
