"dota"
{
"DOTA_Accept"	"Acceptera"
"DOTA_Cancel"	"Avbryt"
"DOTA_Console"	"Konsol"
"DOTA_Create"	"Skapa"
"DOTA_Decline"	"Avböj"
"DOTA_Error"	"Fel"
"DOTA_Join"	"Gå med"
"DOTA_Leave"	"Lämna"
"DOTA_New"	"Nytt"
"DOTA_Ok"	"OK"
"DOTA_Sale"	"Rea"
"DOTA_Close"	"Stäng"
"DOTA_Continue"	"Fortsätt"
"DOTA_Add"	"Lägg till"
"DOTA_Edit"	"Ändra"
"DOTA_Enable"	"Aktivera"
"DOTA_Disable"	"Inaktivera"
"DOTA_Refresh"	"Uppdatera"
"DOTA_Loading"	"Laddar"
"DOTA_None"	"Ingen"
"DOTA_Customize"	"Anpassa"
"DOTA_AcceptChanges"	"Acceptera ändringar"
"dota_team_radiant"	"Radiant"
"dota_team_dire"	"Dire"
"Unknown"	"Okänd"
"UI_Yes"	"Ja"
"UI_No"	"Nej"
"UI_File_Filter_Any"	"Alla filer (*.*)"
"DOTA_MainMenu_Heroes"	"Hjältar"
"DOTA_MainMenu_Watch"	"Titta"
"DOTA_MainMenu_Learn"	"Lär"
"DOTA_MainMenu_Mods"	"Anpassade spel"
"DOTA_TabName_GlobalItems"	"Globala artiklar"
"DOTA_TabName_Treasury"	"Skattkammare"
"DOTA_TabName_Armory"	"Vapenförråd"
"DOTA_ConfirmQuit"	"BEKRÄFTA AVSLUTANDE"
"DOTA_ConfirmQuitDesc"	"Vill du verkligen avsluta Dota 2?"
"DOTA_ConfirmQuitDescUnsafe"	"Att lämna ett spel innan det är avgjort kan förstöra spelet för de andra spelarna. Vill du verkligen avsluta Dota 2?"
"DOTA_InvalidPersonaName"	"[okänd]"
"DOTA_Friends_WindowTitle"	"VÄNNER"
"DOTA_FriendsCategory_ReadyToPlay"	"i öppna matcher <font color='#63C290'><b></b>({d:friend_count})</font>"
"DOTA_FriendsCategory_PlayingDota"	"i Dota <font color='#ACEBA9'>({d:friend_count})</font>"
"DOTA_FriendsCategory_Online"	"Online <font color='#6a9dcc'>({d:friend_count})</font>"
"DOTA_FriendsCategory_Pending"	"Väntar <font color='#eeee82'>({d:friend_count})</font>"
"DOTA_FriendsCategory_Offline"	"Offline <font color='#676666'>({d:friend_count})</font>"
"DOTA_Friends_Empty"	"Din vänlista är tom"
"DOTA_FriendsMenu_Tooltip_NoneReady"	"Vänner"
"DOTA_UserName"	"{g:dota_persona:user_account_id}"
"DOTA_UserNamePro"	"{g:dota_persona_pro:user_account_id}"
"DOTA_UserNickname"	"{g:dota_persona_nickname:user_account_id}"
"DOTA_UserRichPresence"	"{s:user_rich_presence}"
"DOTA_ProfileCard_StatTitle_SoloRank"	"Solo-MMR"
"DOTA_ProfileCard_StatTitle_PartyRank"	"Grupp-MMR"
"DOTA_ProfileCard_StatTitle_Wins"	"Vinster"
"DOTA_ProfileCard_StatTitle_Commends"	"Beröm"
"DOTA_ProfileCard_StatTitle_GamesPlayed"	"Matcher"
"DOTA_ProfileCard_StatTitle_FirstMatchDate"	"Första matchen"
"DOTA_ProfileCard_StatValue_Int"	"{d:stat_value}"
"DOTA_ProfileCard_StatValue_Date"	"{t:s:stat_value}"
"DOTA_ProfileCard_StatValue_String"	"{s:stat_value}"
"DOTA_ProfileCard_SlotTab_Trophies"	"Troféer"
"DOTA_ProfileCard_SlotTab_Items"	"Vapenförråd"
"DOTA_ProfileCard_SlotTab_Heroes"	"Hjältar"
"DOTA_ProfileCard_SlotTab_Emoticons"	"Uttryckssymboler"
"DOTA_ProfileCard_NoTrophies"	"Inga tillgängliga troféer."
"DOTA_ProfileCard_NoItems"	"Inga tillgängliga föremål."
"DOTA_ProfileCard_HeroOnly"	"Endast hjältar"
"DOTA_ProfileCard_HeroShowWins"	"Visa vinster"
"DOTA_ProfileCard_HeroShowWinsAndLosses"	"Visa vinster/förluster"
"DOTA_ProfileCard_ItemSearchPrefix"	"Sök efter:"
"DOTA_ProfileCard_ItemSearchPlaceholder"	"Föremål efter namn"
"DOTA_ProfileCard_ItemArmoryLink"	"Visa hela vapenförrådet"
"DOTA_HeroTooltip_HeroName"	"{s:hero_name}"
"DOTA_HeroTooltip_HeroRecord"	"{s:hero_wins_string}, {s:hero_losses_string}"
"DOTA_ProfileCard_HeroSearchPlaceholder"	"Sök efter hjältenamn"
"DOTA_Wins_Singular"	"1 vinst"
"DOTA_Wins_Plural"	"{d:hero_wins} vinster"
"DOTA_Losses_Singular"	"1 förlust"
"DOTA_Losses_Plural"	"{d:hero_losses} förluster"
"DOTA_Profile_TotalGames"	"Antal matcher"
"DOTA_Profile_Solo_MMR"	"Solo-MMR"
"DOTA_Profile_Team_MMR"	"Lag-MMR"
"DOTA_Profile_Party_MMR"	"Grupp-MMR"
"DOTA_Profile_VictoryCount"	"Vinster"
"DOTA_Profile_ProfilePage"	"Profil"
"DOTA_Profile_TrophyPage"	"Troféer"
"DOTA_Profile_RecentGamesPage"	"Senaste matcher"
"DOTA_Profile_HeroPage"	"Hjältar"
"DOTA_Profile_PlayStyle"	"Spelstil"
"DOTA_Profile_MostRecent"	"Senaste {s:num_style_games} match(er)"
"DOTA_Profile_RecentActivity"	"Senaste aktivitet"
"DOTA_Profile_Fighting"	"Stridande"
"DOTA_Profile_Fighting_TooltipTitle"	"Stridande"
"DOTA_Profile_Fighting_Tooltip"	"Spelare som slåss med fiendehjältar i många strider."
"DOTA_Profile_Farming"	"Farmande"
"DOTA_Profile_Farming_TooltipTitle"	"Farmande"
"DOTA_Profile_Farming_Tooltip"	"Spelare som samlar guld genom att döda monster."
"DOTA_Profile_Supporting"	"Understöd"
"DOTA_Profile_Supporting_TooltipTitle"	"Understödjande"
"DOTA_Profile_Supporting_Tooltip"	"Spelare som stödjer sitt lag med helande, wards och föremål."
"DOTA_Profile_Pushing"	"Pushande"
"DOTA_Profile_Pushing_TooltipTitle"	"Pushande"
"DOTA_Profile_Pushing_Tooltip"	"Spelare som skapar tryck på torn och hjälper till att skapa utrymme."
"DOTA_Profile_Versatility"	"Flexibilitet"
"DOTA_Profile_Versatility_TooltipTitle"	"Flexibilitet"
"DOTA_Profile_Versatility_Tooltip"	"Spelare som är flexibla och spelar många olika hjältar."
"DOTA_Profile_Tooltip_Value"	"{s:CurrentStatValue}"
"DOTA_Profile_Tooltip_Comparison"	"{s:CurrentComparisonValue}"
"DOTA_Profile_StatsCompare"	"Jämför med min statistik"
"DOTA_Profile_Self"	"Jag"
"DOTA_Profile_GPM"	"Genomsnittlig GPM"
"DOTA_Profile_XPM"	"Genomsnittlig XPM"
"DOTA_Profile_LH"	"Genomsnittliga dödande träffar"
"DOTA_Profile_Rampages"	"Härjningståg"
"DOTA_Profile_TripleKills"	"Trippelmord"
"DOTA_Profile_FirstBlood"	"Första blod"
"DOTA_Profile_FirstBled"	"Först att dö"
"DOTA_Profile_CourierKills"	"Dödade kurirer"
"DOTA_Profile_Aegises"	"Stulna Aegis"
"DOTA_Profile_CheeseEaten"	"Uppätna ostar"
"DOTA_Profile_CreepStack"	"Stackade läger"
"DOTA_Profile_GPMValue"	"{s:GPM}"
"DOTA_Profile_XPMValue"	"{s:XPM}"
"DOTA_Profile_LHValue"	"{s:LH}"
"DOTA_Profile_RampagesValue"	"{d:Rampages}"
"DOTA_Profile_TripleKillsValue"	"{d:TripleKills}"
"DOTA_Profile_FirstBloodValue"	"{d:FirstBlood}"
"DOTA_Profile_FirstBledValue"	"{d:FirstBled}"
"DOTA_Profile_CourierKillsValue"	"{d:CourierKills}"
"DOTA_Profile_AegisesValue"	"{d:Aegises}"
"DOTA_Profile_CheeseEatenValue"	"{d:CheeseEaten}"
"DOTA_Profile_CreepStackValue"	"{d:CreepStack}"
"DOTA_Profile_GPMLocalValue"	"{s:GPMLocal}"
"DOTA_Profile_XPMLocalValue"	"{s:XPMLocal}"
"DOTA_Profile_LHLocalValue"	"{s:LHLocal}"
"DOTA_Profile_RampagesLocalValue"	"{d:RampagesLocal}"
"DOTA_Profile_TripleKillsLocalValue"	"{d:TripleKillsLocal}"
"DOTA_Profile_FirstBloodLocalValue"	"{d:FirstBloodLocal}"
"DOTA_Profile_FirstBledLocalValue"	"{d:FirstBledLocal}"
"DOTA_Profile_CourierKillsLocalValue"	"{d:CourierKillsLocal}"
"DOTA_Profile_AegisesLocalValue"	"{d:AegisesLocal}"
"DOTA_Profile_CheeseEatenLocalValue"	"{d:CheeseEatenLocal}"
"DOTA_Profile_CreepStackLocalValue"	"{d:CreepStackLocal}"
"DOTA_RecentGames_Title"	"Senaste matcher"
"DOTA_RecentGames_TimeStamp"	"Datum/Tid"
"DOTA_RecentGames_HeroSelection"	"Spelad hjälte"
"DOTA_RecentGames_GameResult"	"Resultat"
"DOTA_RecentGames_GameLength"	"Matchlängd"
"DOTA_RecentGames_Team"	"Lag"
"DOTA_RecentGames_GameType"	"Typ"
"DOTA_RecentGames_Items"	"Föremål"
"DOTA_RecentGame_Timestamp_Entry"	"{t:s:timestamp} {t:t:timestamp}"
"DOTA_RecentGame_Duration"	"{t:d:duration}"
"DOTA_RecentGame_Downloading"	"{s:DownloadPercent} Laddar ned"
"DOTA_RecentGame_Watch"	"Se repris"
"DOTA_RecentGame_NoReplay"	"Ingen repris"
"DOTA_RecentGame_Expired"	"Repris har utgått"
"DOTA_RecentGame_Finding"	"Letar..."
"DOTA_RecentGame_Download"	"Ladda ned match"
"DOTA_RecentGame_Pending"	"Väntar på repris"
"DOTA_RecentGame_Unavailable"	"Repris otillgänglig"
"DOTA_RecentGame_MatchID"	"Match-ID: #{s:match_id}"
"DOTA_No_Team_Name"	"--"
"DOTA_TrophyCount"	"{d:trophy_count} trofé"
"DOTA_TrophiesCount"	"{d:trophy_count} troféer"
"DOTA_TrophyCount_Number"	"{d:trophy_count}"
"DOTA_TrophyCount_NoNum"	"Trofé"
"DOTA_TrophiesCount_NoNum"	"Troféer"
"DOTA_Trophies_ViewAll"	"Alla"
"DOTA_TrophyName"	"{s:trophy_name}"
"DOTA_TrophyCategory"	"{s:trophy_category}"
"DOTA_TrophyDescription"	"{s:trophy_description}"
"DOTA_TrophyXP"	"{d:trophy_xp}<span class=\"TrophyPointTextSmall\">TP</span>"
"DOTA_NextTrophy"	"Nästa belöning"
"DOTA_NewPlayerQuestion_Title"	"VÄLKOMMEN TILL DOTA 2"
"DOTA_PlayerOriginQuestion_Question"	"För att förbättra din spelupplevelse, beskriv din bekantskap med Dota 2 och likartade spel:"
"DOTA_PlayerOriginQuestion_BeginnerButton"	"Jag är en nybörjare."
"DOTA_PlayerOriginQuestion_RTSButton"	"Jag har spelat RTS-spel."
"DOTA_PlayerOriginQuestion_MOBAButton"	"Jag har spelat ett spel som liknar Dota 2."
"DOTA_PlayerOriginQuestion_Dota2Button"	"Jag har spelat Dota 2."
"DOTA_PlayerOriginQuestion_MOBAExplanation"	"Välj det spel du är mest van med:"
"DOTA_OtherGames_LOL"	"League of Legends"
"DOTA_OtherGames_DOTA"	"DotA 1"
"DOTA_OtherGames_HON"	"Heroes of Newerth"
"DOTA_OtherGames_Smite"	"Smite"
"DOTA_OtherGames_Other"	"Annat spel"
"DOTA_PlayerOriginQuestion_ConfirmationButton"	"DÅ KÖR VI"
"DOTA_PlayerOriginQuestion_ConfirmationTutorial"	"Som en spelare som är ny i Dota, kan genomgångarna som finns under Spela > Träning vara av intresse. De är ett bra första steg mot att dominera andra spelare över hela världen."
"DOTA_PlayerOriginQuestion_ConfirmationSettings"	"Dina tangenter och alternativ har nu de vanligaste inställningarna som spelare med din erfarenhet har. Du kan anpassa dessa närsomhelst genom att klicka på inställningsikonen."
"DOTA_Tutorial_SkipButton"	"Hoppa över genomgång"
"DOTA_ConfirmSkip"	"Hoppa över inledning till Dota 2?"
"DOTA_ConfirmSkipDesc"	"Är du säker på att du vill hoppa över genomgångarna för Dota 2?"
"DOTA_Tutorial_Start_Quest"	"PÅBÖRJA UPPDRAG"
"DOTA_Tutorial_Quest0_Title"	"UPPDRAG 1"
"DOTA_Tutorial_Quest0_TitleDesc"	"AVSTÅNDSHJÄLTE"
"DOTA_Tutorial_Quest0DetailsDesc"	"Det här uppdraget tar ungefär\n 10 minuter att slutföra."
"DOTA_Tutorial_QuestDetailsLearn"	"Du kommer lära dig:"
"DOTA_Tutorial_Quest0DetailsLesson"	"Förflytta din hjälte\nGå upp i nivå med din hjälte\nAnvända förmågor\nFöremål\nGrundläggande stridsmekanik\nDödande träffar"
"DOTA_Tutorial_Quest1_Title"	"UPPDRAG 2"
"DOTA_Tutorial_Quest1_TitleDesc"	"STRID PÅ VÄGEN"
"DOTA_Tutorial_Quest1DetailsDesc"	"Det här uppdraget tar ungefär\n 10 minuter att slutföra."
"DOTA_Tutorial_Quest1DetailsLesson"	"Strida på avstånd \n Områdesförmågor (AOE) \n Minikartan \n Torn \n Kuriren och förrådet \n Teleportering"
"DOTA_Tutorial_Quest2_Title"	"UPPDRAG 3"
"DOTA_Tutorial_Quest2_TitleDesc"	"STRID PÅ VÄGEN"
"DOTA_Tutorial_Quest2DetailsDesc"	"Det här uppdraget tar ungefär\n 10 - 15 minuter att slutföra."
"DOTA_Tutorial_Quest2DetailsLesson"	"Strider på vägen \n Försvara och anfalla torn \n Startföremål"
"DOTA_Challenges_Title"	"Lära"
"DOTA_ChallengeGroup_0_Title"	"Spelmekanik"
"DOTA_ChallengeGroup_1_Title"	"Vägledda botmatcher"
"DOTA_ChallengeGroup_1_Desc"	"Börja här!"
"DOTA_ChallengeGroup_2_Title"	"Botmatcher"
"DOTA_ChallengeGroup_More"	"Mer kommer"
"DOTA_ChallengeGroup_Locked"	"Låst"
"DOTA_LearnMechanics_Title"	"Spelmekanik"
"DOTA_LearnMechanics_SubTitle"	"Lär dig grundkunskaperna i att spela Dota. Omfattar hur man kontrollerar sin hjälte, använder föremålsbutiken, hur man tjänar guld och erfarenhet, m.m. Om du aldrig har spelat ett spel som Dota, börja här."
"DOTA_Mechanics_0_Title"	"Spelmekanik 1"
"DOTA_Mechanics_0_Desc"	"Förflytta din hjälte\nGå upp i nivå med din hjälte\nAnvända förmågor\nFöremål\nGrundläggande stridsmekanik\nDödande träffar"
"DOTA_Mechanics_1_Title"	"Spelmekanik 2"
"DOTA_Mechanics_1_Desc"	"Strida på avstånd\nOmrådesförmågor\nMinikartan\nTorn\nKuriren och förrådet\nTeleportering"
"DOTA_LearnGuidedBotMatches_Title"	"Vägledda botmatcher"
"DOTA_LearnGuidedBotMatches_SubTitle"	"Kom och slåss mot AI-kontrollerade hjältar samtidigt som du lär dig spela Dota. Vi handleder dig steg för steg genom varje fas i en hel match, medan du bygger din hjälte till en ostoppbar kraft."
"DOTA_GuidedBotMatches_0_Title"	"Luna"
"DOTA_GuidedBotMatches_0_Desc"	"Kort avståndsattack\nHög attackskada\nSnabb förflyttning\nMåttligt ömtålig\nAnvänder attributet Agility"
"DOTA_GuidedBotMatches_1_Title"	"Sven"
"DOTA_GuidedBotMatches_1_Desc"	"Närstridsattack\nExplosiv attackskada\nTålig\nSårbar mot nedsaktning\nAnvänder attributet Styrka"
"DOTA_GuidedBotMatches_2_Title"	"Lina"
"DOTA_GuidedBotMatches_2_Desc"	"Lång avståndsattack\nExplosiv förmågeskada\nKorta cooldowns\nMycket ömtålig\nAnvänder attributet Intelligens"
"DOTA_LearnBotMatches_Title"	"Botmatcher"
"DOTA_LearnBotMatches_SubTitle"	"Öva med och mot AI-kontrollerade hjältar i en stressfri träningsmiljö."
"DOTA_BotMatches_0_Title"	"Lätta bottar"
"DOTA_BotMatches_0_Desc"	"Lär dig en ny hjälte."
"DOTA_BotMatches_1_Title"	"Mellansvåra bottar"
"DOTA_BotMatches_1_Desc"	"Bli bekväm."
"DOTA_BotMatches_2_Title"	"Svåra bottar"
"DOTA_BotMatches_2_Desc"	"Utmana dig själv."
"DOTA_BotMatches_3_Title"	"Galna bottar"
"DOTA_BotMatches_3_Desc"	"Gör dig illa."
"FileOpenDialog_Open"	"Öppna"
"FileOpenDialog_Save"	"Spara"
"FileOpenDialog_Select"	"Välj"
"FileOpenDialog_FileType_Folder"	"Filmapp"
"DOTA_FindMatch"	"Hitta match"
"DOTA_FindingMatch"	"Hittar match ( {s:find_match_time} )"
"DOTA_FindMatchTime"	"{s:find_match_time}"
"DOTA_Searching"	"Söker"
"DOTA_StartSoloBotMatch"	"Starta botmatch"
"DOTA_Create_Lobby"	"SKAPA LOBBY"
"DOTA_Join_Lobby"	"Gå med i lobby"
"DOTA_LobbyStartGame"	"Starta matchen"
"DOTA_ReturnToLobby"	"Gå tillbaka till lobbyn"
"DOTA_FindMatchStatus"	"{s:searching_matchtype} / {s:searching_gamemodes} / {s:searching_region}"
"DOTA_FindGameModesMany"	"Spellägen:"
"DOTA_FindRegionsMany"	"Regioner: "
"DOTA_GameMode_AllPick"	"Alla väljer"
"DOTA_GameMode_SingleDraft"	"Enkelt val"
"DOTA_GameMode_CaptainsMode"	"Kaptensläge"
"DOTA_GameMode_RandomDraft"	"Slumpat val"
"DOTA_GameMode_AbilityDraft"	"Förmågeval"
"DOTA_GameMode_LeastPlayed"	"Minst spelade"
"DOTA_GameMode_AllRandom"	"Alla slumpade"
"DOTA_GameMode_LimitedHeroes"	"Begränsade hjältar"
"DOTA_GameMode_CaptainsDraft"	"Kaptenens val"
"DOTA_GameMode_AllRandomDeathMatch"	"Alla slumpade - Dödsmatch"
"DOTA_ImmediatePurchase_SendFailed"	"Kunde inte sända köpbegäran. Dota-servrarna kan vara offline. Försök igen senare."
"DOTA_ImmediatePurchase_Timeout"	"Tog för lång tid att få ett svar på köpbegäran. Var god försök igen senare."
"DOTA_ImmediatePurchase_InitFailed"	"Vi kunde inte initiera ett köp med Perfect World just nu. Var god försök igen senare."
"DOTA_ImmediatePurchase_InsufficientFundsPW"	"Det fanns inte tillräckligt med pengar på ditt Perfect World-konto för att slutföra köpet. Var god ladda på ditt konto och försök igen."
"DOTA_ImmediatePurchase_Success_Title"	"Klart"
"DOTA_ImmediatePurchase_Success_Text"	"Köpet har slutförts! Dina artiklar dyker snart upp i ditt Vapenförråd."
"DOTA_ImmediatePurchase_Cancelled_Title"	"Avbruten"
"DOTA_ImmediatePurchase_UnbundleTimeout"	"Tog för lång tid att få ett svar för uppackningsbegäran. Var god försök igen senare."
"DOTA_ImmediatePurchase_UnbundleFailure"	"Kunde inte packa upp din bunt. Var god försök igen senare."
"DOTA_ImmediatePurchase_LateCancel"	"Köpet avbröts tidigare. Inga pengar har dragits."
"DOTA_ConfirmPurchaseTitle"	"Bekräfta köp"
"DOTA_ConfirmPurchaseText"	"Vill du köpa denna artikel?"
"DOTA_PurchaseInProgress_Title"	"Köp pågår"
"DOTA_PurchaseInProgress_Text"	"Ditt köp behandlas."
"DOTA_UnbundleInProgress_Title"	"Packar upp..."
"DOTA_UnbundleInProgress_Text"	"Din bunt packas upp."
"DOTA_ConfirmUnbundleTitle"	"Bekräfta uppackning"
"DOTA_ConfirmUnbundleText"	"Du måste packa upp denna bunt för att kunna utrusta föremålen i den. Fortsätta?"
"DOTA_RequestingBalance_Title"	"Begär saldo"
"DOTA_RequestingBalance_Text"	"Begär kontosaldo av ditt Perfect World-konto..."
"DOTA_PartnerPurchaseRecharge_Title"	"Ladda på saldo"
"DOTA_PartnerPurchaseRecharge_Text"	"Byter till att ladda på ditt kontosaldo..."
"DOTA_PartnerPurchase_Purchase"	"{g:dota_item_price:item_def}"
"DOTA_PartnerPurchase_Recharge"	"Ladda på konto"
"DOTA_PartnerPurchase_Balance"	"Saldo: {m:balance}"
"DOTA_PartnerRecharge_Close"	"Återvänd till köp"
"RequestBalanceBadAccount"	"Kunde inte begära kontosaldo: konto hittades inte."
"RequestBalanceAccountNotLinked"	"Kunde inte begära kontosaldo: ditt konto är ej länkad till Perfect World."
"RequestBalanceUnsupportedPartner"	"Kunde inte begära kontosaldo: ditt konto är ej länkad till en erkänd partner"
"StoreCheckout_Error_Title"	"Fel"
"StoreCheckout_NoItems"	"Din kundvagn är tom!"
"StoreCheckout_TooManyItems"	"Du har för många artiklar i din kundvagn!"
"StoreCheckout_Loading"	"Går till kassan..."
"StoreCheckout_Unavailable"	"Kassan är inte tillgänglig just nu."
"StoreCheckout_Cancelling"	"Avbryter..."
"StoreCheckout_Fail"	"Butiken är för tillfället stängd."
"StoreCheckout_InvalidParam"	"En programmerare har trasslat till det! En ogiltig parameter leddes till spelkoordinatorn. Försök genomföra köpet igen."
"StoreCheckout_InternalError"	"Det verkar som om det har uppstått ett problem att initiera eller uppdatera din transaktion. Var vänlig vänta en minut och försök igen eller kontakta support för assistans."
"StoreCheckout_ContactSupport"	"Det uppstod ett problem med din transaktion. Var vänlig kontakta support för assistans."
"StoreCheckout_NotApproved"	"Spelets samordnare kunde inte godkänna din transaktion med Steam. Var vänlig försök igen senare."
"StoreCheckout_NotLoggedin"	"Du måste vara inloggad till Steam för att kunna fullborda köpet."
"StoreCheckout_WrongCurrency"	"Den här transaktionens valuta matchar inte din Steam-plånboks valuta."
"StoreCheckout_NoAccount"	"Ditt Steam konto är för nuvarande otillgängligt. Var vänlig försök igen senare."
"StoreCheckout_InsufficientFunds"	"Du har inte tillräckligt med pengar för att fullborda köpet."
"StoreCheckout_TimedOut"	"Den här transaktionen har nått sin tidsgräns. Var vänlig försök igen senare."
"StoreCheckout_SteamAccountDisabled"	"Ditt Steam-konto är inaktiverat och kan inte användas för att handla."
"StoreCheckout_SteamAccountNoPurchase"	"Transaktioner med Steam-plånbok har blivit inaktiverat på detta konto."
"StoreCheckout_OldPriceSheet"	"Din lokala produktlista är inaktuell. En ny begärs."
"StoreCheckout_TransactionNotFound"	"Den här transaktionens ID hittades inte av spelets samordnare. Var vänlig försök igen senare."
"StoreCheckout_TransactionCancelled"	"Transaktion avbruten. Inga pengar har dragits."
"StoreCheckout_TransactionCompleted"	"Transaktion slutförd!\\\nHa så kul med bytet!"
"StoreCheckout_CompleteButUnfinalized"	"Kunde inte bekräfta om transaktionen lyckades. Om det lyckades, kommer dina artiklar att levereras vid ett senare tillfälle."
"StoreCheckout_NotEnoughRoom"	"Du har inte tillräckligt med utrymme i ditt vapenförråd för att kunna köpa så många artiklar."
"StoreCheckout_ContactSupport_Dialog_Title"	"Varning"
"StoreCheckout_ContactSupport_Dialog_Btn"	"Kontakta"
"StoreCheckout_LimitedQuantityItemsUnavailable"	"Ett föremål som du försöker köpa har blivit utsålt eller är inte tillgängligt just nu."
"StoreCheckout_Nexon_InsufficientFunds"	"Du har inte tillräckligt med pengar för att slutföra köpet."
"StoreCheckout_Nexon_FundsLocked"	"Nexon cash lock är aktiverat."
"npc_dota_hero_abaddon_hype"	"Abaddon kan överleva många angrepp tack vare hans förmåga att omvandla fienders attacker till självhelande. Han rider in i stridens hetta, alltid redo att beskydda allierade med sin Aphotic Shield eller hela dem med sin tveeggade Mist Coil, som även kan skada fiender."
"npc_dota_hero_alchemist_hype"	"Kunskapen att utvinna extra guld kommer väl till pass för Alchemist, som inte har några problem med att samla ihop verktygen han behöver för att förgöra sina motståndare. Han överrumplar sina fiender med frätande syra och en blandning av instabila kemikalier, och strider för att försäkra att hans giriga upptåg förblir oavbrutna."
"npc_dota_hero_ancient_apparition_hype"	"Ingenstans kan man vara helt säker från Ancient Apparition, som kan avfyra en kraftfull explosion av is var som helst på slagfältet och splittra försvagade motståndare. Genom att sakta ned sina fiender och förbättra sina allierades effektivitet i striden, förblir han ett konstant hot mot sina fiender."
"npc_dota_hero_antimage_hype"	"Om Anti-Mage får chansen att uppnå sin fulla styrka, är det få som kan stoppa hans framfart. Han tömmer sina fienders mana med varje slag och kan teleportera sig själv korta avstånd, vilket gör det utmanande att hejda honom."
"npc_dota_hero_axe_hype"	"Axe hugger ned sina fiender, en efter en. Han marscherar först i laget, låser fast sina fiender i strid och kontrar sedan deras slag med dödliga sving från sitt vapen. Han är alltid redo att rusa före och driva yxan genom en försvagad fiende."
"npc_dota_hero_bane_hype"	"Motståndare till Bane fruktar hans utbud av inaktiverande förmågor. Oavsett om han fångar någon med en smittsam mardröm, eller griper tag och håller en på plats, ger han sina allierade all tid de behöver för att dräpa sina fiender."
"npc_dota_hero_batrider_hype"	"När Batrider stiger till skyn så kan han slå till åt vilket håll som helst. Flygandes över trätopparna fångar han in en fiende med sin lasso, och drar bytet genom ett spår av eld mot sina skoningslösa allierade."
"npc_dota_hero_beastmaster_hype"	"Beastmaster kan kalla på ett giftspottande vildsvin och en spanande hök som hjälper honom med sin jakt. Han hugger sig fram genom skogen med sina yxor, och hans bedövande vrål öppnar vägen för hans allierade att förgöra sina fiender."
"npc_dota_hero_bloodseeker_hype"	"Bloodseeker tvingar sina fiender till svåra beslut. Han kan driva sina motståndare tillbaka genom att täcka ett stort område med en skadlig ritual, medan hans ultimata förmåga tvingar dem att stå still eller dö."
"npc_dota_hero_bounty_hunter_hype"	"Bounty Hunter smyger tätt bakom sina fiender och håller alltid ett öga på dem. När en av hans mål stupar i strid, blir han och hans allierade rikligt belönade."
"npc_dota_hero_brewmaster_hype"	"Brewmaster är en fruktad kämpe som kan vända en strid genom att dela sig till tre elementära andar, var och en med unika förmågor. När han inte är delad för han med sig berusat kaos till sina motståndare, med bromsande smällar och kraftfulla svingar med sin stav."
"npc_dota_hero_bristleback_hype"	"När det är slagsmål på gång så vänder Bristleback den ofta ryggen. Då all skada som träffar honom i ryggen reduceras kan han vada in i striden utan vidare bekymmer, samtidigt som han sprayar fiender med skadliga piggar och bromsande snor."
"npc_dota_hero_broodmother_hype"	"Gömd i sitt nät föder Broodmother fram en armé av spindlar som leder hennes lagstyrkor mot fiendens bas. När byte nalkas, attackerar hon tillsammans med sina barn med förlamande bett och tillfredsställer hennes omättliga hunger."
"npc_dota_hero_centaur_hype"	"Centaur Warrunner är en mästare på att både åsamka och absorbera skada. Han rusar först in i strider, stampar för att bedöva sina fiender, och omedelbart kontra deras attacker. Hans ultimata förmåga snabbar upp hans allierade i både anfall och reträtt, vilket skyndar på blodbadets takt."
"npc_dota_hero_chaos_knight_hype"	"Chaos Knight är en armé i sig själv. Denna hjälte kan framkalla ett helt kavalleri av kloner för att ödelägga fiendens försvar, och skulle en fiende komma för nära så kan han göra en reva i verkligheten och dra sig själv och hans vålnader nära nog för att förinta fienden med ett regn av brutala slag."
"npc_dota_hero_chen_hype"	"Chen konverterar skogens varelser till sin sak och leder sina provisoriska arméer för att hjälpa sitt lag i striden. Han attackerar fiender med odjur medan han skickar sina vänner till säkerhet. Sen, när det ser som mörkast ut, helar han sina allierade var de än må vara."
"npc_dota_hero_clinkz_hype"	"När Clinkz smyger omkring osynlig på slagfältet är ingen säker från ett bakhåll. Kvick i fötterna och med pilbågen ger han sina motståndare en eldig död, innan han retirerar för att stjäla livet från skogens varelser och planera sitt nästa anfall."
"npc_dota_hero_rattletrap_hype"	"Clockwork kan skjuta sig rakt in mot fiender med sin gripkrok, isolera mål och spränga sönder dem med desorienterat splitter. Med sina händiga lysraketer som ger uppsikt över slagfältet, har han aldrig problem med att hitta mål att hoppa in på."
"npc_dota_hero_crystal_maiden_hype"	"Crystal Maiden är ett hjälpsamt tillskott till alla lag, då hon är kapabel till att hålla sina allierade försedd med mana och kunna sakta ned fiender för att säkra ett dråp. När tillfället ges kan hon släppa lös sin massiva ultimata förmåga för att ödelägga hennes motståndare."
"npc_dota_hero_dark_seer_hype"	"Dark Seer är mångsidig och strategisk, utmärkt på att manipulera fienders positioner. Vacuum är en stark förmåga som låter han suga ihop fiender och göra dem mer sårbara för allierades attacker. Dessutom kan han vända fiendernas styrka mot sig själva genom att dra motståndarna genom hans replikerande vägg."
"npc_dota_hero_dazzle_hype"	"Dazzle är gjord för att stödja sina anhängare i strid och hålla sina skadade allierade vid liv, så att de senare kan ödelägga fienden. Hans märkliga magi väver sig in i pansar, vilket försvagar fiender och stärker vänner."
"npc_dota_hero_death_prophet_hype"	"När Death Prophet släpper lös sin spökarmé, utmärker hon sig på att ödelägga fiender och deras försvar likaså. När hon leder sitt lag mot fiendens bas med våg efter skadlig våg från sin svärm, kan hennes angrepp verka ostoppbar."
"npc_dota_hero_disruptor_hype"	"Disruptor utmärker sig på att förstöra sina fienders planer. Han kan framkalla ett ogenomträngligt stängsel som fångar in hans motståndare och sedan kalla ned ett tystande oväder på dem. Skulle en fiende göra någonting oförväntat så kan Disruptor enkelt teleportera tillbaka denne till sin tidigare plats."
"npc_dota_hero_doom_bringer_hype"	"På ett eller annat sätt stänger Doom ned sina fiender. Han äter creeps och gör anspråk på de olika förmågor som de hade vid livet, bränner fiender omkring sig och lägger en varaktig tystnad på en fiendes förmågor och föremål med sin ultimata förmåga."
"npc_dota_hero_dragon_knight_hype"	"När Dragon Knight tar sig an sin fasansfulla drakform slår han skräck i alla som möter honom. Stark och anpassningsbar är han, kapabel att bedöva sina fiender och bränna allt framför sig, och ger ofta sina allierade drivkraften som krävs för att bära dem till seger."
"npc_dota_hero_drow_ranger_hype"	"Få kan fly undan Drow Ranger när hon väl är inom räckhåll. Efter hennes fiender har tystats med en kylig tryckvåg, gör hon slut på dem med en spärreld av iskalla pilar som få kan överleva."
"npc_dota_hero_earth_spirit_hype"	"Earth Spirit bringar kaos till fienden och hjälper sina kamrater i striden. Han anpassar sig till alla stridsscenarion, och kan skicka sina stenstatyer fram och tillbaka för att skada fiender, eller greppa tag i en allierad för att rädda denne från dödens käftar."
"npc_dota_hero_earthshaker_hype"	"Oavsett när det gäller att blockera en fiendes utväg, dela upp deras styrkor eller splittra marken under dem, så är Earthshaker som bäst när han slår till utan förvarning. Den som överlever efterskalven har fortfarande ett sving från hans stora totem att se fram emot."
"npc_dota_hero_elder_titan_hype"	"Elder Titan spanar med sin astrala ande och kan slå till från alla håll. Blotta närvaron fräter bort fienders försvar, och med ett mäktigt stamp kan han få dem att stanna upp, vilket gör det enkelt att förbereda att splittra jorden under dem."
"npc_dota_hero_ember_spirit_hype"	"Snabb och svårfångad är Ember Spirit, som kan träffa alla fiender i närheten i snabb följd och binda fast dem med brinnande kedjor. Han kan kvickt hoppa över slagfältet till en av sina exploderande kopior, vilket gör att få kan undvika eller fånga hans flamma."
"npc_dota_hero_enchantress_hype"	"Enchantress är skadlig på nära håll och dödlig på avstånd, då hennes förtrollade kastspjut gör mer skada ju längre de flyger. Hon kan sakta ned fiender eller charmera skogsvarelser till att slåss för henne - Enchantress har många verktyg för att vinna en strid."
"npc_dota_hero_enigma_hype"	"Enigma har en mycket fruktad ultimat förmåga som låter honom skapa ett svart hål som kan fånga hans fiender, så att hans allierade sedan kan förgöra dem. En alltid närvarande grupp med eidolons finns vid hans sida, och tillsammans med dem pucklar han på sina motståndare med avståndsattacker."
"npc_dota_hero_faceless_void_hype"	"Tiden betyder allt för Faceless Void. Han påskyndar tiden för att hoppa mellan platser, manipulerar den för att undvika attacker, och stannar den helt inom ett stort område för att förgöra sina fiender, och får han tillräckligt av den för att samla tillgångar kan han göra sig otroligt kraftfull."
"npc_dota_hero_gyrocopter_hype"	"Gyrocopter flyger in i striden med ett arsenal av eldkraft redo. Han kan skjuta alla fiender i närheten med kanonskott eller bombardera dem med en spärreld av raketer. Tillåts han uppnå sin fulla styrka förgör han sina fiender med lätthet."
"npc_dota_hero_huskar_hype"	"När hälsan hos Huskar sjunker, blir han allt dödligare. Han kan omedelbart offra en del av både sin och fiendens hälsa med sin ultimata förmåga, och när döden är nära så kan han kasta sina brinnande spjut med förödande hastighet."
"npc_dota_hero_invoker_hype"	"Invoker har ett invecklat arsenal av förmågor till sitt förfogande och kan anpassa sig till alla stridssituationer. Varje konfiguration av hans tre förmågekomponenter resulterar i en av elva förmågor, vilket betyder att han alltid har ett sätt att förstöra eller fly från sina fiender."
"npc_dota_hero_wisp_hype"	"Io har en talang att göra sina allierade effektivare. Förbindelsen från denna kraftfulla kompanjon snabbar på allierade och saktar ned fiender. Kapabel att länka till och teleportera var som helst på slagfältet tillsammans med en allierad, betyder att Io kan göra en dödlig vän ännu dödligare."
"npc_dota_hero_jakiro_hype"	"Jakiro är sin egna bästa vän. Att straffa någon med eld är inte nog, tvillingarna kan dessutom frysa fiender på plats och tvinga dem att stå stilla och brinna. Medan fienderna brinner, vänder de sig för att göra massiv skada på fiendernas byggnader med sin likvida eld."
"npc_dota_hero_juggernaut_hype"	"Juggernaut hugger ned sina fiender med en uppsjö av slag. Han springer och snurrar in i striden med vårdslös frigjordhet, och blir nästan odödlig när han väl får påbörja sitt anfall. Att stoppa Juggernaut kan ofta vara lika svårt som att överleva honom."
"npc_dota_hero_keeper_of_the_light_hype"	"Keeper of the Light är ett hjälpsamt tillskott till alla lag. Han manipulerar mana hos både allierade och fiender, och förgör enkelt lägre stående fiender med sina ljusvågor. Sedan går han över till sin andeform för att samla sitt lag och avancera."
"npc_dota_hero_kunkka_hype"	"Kunkka förutsäger alltid var hans fiender kommer att gå härnäst. Han kan att anfalla ett område med en gejser och ett spökskepp, och skulle han träffa med båda så har han och hans allierade inga problem med att rensa upp det som finns kvar."
"npc_dota_hero_legion_commander_hype"	"Legion Commander marscherar över slagfältet och utmanar ensamma fiender till tvekamp. Varje duell som hon vinner ökar hennes attackskada, tills hon till slut blir en obeveklig enmansarmé."
"npc_dota_hero_leshrac_hype"	"Leshrac har kraftfulla förmågor som ödelägger fiender och deras försvar likaså. Han tar sig långt in i fiendens territorium med sin förödande edikt och splittrar jorden för att bedöva motståndarna, vilket låter hans skoningslösa allierade att göra slut på dem."
"npc_dota_hero_lich_hype"	"Lich, som driver från strid till strid och offrar creeps för mana till sina anfall, är alltid redo att hjälpa sina allierade hjältar förgöra fienden med bromsande köld. Skulle motståndarna vara dåraktiga nog att samla ihop sig, kommer hans studsande ultimata förmåga att försäkra deras undergång."
"npc_dota_hero_life_stealer_hype"	"Skulle Lifestealer komma nära sitt byte så är det inte mycket som kan rädda den. Resandes inuti ett creep eller en allierad hjälte, exploderar han sedan ut från värdkroppen när han närmar sig en fiende och börjar riva denne med sina klor."
"npc_dota_hero_lina_hype"	"Lina är lika dödlig som hon är ömtålig, och kan utan ansträngning dräpa en fiende som är dåraktig nog att bli ertappad ensam. Hon bränner fiender med eld och heta blixtar, och får ökad attackhastighet för varje använd förmåga, vilket ser till att få överlever hennes angrepp."
"npc_dota_hero_lion_hype"	"Lion ger sina fiender få chanser till vedergällning. Han bedövar mål med skadliga taggar eller förvandlar dem temporärt till ofarliga smådjur, och även om hans kraftfulla förmågor inte skulle vara nog, så bör han och hans allierade fortfarande ha all tid de behöver för att dräpa sina fiender."
"npc_dota_hero_lone_druid_hype"	"Med sin kraftfulla själsbjörn vid sin sida i striden, demolerar Lone Druid både fiendens styrkor och byggnader. Han kan byta mellan närkamps- och avståndsattacker efter behov med sin transformation, och har han nog med tid att armera och förstärka både sig själv och sin kompanjon finns det lite som kan stoppa dem."
"npc_dota_hero_luna_hype"	"Då hon hastigt rider in i striden tär sig Luna igenom sina fiender med attacker som kan studsa mellan mål. När fiender hotar åkallar hon månens kraft i form av en enskild kraftig stråle eller i ett angrepp av månstrålar, vilket krossar de fiender som står i hennes väg."
"npc_dota_hero_lycan_hype"	"Som människa eller varg sliter Lycan sönder sina fiender med vassa klor och dödliga käftar. Han kan frammana lömska vargar för att spana eller attackera fiender. Hans vargomvandling ger honom farten och styrkan att springa ikapp sina fiender, eller fly undan ett överfall."
"npc_dota_hero_magnataur_hype"	"Fiender som är dåraktiga nog att klumpa ihop sig lär sig frukta Magnus horn. Han kan dra samman fiender nära honom, han kan hamra dem med förstärkta attacker, eller med sitt horn spetsa dem för att ta fienden till sina skoningslösa allierade."
"npc_dota_hero_medusa_hype"	"Konstant attack är nyckeln till Medusas framgång. Hon klarar sig undan angrepp med sin manasköld och har förmågan att splittra sina skott för att plöja ned fiendens vågor. När hon samlat sig till full styrka blir hon en kraft mäktig nog att stoppa vem som helst."
"npc_dota_hero_meepo_hype"	"Genom att frammana upp till fem permanenta kopior av sig själv kan Meepo slåss på alla fronter samtidigt. Han sprider ut sina kloner över slagfältet, och när en fiende hittas binder han den, samlar sina kopior med en explosiv teleportering, och begraver sedan fiendens rester."
"npc_dota_hero_mirana_hype"	"Då hon siktar från långa avstånd med sin dödliga pil, måste Mirana alltid vara redo att löpa in i strid. Eftersom hon kan gömma sina allierade från fiendens ögon, säkerställer hon att hennes lag alltid är på jakt."
"npc_dota_hero_morphling_hype"	"Genom att skifta sina attribut beroende på situation kan Morphling vara lika undvikande som han är dödlig. Oavsett om han rider en våg för att flankera fienden, eller stärker sin hälsa innan han smiter till sin vilseledande replikation, kan få drömma om att tränga fast honom i ett hörn."
"npc_dota_hero_naga_siren_hype"	"Med sina trupper av speglade kloner snärjer Naga Siren sina fiender och slaktar dem, samtidigt som hon leder sina styrkor till seger. Tack vare hennes röst gör hon det omöjligt för fiender i närheten att lyckas med ett bakhåll eller att fly undan henne."
"npc_dota_hero_furion_hype"	"Oavsett om det är i stridens hetta eller när han samlar resurser till sitt nästa anfall, verkar det som att Natures Prophet är överallt. Genom att teleportera sig var som helst och omedelbart skapa en trupp av våldsamma träd att slåss för honom överfaller han fienden där de minst anar det."
"npc_dota_hero_necrolyte_hype"	"Var än Necrophos vänder, vissnar fienden samtidigt som allierade blomstrar. Han återställer hälsa till sina fiender och skadar fienden med varje dödspuls. Och efter hans närvaro sårat en fiende tillräckligt, framkallar han sin lie för att förlänga tiden de är döda."
"npc_dota_hero_night_stalker_hype"	"Så fort solen gått ner börjar Night Stalkers jakt. Då han rusar genom skogens skuggor snärjer han fiender i en förslöande attack och sliter dem sedan i stycken. Skulle soluppgången hota hans skräckvälde kan han förmörka skyarna för att fortsätta sin slakt."
"npc_dota_hero_nyx_assassin_hype"	"Nyx Assassin är alltid på jakt efter veka byten. Han smyger osynligt genom skogen, och när han fått syn på sitt byte slår han till med sina dödliga klor, spetsar dem på bedövande spikar, och reflekterar sedan fiendens attacker med sitt skyddande skal."
"npc_dota_hero_ogre_magi_hype"	"Med chansen att multiplicera effekten av deras trollformler, är lite tur allt som Ogre Magi behöver för att bränna ned sina fiender, eller förstärka kraften hos deras allierade. Självklart kan det vara svårt att förlita sig på tur..."
"npc_dota_hero_omniknight_hype"	"Som en väktare vid stridens front, är Omniknight alltid redo att ansluta sitt lag i strid. Oavsett om han helar en allierad med en förmåga som även sårar fiender i närheten, eller drämmer till fienden med sin mäktiga hammare, skyddar han sina allierade från skada."
"npc_dota_hero_oracle_hype"	"Genom att varsamt kombinera sina komplicerade förmågor, kontrollerar Oracle ödet hos både fiende och allierad. Med False Promise värnar han om allierade i fara, och kan ge dem en dyrbar stund med skydd för att förstöra en fiende, eller till och med omvända ett hemskt öde."
"npc_dota_hero_obsidian_destroyer_hype"	"Outworld Devourer stjäl från de sinnen han fängslar, och omvandlar rå intelligens till destruktiv styrka. Efter att ha försvagat fienden med ett angrepp av arkanisk energi, krossar han deras sundhet med sin ultimata explosion, och raderar ofta mana från de som skulle överleva."
"npc_dota_hero_phantom_assassin_hype"	"Ögonblicket Phantom Assassin hittar ett byte slår hon till. Hon tar sig omedelbart till ett mål, och undviker attacker med lätthet samtidigt som hon obarmhärtig hugger sina fiender. Utan varning kan en av hennes attacker visa sig vara plötsligt och brutalt dödlig."
"npc_dota_hero_phantom_lancer_hype"	"Phantom Lancer stormar fiendens styrkor med en oändlig mängd kloner. Då han leder sin illusionsarmé kan han skära sönder fiender i ett utlopp av attacker, skicka kloner till fiendens territorium, eller använda sina dubbelgångare för att missleda och fly undan fiender om han skulle omringas."
"npc_dota_hero_phoenix_hype"	"Phoenix dyker in i strid och bränner fiender och helar allierade med solens flammande strålar. När tiden är inne kan Phoenix bli en brinnande sol och sveda fiender i närheten innan en bedövande detonation utlöses, vilket också återställer Phoenix till full styrka."
"npc_dota_hero_puck_hype"	"Puck har en talang för att lura bort sina fiender med lekfulla och smidiga otyg. Genom att teleportera sig till den skadande orben för att färdas korta sträckor, kan Puck attackera fienden med tystnadsstoft. Innan fienden ens hunnit reagera så har Puck redan flytt."
"npc_dota_hero_pudge_hype"	"Varje varsamt siktat kast med Pudges signaturkrok ingiver skräck i fienden. Genom att dra sina fiender till sig och karva dem med sina köttyxor, får han ytterligare hälsa och skada för varje dödad, och blir snart en ostoppbar mördare."
"npc_dota_hero_pugna_hype"	"Pugna är en riktig luring, och använder fiendens kraft mot dem när han förintar deras försvar. Medans hans Nether Ward skadar fiender som törs använda trollformler, suger han livet från fiender för att försäkra sig om att vara redo för nästa anfall."
"npc_dota_hero_queenofpain_hype"	"Queen of Pain slår till utan varning, och förintar hopsamlade fiender med dövande skrik. Skulle en fiende överleva hennes angrepp saktar hon ned dess flykt med sin kastkniv, innan hon slutligen tar kol på dem."
"npc_dota_hero_razor_hype"	"Med en dödlig åskskur till Razors förfogande, vänder han in i striden. Med en svepande ring av elektrisk plasma som steker fienden, länkas han samman med dem för att suga ut kraften för att använda den mot dem."
"npc_dota_hero_riki_hype"	"Riki spanar över stridsfältet, osedd av fienden. Han väljer sina angrepp noggrant och går till anfall med en rökpuff som tystar fienden, och hugger dem sedan innan de ens hinner märka att Riki är där."
"npc_dota_hero_rubick_hype"	"Rubick letar alltid efter nya trollformler att stjäla, och är ivrig att vända fiendens unikaste övertag mot dem. Han lyfter fienden mot luften, och kastar dem sedan dit han vill. Att skapa kaos hos oförsiktiga fiender är ingen utmaning för Rubick."
"npc_dota_hero_sand_king_hype"	"Inte många kan överleva ett bakhåll från Sand King. Han förstör allt runtom sig med sina dödliga chockvågor, han undviker kontringsattacker genom att gömma sig i ett stickigt moln av sand, och han chockar fienden genom att slå till underifrån."
"npc_dota_hero_shadow_demon_hype"	"Det finns få som vågar stå emot Shadow Demon när han spyr ut moln av demoniskt gift för att skada fienden. Genom att förvisa fienden när hans allierade samlas för att slå till kan han påtvinga demoniska förbannelser som framkallar bedragande illusioner av fienden, för att vända deras styrka mot dem."
"npc_dota_hero_nevermore_hype"	"Genom att fånga in själarna från sina offer, ökar Shadow Fiend alltid sin styrka. Varje anfall, varje Raze som dödar en fiende, för honom närmre till att släppa lös sina samlade själar i en dödlig explosion av våldsam energi."
"npc_dota_hero_shadow_shaman_hype"	"Shadow Shaman rensar snabbt vägen för sitt lags trupper att marschera mot fiendebasen. Han attackerar fiender med chockande trollformler och avbryter angrepp med förvandlingar. Hans kraftfulla Serpent Wards förstör fiendens försvar med lättja."
"npc_dota_hero_silencer_hype"	"Silencer förändrar dynamiken i varje strid när han förhindrar fiendens förmåga att använda trollformler. När han skär sina fiender till strimlor med sin glav stjäl han deras intelligens för att använda den själv, vilket gör att hans fiender alltid är i underläge."
"npc_dota_hero_skywrath_mage_hype"	"Lika dödlig som han är skör, förstör Skywrath Mage snabbt sina fiender med mängder av kraftfull magi. Han tystar fienden och ökar deras sårbarhet för trollformler, vilket innebär att han inte har några problem att förånga de som står emot honom."
"npc_dota_hero_slardar_hype"	"Redo att demolera sina fiender, slingrar sig Slardar in i strid. Efter att ha undanröjt en fiendes position och krossat deras försvar, tar han sig ikapp dem och låser fast dem på plats med krossande slag och kraftfulla Bashes från sin treudd."
"npc_dota_hero_slark_hype"	"Att kasta sig in i striden och sedan smita ut igen är det Slark gör bäst. Han rusar in när han får chansen att nåla fast eller tränga in en ensam fiende. Han stjäl deras essens med varje hugg av sin dolk, och är alltid redo att försvinna om situationen skulle vända."
"npc_dota_hero_sniper_hype"	"Att döda från avstånd är Snipers specialitet. Han håller fienden på tå med ständig spärreld för att sedan, när tiden är inne, fälla dem med ett dödande skott."
"npc_dota_hero_spectre_hype"	"Spectre hemsöker sina fiender oavsett var de är. Hon kan enkelt dräpa ett ensamt byte och sprider sin närvaro över slagfältet för att välja sitt mål. När Spectre har samlat sina krafter kan ingen komma undan hennes förskräckliga vrede."
"npc_dota_hero_spirit_breaker_hype"	"Högst mobil och ständigt aggresiv rusar Spirit Breaker över slagfältet för att ta striden till sina fiender. Med varje Bash från sin tunga lykta knockar han sina fiender medvetslösa. Hans fiender kanske kan fly, men med hjälp av Wards kan de inte gömma sig."
"npc_dota_hero_storm_spirit_hype"	"Storm Spirit är aldrig den som missar en strid. Då han zippar över slagfältet i en blixt, slår han fienden från alla håll med exploderande lämningar och laddade attacker, för att sedan försvinna innan fienden knappt hunnit reagera."
"npc_dota_hero_sven_hype"	"Sven är alltid villig att rusa in i strid. Han chockar grupperade fiender när han träder in i strid, och när han aktiverar sin skadeökande ultimata är några svingar med det mäktiga svärdet ofta mer än tillräckligt för att dräpa sina fiender."
"npc_dota_hero_techies_hype"	"För Techies handlar strid om sattyg. De fnittrar när de lägger fällor över slagfältet, och deras explosiva minor, chockfällor, och fjärraktiverade bomber är ofta mer än tillräckligt för att överraska oaktsamma fiender eller krossa en fiendeoffensiv."
"npc_dota_hero_templar_assassin_hype"	"Templar Assassin fyller slagfältet med slöande fällor, och gömmer sig i osynlighet för att överrumpla sina byten. När hon går till attack sliter hon fienden i stycken med genomträngande Psi Blades, och avleder kontringsattacker med hennes refraktorsköld."
"npc_dota_hero_terrorblade_hype"	"Med Terrorblade är inget som det verkar. Han kan framkalla kraftfulla illusioner för att förvirra fienden och krossa deras försvar. Demonmarodören kan byta hälsa med fiender och allierade för att klara sig undan döden eller försvaga sina fiender."
"npc_dota_hero_tidehunter_hype"	"Tidehunter rör sig framför sitt lag och letar ständigt efter det rätta tillfället att slå till. När stunden kommer, släpper han lös sin massiva och förödande ultimata förmåga, som gör det lätt för hans allierade att dräpa sina bedövade fiender."
"npc_dota_hero_shredder_hype"	"Flyktig och oförutsägbar är Timbersaw, som hugger sig fram genom skogen för att möta sina motståndare. En arsenal av sågklingor skär fiender till bitar, och kedjan låter honom dra sig till träd och drämma till fiender på vägen."
"npc_dota_hero_tinker_hype"	"Tinker gör slut på sina fiender med maskinsvärmar och en uppsättning av dödliga manicker. Tillåts han samla på sig tillgångarna som han behöver, kommer det i kombination med kraften att omedelbart återställa sina förmågor att låta honom leda sitt lag på alla fronter."
"npc_dota_hero_tiny_hype"	"Styrkan och storleken hos Tiny växer medan striden fortgår och kan snabbt bli skrämmande. Han kastar hjältar och creeps på sina fiender, eller bedövar dem under en lavin. Når Tiny sin fulla styrka kan han demolera fiendens bas med lätthet."
"npc_dota_hero_treant_hype"	"Treant Protector är alltid en välvillig allierad som beskyddar sina anhängare och deras byggnader med regenererande pansar. Han kan träda fram från träden osedd och snärja fast sina motståndare, och sedan dra hälsa från fiender till allierade i närheten."
"npc_dota_hero_troll_warlord_hype"	"Att omedelbart kunna byta mellan avstånds- och närstridattacker gör Troll Warlord till en formidabel styrka på alla avstånd. Med yxor i hand kan han slå till i en storm av snurrande klingor. Han tar ned sina fiender med attacker som blir allt snabbare, och kan även göra sina allierades attacker snabbare var de än är."
"npc_dota_hero_tusk_hype"	"Tusk är alltid angelägen att påbörja ett slagsmål. Efter att ha stängt in en fiende med en vägg av isbitar, samlar han sina allierade och rullar in i striden inuti en massiv snöboll, vilket får honom att komma nära nog att utdela sitt berömda knockoutslag."
"npc_dota_hero_undying_hype"	"Undying vacklar in i striden och tvingar fiender att ta beslutet om de ska fly från hans vrede eller slitas sönder av den. Han stjäl styrkan från sina motståndare och framkallar en hord av ilskna odöda. När han slutligen förvandlas till en stor köttgolem, kan hans fiender redan vara överväldigade."
"npc_dota_hero_ursa_hype"	"För varje svep med sina klor gör Ursa sitt mål mer sårbart för nästa attack. Med förmågan att snabbt öka hur snabbt han kan slå, tillsammans med förmågan att sakta ned ett byte i närheten, gör att han snabbt kan riva sönder sina fiender."
"npc_dota_hero_vengefulspirit_hype"	"Närvaron till Vengeful Spirit känns hela tiden, oavsett om hon lever eller är död. Kapabel att byta plats med en hjälte i närheten, bedöva fiender och reducera effektiviteten hos den som dödade henne, gör att hon konstant orsakar förvirring och kaos för sina motståndare."
"npc_dota_hero_venomancer_hype"	"Venomancer ger sina fiender en långsam död. Han odlar ändlöst en armé av giftspottande väktare som försvarar sitt territorium, och skulle fiender komma honom nära så släpper han lös ett massivt moln av långvarigt gift som försvagar dem."
"npc_dota_hero_viper_hype"	"Giftattacker på avstånd gör Viper till ett allvarligt hot för vem som helst han siktar på. Medan olika toxiner fräter bort en fiendes hälsa och saktar ned dennes förflyttning, gör Viper helt enkelt det som han gör bäst: lägger till mer gift."
"npc_dota_hero_visage_hype"	"Medan hans dödliga följeslagare spanar av slagfältet, rustar Visage sig själv med pansar och söker upp nästa strid. När han väl är i närheten samlar han på sig själsenergi från skada som tagits av slagkämpar i närheten innan han släpper lös den i en förödande attack."
"npc_dota_hero_warlock_hype"	"Warlock kan framkalla sin demoniska golem och förgöra sina fiender och deras försvar. Även utan sin golem kan hans mörka trollformler sprida förödelse, som att kunna hela allierade eller skada fiender med ett ord, eller binda samman fiender för att dela sin vånda."
"npc_dota_hero_weaver_hype"	"Weaver har inga problem med att undvika fiender för att hitta ett nytt ställe att anfalla ifrån. Han glider in och ut ur syne och undviker döden genom att spola tillbaka tiden för sig själv till en tidigare plats och hälsotillstånd. Hans uppsättning av flyktiga förmågor ser till att han alltid är en farlig plåga för sina motståndare."
"npc_dota_hero_windrunner_hype"	"Snabb och svårfångad är den viga Windranger som alltid letar efter den rätta vinkeln att attackera ifrån. Oavsett om hon banar väg med sin dödliga Powershot eller binder ihop fiender för att sedan peppra dem med pilar, så är hon alltid i farten."
"npc_dota_hero_winter_wyvern_hype"	"Winter Wyvern flyger över slagfältet och saktar ned sina motståndare med en brännande kyla. Skulle fienden vara dåraktig nog att samla ihop sig så förbannar hon dem till att attackera en av sina egna, och söndrar sedan gruppen med splitter av is."
"npc_dota_hero_witch_doctor_hype"	"Witch Doctor gör vad som krävs för sitt lag. Kapabel att hela sina allierade, bedöva och förbanna fiender för att säkra deras undergång, eller själv förgöra sina fiender med sin ultimata förmåga, är det få som kan matcha Witch Doctors mångsidighet."
"npc_dota_hero_skeleton_king_hype"	"Wraith King går in i striden utan fruktan för att bedöva sina fiender och sedan hugga dem till underkastelse. Skulle hans fiender få övertaget kommer hans återupplivande ultimata förmåga att se till att han får en till chans att svinga sitt svärd."
"npc_dota_hero_zuus_hype"	"Ingen kan gömma sig för Zeus, oavsett när han kallar ned en blixt för att få uppsyn över omgivningen, skickar en kedjeblixt som går igenom hans närmsta fiender, eller framkallar ett mäktigt blixtregn som träffar alla fiender. Det spelar ingen roll var hans fiender är, för Zeus kommer hitta dem."
"DOTA_AbilityTooltip_Name"	"{s:name}"
"DOTA_AbilityTooltip_Level"	"Nivå {s:level}"
"DOTA_AbilityTooltip_TargetType"	"PÅVERKAR: {s:targettype}"
"DOTA_AbilityTooltip_CastType"	"FÖRMÅGA: {s:casttype}"
"DOTA_AbilityTooltip_DamageType"	"SKADETYP: {s:damagetype}"
"DOTA_AbilityTooltip_SpellImmunityType"	"FÖRMÅGEIMMUNITET: {s:spellimmunity}"
"DOTA_AbilityTooltip_Description"	"{s:description}"
"DOTA_AbilityTooltip_ScepterDescription"	"{s:scepterdescription}"
"DOTA_AbilityTooltip_ExtraDescription"	"{s:extradescription}"
"DOTA_AbilityTooltip_Attributes"	"{s:attributes}"
"DOTA_AbilityTooltip_Cooldown"	"{s:cooldown}"
"DOTA_AbilityTooltip_ManaCost"	"{s:manacost}"
"DOTA_AbilityTooltip_Lore"	"{s:lore}"
"DOTA_AbilityTooltip_UpgradeLevel"	"Nästa uppgradering vid hjältenivå {d:upgradelevel}"
"DOTA_AbilityTooltip_BuildHeader"	"Förmågeguide"
"DOTA_AbilityTooltip_BuildComment"	"{s:buildcomment}"
"DOTA_PersonaTooltip_Title"	"{g:dota_persona:account_id}"
"DOTA_PersonaTooltip_TitlePro"	"{g:dota_persona_pro:account_id}"
"DOTA_PendingInvites"	"Gruppinbjudningar"
"DOTA_PendingInvitesTooltip_None"	"Inga mottagna inbjudningar"
"DOTA_PendingInvitesTooltip_1"	"1 mottagen inbjudan"
"DOTA_PendingInvitesTooltip_N"	"{d:pending_invite_count} mottagna inbjudningar"
"DOTA_PendingInvitesTooltip_Leader"	"Klicka för att hantera inbjudningar."
"DOTA_PendingInvitesTooltip_NonLeader"	"Klicka för att visa inbjudningar."
"DOTA_PendingInvitesCancelAll"	"Avbryt alla inbjudningar"
"DOTA_PendingInvitesNotPartyLeader"	"Endast gruppledaren kan hantera inbjudningar"
"DOTA_ChatTab_NotInChannelMessage"	"Ingen hör dig."
"DOTA_ChatTab_ToggleGlobal"	"Visa meddelanden från denna kanal i alla flikar."
"DOTA_ChatTab_Close"	"Stäng denna flik."
"DOTA_ChatTab_Leave"	"Lämna denna kanal."
"DOTA_JoinChatChannel_Title"	"Gå med i kanal"
"DOTA_JoinChatChannel_Description"	"Skapa eller gå med i en chattkanal."
"DOTA_JoinChatChannel_AddToCurrentTab"	"Lägg till den nuvarande fliken '{s:current_tab_name}'"
"DOTA_JoinChatChannel_CreateNewTab"	"Skapa en ny flik:"
"DOTA_Chat_ChannelName"	"{s:channel_name}"
"DOTA_Chat_ChannelMemberCount_Singular"	"1 medlem"
"DOTA_Chat_ChannelMemberCount_Plural"	"{d:channel_member_count} medlemmar"
"DOTA_EditChatTab_Title"	"Modifiera chattflik"
"DOTA_EditChatTab_Description"	"Välj vilka chattmeddelanden som ska visas i denna flik."
"DOTA_EditChatTab_AddNewChannel"	"Lägg till en ny kanal..."
"DOTA_EditChatTab_TabName"	"Fliknamn:"
"DOTA_EditChatTab_ChannelToggleDisabled"	"{s:target} måste alltid vara i åtminstone en flik."
"DOTA_EditChatTab_Target"	"{s:target}"
"DOTA_Chat_TimestampFormat"	"{t:t:timestamp}"
"DOTA_Chat_Autocomplete_Title"	"{s:autocomplete_title}"
"DOTA_Chat_Autocomplete_NoMatches"	"Inga matchningar"
"DOTA_Chat_Autocomplete_WhisperFriends"	"Viska till en vän"
"DOTA_Chat_Autocomplete_InviteFriends"	"Bjud in en vän"
"DOTA_Chat_Autocomplete_Channels"	"Kanaler"
"DOTA_Chat_Autocomplete_Commands"	"Kommandon"
"DOTA_Chat_Autocomplete_CommandName"	"/{s:command_name}"
"DOTA_Chat_Autocomplete_CommandDescription"	"{s:command_description}"
"dota_suggest_invite_format"	"Snälla bjud in %s1 till gruppen."
"dota_suggest_invite_format_leader"	"Snälla bjud in {s:invite_persona} till gruppen. ( <a href=\"event:DOTAInviteToParty({s:invite_persona_steamid})\" class=\"InviteButton\">Skicka inbjudan</a> )"
"dota_suggest_invite_format_lobby"	"Snälla bjud in {s:invite_persona} till lobbyn."
"dota_suggest_invite_format_lobby_leader"	"Snälla bjud in {s:invite_persona} till lobbyn. ( <a href=\"event:DOTAInviteToLobby({s:invite_persona_steamid})\" class=\"InviteButton\">Skicka inbjudan</a> )"
"DOTA_ChatMessage_Default"	"<span class=\"{s:target_class} {s:sender_class} {s:visitor_class}\"><span class=\"ChatTarget\">({s:target})</span> <span class=\"ChatPersona\">{s:event_crest}{s:persona}</span>: {g:dota_filtered_string:message}</span>"
"DOTA_ChatMessage_WhisperTo"	"<span class=\"{s:target_class} {s:sender_class} {s:visitor_class}\">Till <span class=\"ChatPersona\">{s:event_crest}{s:persona}</span>: {g:dota_filtered_string:message}</span>"
"DOTA_ChatMessage_WhisperFrom"	"<span class=\"{s:target_class} {s:sender_class} {s:visitor_class}\">Från <span class=\"ChatPersona\">{s:event_crest}{s:persona}</span>: {g:dota_filtered_string:message}</span>"
"DOTA_ChatMessage_System"	"<span class=\"{s:target_class} {s:sender_class} {s:visitor_class}\"><span class=\"ChatTarget\">({s:target})</span>: {g:dota_filtered_string:message}</span>"
"DOTA_ChatTarget_Format_Default"	"{s:target}"
"DOTA_ChatTarget_Prompt_Default"	"Till ({s:target}):"
"DOTA_ChatTarget_Format_Whisper"	"{s:persona}"
"DOTA_ChatTarget_Prompt_Whisper"	"Till [{s:persona}]:"
"DOTA_ChatTarget_Party"	"Grupp"
"DOTA_ChatTarget_Lobby"	"Lobby"
"DOTA_ChatTarget_Team"	"Lag"
"DOTA_ChatTarget_Guild"	"Gille"
"DOTA_ChatTarget_Fantasy"	"Fantasi"
"DOTA_ChatTarget_Console"	"Konsol"
"DOTA_ChatTarget_Whisper"	"Viska"
"DOTA_ChatTarget_Invalid"	"Ingen kanal"
"DOTA_ChatTarget_GameAll"	"Alla"
"DOTA_ChatTarget_GameAllies"	"Allierade"
"DOTA_ChatTarget_GameCoaching"	"Coachning"
"DOTA_ChatTarget_GameSpectator"	"Åskådare"
"DOTA_ChatTargetMenu_Title"	"{s:target}"
"DOTA_ChatTargetMenu_ToggleEnabled"	"{s:toggle_enabled}"
"DOTA_ChatTargetMenu_NotActive"	"(Ej aktiv)"
"DOTA_Chat_Placeholder"	"Skriv här för att chatta. Använd '/' för kommandon."
"DOTA_Chat_MissedMessages"	"{s:missed_message_count}"
"DOTA_ChatCommand_Party"	"p"
"DOTA_ChatCommand_Party_Name"	"Grupp"
"DOTA_ChatCommand_Party_Description"	"Chatta med din nuvarande grupp."
"DOTA_ChatCommand_Lobby"	"l"
"DOTA_ChatCommand_Lobby_Name"	"Lobby"
"DOTA_ChatCommand_Lobby_Description"	"Chatta med din nuvarande lobby."
"DOTA_ChatCommand_Channel"	"c"
"DOTA_ChatCommand_Channel_Name"	"Kanal"
"DOTA_ChatCommand_Channel_Description"	"Chatta med en specifik chattkanal."
"DOTA_ChatCommand_Whisper"	"w"
"DOTA_ChatCommand_Whisper_Name"	"Viska"
"DOTA_ChatCommand_Whisper_Description"	"Viska privat med en vän."
"DOTA_ChatCommand_Reply"	"r"
"DOTA_ChatCommand_Reply_Name"	"Svara"
"DOTA_ChatCommand_Reply_Description"	"Svara på en viskning som skickats privat från en vän."
"DOTA_ChatCommand_Help"	"?"
"DOTA_ChatCommand_Help_Name"	"Hjälp"
"DOTA_ChatCommand_Help_Description"	"Visa hjälp för chattkommandon."
"DOTA_ChatCommand_InviteToParty"	"partyinvite"
"DOTA_ChatCommand_InviteToParty_Name"	"Bjud in till grupp"
"DOTA_ChatCommand_InviteToParty_Description"	"Bjud in en vän till din nuvarande grupp."
"DOTA_ChatCommand_LeaveParty"	"leaveparty"
"DOTA_ChatCommand_LeaveParty_Name"	"Lämna grupp"
"DOTA_ChatCommand_LeaveParty_Description"	"Lämna din nuvarande grupp."
"DOTA_ChatCommand_JoinChannel"	"joinchannel"
"DOTA_ChatCommand_JoinChannel_Name"	"Gå med i kanal"
"DOTA_ChatCommand_JoinChannel_Description"	"Gå med eller skapa en chattkanal."
"DOTA_ChatCommand_LeaveChannel"	"leavechannel"
"DOTA_ChatCommand_LeaveChannel_Name"	"Lämna kanal"
"DOTA_ChatCommand_LeaveChannel_Description"	"Lämna en specifik chattkanal."
"DOTA_ChatCommand_GameAll"	"all"
"DOTA_ChatCommand_GameAll_Name"	"Alla"
"DOTA_ChatCommand_GameAll_Description"	"Chatta med alla spelare i spelet."
"DOTA_ChatCommand_GameAllies"	"allies"
"DOTA_ChatCommand_GameAllies_Name"	"Allierade"
"DOTA_ChatCommand_GameAllies_Description"	"Chatta med dina allierade."
"DOTA_ChatCommand_GameCoaching"	"coach"
"DOTA_ChatCommand_GameCoaching_Name"	"Coachning"
"DOTA_ChatCommand_GameCoaching_Description"	"Chatta med din elev eller coach."
"DOTA_ChatCommand_GameSpectator"	"spectator"
"DOTA_ChatCommand_GameSpectator_Name"	"Åskådare"
"DOTA_ChatCommand_GameSpectator_Description"	"Chatta med övriga åskådare."
"DOTA_ChatCommand_Clear"	"clear"
"DOTA_ChatCommand_Clear_Name"	"Rensa"
"DOTA_ChatCommand_Clear_Description"	"Rensa all synlig chatt i denna flik."
"DOTA_Chat_UnknownCommandMessage"	"Okänt chattkommando '{s:chat_command}'"
"DOTA_ChatHelp_Targets"	"Mål"
"DOTA_ChatHelp_Commands"	"Kommandon"
"DOTA_ChatHelp_NameFormat"	"{s:command_name}:"
"DOTA_ChatHelp_CommandFormat"	"/{s:command}"
"DOTA_Chat_JoinedParty"	"Gick med i en grupp: {s:party_members}"
"DOTA_Chat_LeftParty"	"Gruppen upplöstes."
"DOTA_Chat_MemberJoinedParty"	"Spelare gick med i gruppen: {s:party_members}"
"DOTA_Chat_MemberLeftParty"	"Spelare lämnade gruppen: {s:party_members}"
"DOTA_Chat_InvitedToJoinParty"	"Bjöd in: {s:party_members}"
"DOTA_Chat_RequestedToJoinParty"	"Begärde att få gå med: {s:party_members}"
"DOTA_Chat_PartyMemberSeparator"	", "
"DOTA_Feature_Under_Construction_Title"	"Under konstruktion"
"DOTA_Feature_Under_Construction_Text"	"Denna funktion är under konstruktion och är ej tillgänglig ännu."
"DOTA_Treasure_Purchase_Under_Construction_Text"	"Köp av skatter är ännu inte tillgängligt, men köp från Dota-butiken stöds. Se föremålsset längst till vänster på listan över tillgängliga föremålsset."
"DOTA_Marketplace_Purchase_Under_Construction_Text"	"Köp på marknaden är ännu inte tillgängligt, men köp från Dota-butiken stöds. Se föremålsets längs till vänster på listan över tillgängliga föremålsets."
"DOTA_PartyJoinRequest_Title"	"Begär gruppinbjudan"
"DOTA_PartyJoinRequest_Description"	"{g:dota_persona:b:inviter} begär inbjudan till din grupp."
"DOTA_PartyMergeRequest_Title"	"Begär gruppsammanslagning"
"DOTA_PartyMergeRequest_Description"	"{g:dota_persona:b:inviter} begär att deras grupp får slå sig samman med er grupp."
"DOTA_PartyMergeRequestLowPriWarning"	"OBS: om du accepterar denna begäran kommer er grupp att få lågprioritetsstatus."
"DOTA_PartyInvite_Title"	"Gruppinbjudan"
"DOTA_Invite_IOfN"	"{d:received_invite_index} av {d:received_invite_count}"
"DOTA_PartyInvite_Description"	"{g:dota_persona:b:inviter} har bjudit in dig till en grupp."
"DOTA_PartyInvite_LowPriority_Title"	"Lågprioritet - Gruppinbjudan"
"DOTA_PartyInvite_LowPriority_Description"	"{g:dota_persona:b:inviter} har bjudit in dig till en lågprioriterad grupp."
"DOTA_PartyInvite_BlockPartyLeader"	"Blockera all kommunikation från {g:dota_persona:b:inviter}"
"DOTA_LobbyInvite_BlockInviter"	"Blockera all kommunikation från denna spelare"
"DOTA_PartyInvite_BlockNonFriendInvites"	"Blockera inbjudningar från spelare som inte är vänner"
"DOTA_PartyInvite_BlockNonFriendInvitesDescription"	"Kan ändras under Alternativ/Profil i Inställningspanelen"
"DOTA_PartyInvite_Expired"	"Begäran har upphävts eller är inte längre giltig."
"DOTA_PartyInvite_Coach"	"Coach:"
"DOTA_PartyVisTooltip_TitleOpen"	"Söker gruppmedlemmar"
"DOTA_PartyVisTooltip_TitleNotOpen"	"Söker inte gruppmedlemmar"
"DOTA_PartyVisTooltip_SoloNotOpen"	"Klicka för att ändra din status."
"DOTA_PartyVisTooltip_SoloOpen"	"Vänner kan begära inbjudan.<br/>Klicka för att ändra din status."
"DOTA_PartyVisTooltip_LeaderOpen"	"Inbjudningsbegäran från gruppmedlemmars vänner accepteras automatiskt.<br/>Klicka för att stänga av statusen Öppen Grupp."
"DOTA_PartyVisTooltip_LeaderOpenManualAccept"	"Gruppmedlemmars vänner kan begära inbjudan.<br/>Klicka för att stänga av statusen Öppen Grupp."
"DOTA_PartyVisTooltip_LeaderNotOpen"	"Gruppmedlemmars vänner kan begära inbjudan.<br/>Klicka för att sätta på statusen Öppen Grupp, som ökar synligheten till vänner."
"DOTA_PartyVisTooltip_NotOpenHidden"	"Du gömmer din medlemskap i denna grupp för dina vänner, i enlighet med dina sekretessinställningar<br/>OBS: Övriga gruppmedlemmar kan låta sina vänner se gruppen och begära inbjudan."
"DOTA_PartyVisTooltip_NonLeaderOpen"	"Inbjudningsbegäran från vänner.<br/>Klicka för att stänga av statusen Öppen Grupp."
"DOTA_PartyVisTooltip_NonLeaderNotOpen"	"Gruppmedlemmars vänner kan begära inbjudan.<br/>Endast gruppledaren kan acceptera inbjudningsbegäran.<br/>Klicka för att sätta på statusen Öppen Grupp, vilket ökar synligheten till vänner."
"DOTA_TogglePartyOpenMic_Tooltip"	"Växla Open Mic för grupp"
"DOTA_PartySettings"	"Gruppinställningar"
"DOTA_PartySettings_OpenParty"	"Öppna denna grupp för inbjudningsbegäran"
"DOTA_PartySettings_BroadcastToFriends"	"Låt mina vänner se när jag är i en grupp"
"DOTA_PartySettings_OpenState_NotOpen"	"Gruppledaren har inte markerat gruppen som öppen för inbjudningsbegäran."
"DOTA_PartySettings_OpenState_NotOpenLeader"	"Denna grupp är inte öppen för inbjudningsbegäran."
"DOTA_PartySettings_OpenState_OpenButHiddenFromFriends"	"Denna grupp är öppen för inbjudningsbegäran. Du publicerar inte denna grupp för dina vänner, men den kan vara synlig för andra gruppmedlemmars vänner."
"DOTA_PartySettings_OpenState_Open"	"Denna grupp är öppen för inbjudningsbegäran och är synlig för dina vänner. Den kan också vara synlig för andra gruppmedlemmars vänner."
"DOTA_LobbyInvite_Title"	"Lobbyinbjudan"
"DOTA_LobbyInvite_Description"	"{g:dota_persona:inviter} har bjudit in dig till en lobby."
"DOTA_PartyJoinedLobby_Title"	"Gick med i lobby"
"DOTA_PartyJoinedLobby_Generic"	"{s:party_leader} har flyttat dig till en lobby."
"DOTA_PartyJoinedLobby_Custom"	"{s:party_leader} har flyttat dig till en lobby för {s:custom_game}."
"DOTA_PartyLeader"	"Gruppledare"
"DOTA_LobbyKicked_Header"	"Utsparkad från lobbyn"
"DOTA_LobbyKicked_Message"	"Du blev utsparkad från spellobbyn av lobbyledaren."
"DOTA_PlayerContextMenu_ViewProfile"	"Visa profil"
"DOTA_PlayerContextMenu_ChatWithPlayer"	"Skicka meddelande"
"DOTA_PlayerContextMenu_InviteToParty"	"Bjud in till grupp"
"DOTA_PlayerContextMenu_SuggestInviteToParty"	"Föreslå inbjudan till grupp"
"DOTA_PlayerContextMenu_KickFromParty"	"Sparka ut från gruppen"
"DOTA_PlayerContextMenu_SetPartyLeader"	"Ange gruppledare"
"DOTA_PlayerContextMenu_LeaveParty"	"Lämna gruppen"
"DOTA_PlayerContextMenu_CoachParty"	"Coacha denna grupp"
"DOTA_PlayerContextMenu_StopCoachingParty"	"Sluta coacha denna grupp"
"DOTA_PlayerContextMenu_AddFriend"	"Lägg till vän"
"DOTA_PlayerContextMenu_RemoveFriend"	"Ta bort vän"
"DOTA_PlayerContextMenu_AcceptFriendRequest"	"Acceptera vänförfrågan"
"DOTA_PlayerContextMenu_IgnoreFriendRequest"	"Ignorera vänförfrågan"
"DOTA_PlayerContextMenu_Spectate"	"Titta på match"
"DOTA_PlayerContextMenu_InviteToLobby"	"Bjud in till lobby"
"DOTA_PlayerContextMenu_SuggestInviteToLobby"	"Föreslå inbjudan till lobby"
"DOTA_PlayerContextMenu_KickFromLobby"	"Sparka ut från lobby"
"DOTA_PlayerContextMenu_KickFromLobbyTeam"	"Sparka ut från lobbylag"
"DOTA_FeaturedHero_UnableToLoad"	"Kunde inte läsa in hjältar i fokus."
"DOTA_FeaturedHero_ViewGrid"	"Visa rutnät"
"DOTA_FeaturedHero_HeroName"	"{s:hero_name}"
"DOTA_FeaturedHero_ItemName"	"{g:dota_item_name:item_def}"
"DOTA_FeaturedHeroReason_NewHero"	"Nyligen släppt hjälte"
"DOTA_FeaturedHeroReason_NewItem"	"Ny {s:item_rarity}"
"DOTA_FeaturedHeroReason_FrequentlyPlayedHero"	"För att du har spelat"
"DOTA_FeaturedHeroReason_FeaturedItem"	"Artikel i fokus"
"DOTA_FeaturedHeroReason_PopularItem"	"Bästsäljare"
"DOTA_FeaturedHeroReason_SaleItem"	"På rea nu"
"DOTA_NewFeaturedHero_WinterWyvern"	"På en kall vind kommer vinterdraken."
"DOTA_HeroSelectorCategory_Default"	"Alla hjältar"
"DOTA_HeroSelectorCategory_NewItems"	"Nya artiklar"
"DOTA_HeroSelectorCategory_Favorites"	"Favoriter"
"DOTA_HeroSelectorCategory_MostPlayed"	"Mina mest spelade"
"DOTA_HeroSelectorCategory_LeastPlayed"	"Mina minst spelade"
"DOTA_HeroSelectorCategory_HaveItems"	"Jag har artiklar till"
"DOTA_HeroSelectorCategory_PrimaryAttribute_Strength"	"Styrka"
"DOTA_HeroSelectorCategory_PrimaryAttribute_Agility"	"Agility"
"DOTA_HeroSelectorCategory_PrimaryAttribute_Intelligence"	"Intelligens"
"DOTA_HeroSelectorCategory_AttackRange_Melee"	"Närstrid"
"DOTA_HeroSelectorCategory_AttackRange_Ranged"	"Avstånd"
"DOTA_HeroSelector_SelectHero_Label"	"Välj"
"DOTA_HeroSelector_ClearFilters"	"Rensa filter"
"DOTA_OwnedItemSet_Selector_Title"	"Ägs"
"DOTA_EquippedItemSet_Selector_Title"	"Utrustad"
"DOTA_OwnedItemSet_Available_Title"	"Tillgängliga"
"DOTA_FeaturedItemSet_Selector_Title"	"I fokus"
"DOTA_AllItemSet_Selector_Title"	"Alla"
"DOTA_ConfirmLANLobby_title"	"LOKAL LOBBY"
"DOTA_ConfirmLANLobby_desc"	"En lokal match skapas på din dator. Systemkraven är högre för värden till en lokal match."
"DOTA_ConfirmLANLobbyDisconnect_title"	"Avsluta lokal lobby?"
"DOTA_ConfirmLANLobbyDisconnect_desc"	"Din dator är värd för denna lobbymatch, om du kopplar ifrån kommer matchen att avslutas för alla spelare. Fortsätta?"
"DOTA_ConfirmLANLobbyDisconnect_ok"	"Ja, koppla från"
"DOTA_Lobby_Settings_General"	"ALLMÄNNA LOBBYINSTÄLLNINGAR"
"DOTA_Lobby_Settings_Required"	"OBLIGATORISK"
"DOTA_Lobby_Settings_Confirm"	"{s:lobby_confirm_label}"
"DOTA_Lobby_Settings_Game_Mode"	"SPELLÄGE"
"DOTA_Lobby_Settings_Region"	"SERVERPLATS"
"DOTA_Lobby_Settings_Password"	"LÖSENORD FÖR LOBBY"
"DOTA_Lobby_Settings_Game_Name"	"SPELNAMN"
"DOTA_Lobby_Settings_Advanced"	"AVANCERADE LOBBYINSTÄLLNINGAR"
"DOTA_Lobby_Settings_Competitive"	"TÄVLING"
"DOTA_Lobby_Settings_Starting_Team"	"BÖRJANDE LAG"
"DOTA_Lobby_Settings_Starting_Team_Random"	"SLUMPVALT"
"DOTA_Lobby_Settings_Starting_Team_Radiant"	"RADIANT"
"DOTA_Lobby_Settings_Starting_Team_Dire"	"DIRE"
"DOTA_Lobby_Settings_Penalty_Radiant"	"STRAFF - RADIANT"
"DOTA_Lobby_Settings_Penalty_Dire"	"STRAFF - DIRE"
"DOTA_Lobby_Settings_Penalty_Level_0"	"Inget straff"
"DOTA_Lobby_Settings_Penalty_Level_1"	"-30 sek förbjudfas"
"DOTA_Lobby_Settings_Penalty_Level_2"	"-70 sek förbjudfas"
"DOTA_Lobby_Settings_Penalty_Level_3"	"-110 sek förbjudfas"
"DOTA_Lobby_Settings_Penalty_Tooltip"	"I Kaptensläge reducerar detta antalet sekunder i förbjudfasen för detta lag."
"DOTA_Lobby_Settings_Series_Type"	"SERIETYP"
"DOTA_Lobby_Settings_No_Series"	"INGEN SERIE"
"DOTA_Lobby_Settings_Series_Best_of_3"	"BÄST AV 3"
"DOTA_Lobby_Settings_Series_Best_of_5"	"BÄST AV 5"
"DOTA_Lobby_Settings_Gameplay_Rules"	"SPELREGLER"
"DOTA_Lobby_Settings_Enable_Cheats"	"AKTIVERA FUSK"
"DOTA_Lobby_Settings_All_Chat"	"CHATT MED ALLA"
"DOTA_Lobby_Settings_Fill_Bots"	"FYLL TOMMA PLATSER MED BOTTAR"
"DOTA_Lobby_Settings_Bot_Difficulty"	"BOTTARS SVÅRIGHETSGRAD"
"DOTA_Lobby_Settings_Bot_Difficulty_Passive"	"PASSIV"
"DOTA_Lobby_Settings_Bot_Difficulty_Easy"	"LÄTT"
"DOTA_Lobby_Settings_Bot_Difficulty_Medium"	"MEDEL"
"DOTA_Lobby_Settings_Bot_Difficulty_Hard"	"SVÅR"
"DOTA_Lobby_Settings_Bot_Difficulty_Unfair"	"ORÄTTVIS"
"DOTA_Lobby_Settings_Version"	"VERSION"
"DOTA_Lobby_Settings_Version_Latest"	"SENASTE"
"DOTA_Lobby_Settings_Version_Tournament"	"TURNERING"
"DOTA_Lobby_Settings_Spectator_Section"	"ÅSKÅDARE"
"DOTA_Lobby_Settings_Dota_TV_Delay"	"DOTA TV-FÖRDRÖJNING"
"DOTA_Lobby_Settings_Dota_TV_Delay_2_Minutes"	"2 minuter"
"DOTA_Lobby_Settings_Dota_TV_Delay_5_Minutes"	"5 minuter"
"DOTA_Lobby_Settings_Dota_TV_Delay_10_Seconds"	"10 sekunder"
"DOTA_Lobby_Settings_Spectators"	"ÅSKÅDARE"
"DOTA_Lobby_Settings_Spectators_Enabled"	"AKTIVERAT"
"DOTA_Lobby_Settings_Spectators_Disabled"	"INAKTIVERAT"
"dota_lobby_settings_hide_password"	"Dölj lösenord"
"dota_lobby_settings_local_host"	"Lokal värd"
"DOTA_Lobby_Settings_Visibility"	"Lobbysynlighet"
"DOTA_Lobby_Settings_Visibility_Public"	"Allmän"
"DOTA_Lobby_Settings_Visibility_Friends"	"Vänner"
"DOTA_Lobby_Settings_Visibility_Unlisted"	"Olistad"
"DOTA_Lobby_Settings_Visibility_Tooltip"	"Kontrollerar var lobbyn är synlig. Offentliga lobbyer är synliga i lobbybläddraren och i vänlistan. Vänlobbyer syns endast för vänner, fast andra spelare kan bjudas in. Olistade lobbyer är varken synliga i bläddraren eller i vänlistan."
"DOTA_TeamUnsetHeader"	"Lag ej angivet"
"DOTA_TeamUnsetMessage"	"Minst ett lag har inte valt lagnamn/-logga. Vill du verkligen börja matchen?"
"DOTA_LeagueUnsetHeader"	"Liga ej vald"
"DOTA_LeagueUnsetMessage"	"Ingen liga är vald för denna lobby, men du kan välja en. Starta match ändå?"
"DOTA_LobbyAllowSpectatingHeader"	"Kunde inte starta lobbymatch"
"DOTA_LobbyAllowSpectatingMessage"	"Matchen måste vara inställd för att tillåta åskådare när det finns åskådare i lobbyn. Tillåt åskådare i Inställningspanelen."
"dota_radiant"	"Radiant"
"dota_dire"	"Dire"
"dota_lobby_team_name_radiant"	"{s:team_name_good_guys}"
"dota_lobby_team_name_dire"	"{s:team_name_bad_guys}"
"dota_lobby_no_team"	"Inget lag"
"dota_lobby_broadcast_default_channel_name"	"Kanalnamn"
"dota_lobby_broadcast_join"	"Gå med"
"dota_lobby_broadcast_leave"	"Lämna"
"dota_lobby_broadcast_create"	"Skapa ny kanal"
"dota_lobby_broadcast_no_channels"	"Inga sändningskanaler har skapats"
"dota_popup_broadcast_channel_edit_title"	"Anpassa sändningskanal"
"dota_lobby_broadcast_default_channel_name_custom"	"{s:custom_title}"
"dota_popup_broadcast_channel_edit_channel_name"	"Kanaltitel"
"dota_popup_broadcast_channel_edit_country"	"Land"
"dota_popup_broadcast_channel_edit_language"	"Språk"
"dota_popup_broadcast_channel_edit_save"	"Spara som standardinställningar och tillämpa på tomma kanaler vid anslutning"
"DOTA_Lobby_Broadcaster_Channel_Other_Language"	"Annat språk"
"lobby_slot_error_header"	"Kan inte byta plats"
"generic_gc_timeout"	"Meddelande överskred tidsgränsen."
"lobby_slot_success_header"	"Klart"
"lobby_slot_denied"	"Du har inte tillåtelse att gå med denna plats."
"lobby_slot_cameramanalready"	"Kommentatorskanaler kan bara ha en kameraman"
"lobby_slot_cameramanon"	"Du är nu flaggad som kameraman"
"lobby_slot_cameramanoff"	"Du är inte längre kameraman"
"lobby_slot_error"	"Kunde inte ändra lobbyplats."
"lobby_create_timeout"	"Kunde inte skapa lobby."
"find_match_error"	"Kan inte köa för matchning just nu."
"DOTA_DialogVariableTest1"	"Simple: {s:var}"
"DOTA_DialogVariableTest2"	"Pengavärde: {m:money}"
"DOTA_DialogVariableTest3"	"Artikellänk: {g:dota_item_link:item_def}"
"DOTA_DialogVariableTest4"	"Artikelpris: {g:dota_item_price:item_def}"
"DOTA_DialogVariableTest5"	"Kontots ID-namn: {g:dota_persona:account_id}, Proffsnamn: {g:dota_persona:pro:account_id}"
"DOTA_DialogVariableTest6"	"Enkel med span: <span class=\"TextSpan\">{s:var}</span>"
"LobbySetting_GameMode"	"Spelläge"
"LobbySetting_GameMode_Value"	"{s:lobbysetting_gamemode}"
"LobbySetting_Bots"	"Bottar"
"LobbySetting_Bots_Value"	"{s:lobbysetting_bots}"
"LobbySetting_Password"	"Lösenord"
"LobbySetting_Password_Value"	"{s:lobbysetting_password}"
"LobbySetting_Server"	"Server"
"LobbySetting_Server_Value"	"{s:lobbysetting_server}"
"LobbySetting_Cheats"	"Fusk"
"LobbySetting_Cheats_Value"	"{s:lobbysetting_cheats}"
"LobbySetting_Spectators"	"Åskådare"
"LobbySetting_Spectators_Value"	"{s:lobbysetting_spectators}"
"LobbySetting_Visibility"	"Synlighet"
"LobbySetting_Visibility_Value"	"{s:lobbysetting_visibility}"
"dota_lobby_lan_title"	"Lokal server"
"dota_lobby_coaches_none"	"Coacher: Inga"
"dota_lobby_coaches"	"Coacher:"
"DOTA_Custom_Game"	"Anpassat spel"
"DOTA_Custom_Game_Info"	"Info"
"DOTA_Custom_Game_View_Details"	"Se speldetaljer"
"DOTA_Custom_Game_Author"	"av {g:dota_persona:author}"
"DOTA_Custom_Game_Lobby_Count"	"{d:lobby_count} lobby"
"DOTA_Custom_Game_Lobby_Count_Plural"	"{d:lobby_count} lobbyer"
"DOTA_Custom_Game_Friend_Lobbies_Alert"	"Du har {d:friend_count} vän med en öppen spellobby."
"DOTA_Custom_Game_Friend_Lobbies_Alert_Plural"	"Du har {d:friend_count} vänner med öppna spellobbyer."
"DOTA_Custom_Game_Quick_Join"	"Gå med"
"DOTA_Custom_Game_View_Lobbies"	"Visa lobbyer"
"DOTA_Custom_Game_Find_Lobby"	"Hitta lobby"
"DOTA_Custom_Game_Create_Lobby"	"Skapa lobby"
"DOTA_Custom_Game_Game_Page"	"Spelsida"
"DOTA_Custom_Game_Workshop_Page"	"Workshop-sida"
"DOTA_Custom_Game_Download_Queued"	"Nedladdning köad"
"DOTA_Custom_Game_Downloading"	"Laddar ned..."
"DOTA_Custom_Game_Downloading_Percent"	"Laddar ned - {d:lobby_download_percent}%"
"DOTA_Custom_Game_Needs_Update"	"Behöver uppdateras"
"DOTA_Custom_Game_Play"	"Spela {s:game_mode_name}"
"DOTA_Custom_Game_Uninstall"	"Avinstallera"
"DOTA_Custom_Game_Install"	"Installera"
"DOTA_Custom_Game_Installed"	"Installerat"
"DOTA_Custom_Game_Not_Installed"	"Ej installerat"
"DOTA_Custom_Game_Connect"	"Gå med lobby"
"DOTA_Custom_Game_FileSize"	"{d:file_size} MB"
"DOTA_Custom_Game_Name"	"{s:game_mode_name}"
"DOTA_Custom_Game_Released_By"	"Släpptes {s:release_date}</b> av <b>{g:dota_persona:author}</b>"
"DOTA_Custom_Game_Subscription"	"{s:subscriptions_count} abonnemang"
"DOTA_Custom_Game_Subscriptions"	"{s:subscriptions_count} abonnemang"
"DOTA_Custom_Game_Rating"	"Betyg"
"DOTA_Custom_Game_Release_Date"	"Släppt"
"DOTA_Custom_Game_Playing_Now"	"{s:player_count} spelar nu"
"DOTA_Custom_Game_Ratings_Count"	"({d:ratings_count})"
"DOTA_Custom_Game_Description"	"{s:game_description}"
"DOTA_Custom_Game_Last_Updated"	"Senast uppdaterad {s:last_updated_date}"
"DOTA_Custom_Game_Update_Note_Title"	"{s:timestamp}"
"DOTA_Custom_Game_Screenshots"	"Skärmdumpar"
"DOTA_Custom_Game_Map_Label"	"Bana"
"DOTA_Custom_Game_Map_Any"	"Alla"
"DOTA_Custom_Game_Update"	"Uppdatera"
"DOTA_Custom_Game_Spectate"	"Titta på"
"DOTA_Custom_Game_Already_In_Lobby"	"Avsluta din pågående match för att påbörja detta spelläge."
"DOTA_Custom_Game_Friends_Playing"	"Vänner som spelar anpassade spel"
"DOTA_Custom_Game_Friends_In_Lobbies"	"{d:friends_in_open_lobbies} i öppna lobbyer"
"DOTA_Custom_Game_Friends_In_Game"	"{d:friends_in_game} vänner i anpassade spel"
"DOTA_Custom_Games_Friends_Play"	"Anpassade spel som dina vänner spelar"
"DOTA_Custom_Game_Invite_Friend"	"Bjud in en vän"
"DOTA_Custom_Game_Tooltip_Subscribers"	"{d:subscriber_count} abonnemang"
"DOTA_Custom_Game_Tooltip_Subscriber"	"{d:subscriber_count} abonnemang"
"DOTA_Custom_Game_Most_Popular"	"Mest populär"
"DOTA_Custom_Game_Installed_Games"	"Installerade spel"
"DOTA_Custom_Game_Favorite_Games"	"Visa endast favoriter"
"DOTA_Custom_Game_Add_Favorite"	"Favorit"
"DOTA_Custom_Game_VotePrompt"	"Tycker du vi ska hjälpa fler att få reda på detta spel?"
"DOTA_Custom_Game_DetailsPrompt"	"Besök detta spelets detaljsida för att läsa mer, installera och spela."
"DOTA_Custom_Game_Vote_Box_Title"	"Workshop-rösta"
"DOTA_Custom_Game_Vote_Box_Desc"	"Hjälp oupptäckta spel att få ett fotfäste."
"DOTA_Custom_Game_Vote_Start"	"Börja rösta"
"DOTA_Custom_Game_VoteThanks"	"Tack för din röst!"
"DOTA_Custom_Game_Vote_PrevLabel"	"Föreg. spel"
"DOTA_Custom_Game_Vote_NextLabel"	"Nästa spel"
"DOTA_Custom_Game_Vote_ControlsLabel"	"Workshop-röst"
"DOTA_Custom_Game_Vote_YesLabel"	"Ja, visa upp det!"
"DOTA_Custom_Game_Vote_NoLabel"	"Nej, behöver arbete."
"DOTA_Custom_Game_Vote_SkipLabel"	"Hoppa över detta spel, har inget att säga."
"DOTA_Custom_Game_Vote_Up"	"Bra spel"
"DOTA_Custom_Game_Vote_Down"	"Behöver arbete"
"Video_Support_Coming_Soon"	"Videostöd kommer snart"
"DOTA_Custom_Game_Leave_Lobby"	"Lämna denna lobby"
"DOTA_Custom_Game_Suggested_Title"	"Föreslagna spel"
"DOTA_Custom_Game_Suggested_Info"	"Denna lista omfattar populära spel och spel som fått positiva röster.<br><br>Urvalet ändras var 30:e minut, och presenterar alla i gemenskapen med samma 15 spel."
"DOTA_Custom_Game_Addon_Restricted"	"Kunde inte utföra denna åtgärd i begränsat verktygsläge."
"DOTA_Custom_Game_Search"	"Sök anpassade spel"
"DOTA_Custom_Lobby_Create_Button"	"Skapa anpassad lobby"
"DOTA_Custom_Lobby_Settings_Title"	"Skapa lobby"
"DOTA_Custom_Lobby_Settings_Mode"	"Spelläge"
"DOTA_Custom_Lobby_Settings_Map"	"Bana"
"DOTA_Custom_Lobby_LobbyName"	"Valfri beskrivning"
"DOTA_Custom_Lobby_List_Desc"	"En lista över privata lobbyer (lösenordsskyddade) och ofiltrerade aktiva anpassade spel"
"DOTA_Custom_Lobby_Public"	"Offentlig"
"DOTA_Custom_Lobby_Passworded"	"Spelare kan gå med denna lobby via inbjudning eller genom att filtrera lobbylistan med lösenord."
"DOTA_Custom_Lobby_Join_Failed_Title"	"Kunde ej gå med"
"DOTA_Custom_Lobby_Join_Failed_Reason"	"{s:join_error}"
"DOTA_Custom_Lobby_Join_Failed_Prompt"	"Söka efter en öppen lobby för {s:game_name} nu?"
"DOTA_Lobby_Failed_Pings"	"Hämtning av pinginformation misslyckades. Var god säkerställ att din internetanslutning fungerar och att Dota 2-servrarna är online."
"DOTA_Custom_Lobby_Create_Private_Button"	"Skapa privat lobby"
"DOTA_Custom_Lobby_Find_Private_Button"	"Hitta privat lobby"
"DOTA_Custom_Lobby_Find_Private_Title"	"Hitta privat lobby"
"DOTA_Custom_Lobby_Find_Private_Desc"	"Ange ett lösenord för att hitta en privat lobby:"
"DOTA_Custom_Lobby_List_Game_Header"	"Spel"
"DOTA_Custom_Lobby_List_Name_Header"	"Beskrivning"
"DOTA_Custom_Lobby_List_Players_Header"	"Spelare"
"DOTA_Custom_Lobby_List_Map_Header"	"Bana"
"DOTA_Custom_Lobby_List_Region_Header"	"Region"
"DOTA_Custom_Lobby_List_Connection_Header"	"Anslutning"
"DOTA_Custom_Lobby_List_Status_Header"	"Lokal status"
"DOTA_Custom_Lobby_List_Game"	"{s:lobby_game}"
"DOTA_Custom_Lobby_List_Lobby_Name"	"{s:lobby_name}"
"DOTA_Custom_Lobby_List_Players"	"{s:lobby_players} / {s:lobby_max_players}"
"DOTA_Custom_Lobby_List_Map"	"{s:lobby_map}"
"DOTA_Custom_Lobby_List_Region"	"{s:lobby_region}"
"DOTA_Custom_Lobby_List_Connection"	"..."
"DOTA_Custom_Lobby_List_Status"	"{s:lobby_status}"
"DOTA_Custom_Lobby_List_Connect"	"{s:connect_button_text}"
"DOTA_Custom_Lobby_Game_Name"	"{s:game_name}"
"DOTA_Custom_Lobby_Map_Name"	"Bana: {s:map_name}"
"DOTA_Custom_Lobby_Player_Count"	"Spelare: {d:player_count} / {d:max_player_count}"
"DOTA_Custom_Lobby_Player_Count_Short"	"{d:player_count} / {d:max_player_count}"
"DOTA_Custom_Lobby_Visibility"	"Lobbyns synlighet"
"DOTA_Custom_Join_Chat"	"Gå med chatt"
"DOTA_Custom_Join_Chat_Member_Count"	"({d:ChatMemberCount})"
"DOTA_Custom_Leave_Chat"	"Lämna chatt"
"DOTA_Custom_Game_Vote_Up_Tooltip"	"Klicka för att upprösta detta spel på Steams Workshop."
"DOTA_Page_Number"	"Sida: {d:current_page} / {d:num_pages}"
"DOTA_TabName_ModsOverview"	"Översikt"
"DOTA_TabName_ModsSubscribed"	"Bibliotek"
"DOTA_TabName_ModsWorkshop"	"Workshop"
"DOTA_TabName_ModsBrowse"	"Bläddra"
"DOTA_WatchTabName_Live"	"Live"
"DOTA_WatchTabName_Featured"	"Aktuellt"
"DOTA_WatchTabName_Replays"	"Repriser"
"DOTA_WatchTabName_Tournaments"	"Turneringar"
"DOTA_WatchTabName_Downloads"	"Nedladdningar"
"DOTA_WatchLive_Search"	"Sök efter hjältar att titta på"
"DOTA_WatchLive_DataPending"	"Hittar Live-matcher..."
"DOTA_WatchLive_DataError"	"Fel vid inläsning av live-matcher"
"DOTA_WatchLive_NoGames"	"Inga Live-matcher spelas för tillfället"
"DOTA_WatchLive_Connecting"	"Väntar på matchdata..."
"DOTA_WatchLive_HeroFilter"	"Filter: {s:hero_filter_name}"
"DOTA_WatchLive_CountSpec"	"{i:num_spectating} åskådare"
"DOTA_WatchLive_CountSpecFriend"	"{i:num_friends_spectating} vän och {i:num_spectating} åskådare"
"DOTA_WatchLive_CountSpecFriends"	"{i:num_friends_spectating} vänner och {i:num_spectating} åskådare"
"DOTA_WatchLive_CountFriends"	"{i:num_friends_playing} vänner spelar"
"DOTA_WatchLive_ParticipantsVs"	"<font color='#ffffff'>{s:team_1}</font> <font color='#888888'>vs</font> <font color='#ffffff'>{s:team_2}</font>"
"DOTA_WatchLive_ParticipantsMMR"	"<font color='#ffffff'>{i:mmr}</font> <font color='#888888'>medel-MMR</font>"
"DOTA_WatchLive_ParticipantsUnranked"	"Orankad"
"DOTA_WatchLive_Participants1"	"{s:friend_1}"
"DOTA_WatchLive_Participants2"	"{s:friend_1} och {s:friend_2}"
"DOTA_WatchLive_Participants3"	"{s:friend_1}, {s:friend_2}, och {s:friend_3}"
"DOTA_WatchLive_Participants4Plus"	"{s:friend_1}, {s:friend_2}, {s:friend_3}, och {i:friend_count_over_3} till..."
"DOTA_WatchLive_MatchType_MM_Kills"	"{s:game_mode}"
"DOTA_WatchLive_MatchType_MM"	"{s:game_mode}"
"DOTA_WatchLiveDotaTV"	"Titta i DotaTV"
"DOTA_WatchLivePurchase"	"Skaffa turneringspass {g:dota_item_price:ticket_itemdef}"
"DOTA_WatchLiveSpectatorFriends1"	"{g:dota_persona:spectator_friend_1} åskådar"
"DOTA_WatchLiveSpectatorFriends2"	"{g:dota_persona:spectator_friend_1} och {g:dota_persona:spectator_friend_2} åskådar"
"DOTA_WatchLiveSpectatorFriends3"	"{g:dota_persona:spectator_friend_1}, {g:dota_persona:spectator_friend_2}, och {g:dota_persona:spectator_friend_3} åskådar"
"DOTA_WatchLiveSpectatorFriends4Plus"	"{g:dota_persona:spectator_friend_1}, {g:dota_persona:spectator_friend_2}, {g:dota_persona:spectator_friend_3}, och {i:spectator_friend_count_over_3} andra vänner åskådar"
"DOTA_WatchLiveSpectatorCount"	"{i:spectator_count} åskådare"
"DOTA_WatchLivePreGame"	"Förspel"
"DOTA_WatchLive_ElapsedTime"	"Förfluten tid:"
"DOTA_WatchLive_Spectating"	"Åskådare:"
"DOTA_WatchReplays_TournamentsHeader"	"POPULÄRA TURNERINGSMATCHER"
"DOTA_WatchReplays_FriendsHeader"	"VÄNNERS MATCHER"
"DOTA_WatchReplays_Popular"	"POPULÄRA MATCHER"
"DOTA_WatchReplays_SavedForLater"	"SPARAD I TITTA SENARE"
"DOTA_WatchReplays_ParticipantsVs"	"{s:team_1} vs {s:team_2}"
"DOTA_WatchReplays_MatchType_League"	"{s:league_name}"
"DOTA_WatchReplays_MatchType_Public"	"Match {s:match_id} - {s:game_mode}"
"DOTA_WatchReplays_Recommendations"	"{i:recommendations}"
"DOTA_WatchReplays_Recommendations1"	"{g:dota_persona:friend_1} + {i:recommendations}"
"DOTA_WatchReplays_Recommendations2"	"{g:dota_persona:friend_1}, {g:dota_persona:friend_2} + {i:recommendations}"
"DOTA_WatchReplays_Recommendations3Plus"	"{g:dota_persona:friend_1} + {i:friend_count_over_1} vänner till + {i:recommendations}"
"DOTA_WatchReplays_Friends1"	"{g:dota_persona:b:friend_1} spelade"
"DOTA_WatchReplays_Friends2"	"{g:dota_persona:b:friend_1} och {g:dota_persona:friend_2} spelade"
"DOTA_WatchReplays_Friends3Plus"	"{g:dota_persona:b:friend_1}, {g:dota_persona:b:friend_2} och {i:friend_count_over_2} vänner till"
"DOTA_WatchReplays_Views"	"{i:views} visningar"
"DOTA_WatchReplays_Price"	"{g:dota_item_price:ticket_itemdef}"
"DOTA_WatchReplays_SharedMatch"	"{g:dota_persona:shared_by} delade - '{s:shared_text}'"
"DOTA_WatchReplays_SharedHighlight"	"{g:dota_persona:shared_by} delade en höjdpunkt"
"DOTA_WatchReplays_Duration"	"{s:minutes}:{s:seconds}"
"DOTA_WatchReplays_Tag"	"\"{s:recommendation_text}\""
"DOTA_WatchTournaments_FeaturedTitle"	"{s:tournament_featured_title}"
"DOTA_WatchTournaments_FeaturedDates"	"{s:tournament_featured_start} - {s:tournament_featured_end}"
"DOTA_WatchTournaments_FeaturedDescription"	"{s:tournament_featured_description}"
"DOTA_WatchTournaments_FeaturedTeams"	"Lag"
"DOTA_WatchTournaments_PrizePool"	"Prispott:"
"DOTA_WatchTournaments_PrizePoolAmt"	"{s:tournament_featured_prize_pool}"
"DOTA_WatchTournaments_Purchase"	"Turneringspass - {s:tournament_featured_price}"
"DOTA_WatchTournament_TournamentName"	"{s:tournament_name}"
"DOTA_WatchTournament_Price"	"{s:price}"
"DOTA_Replays_Search"	"Sök efter Match-ID"
"DOTA_Watch_GameStatus"	"Se matchstatus"
"DOTA_Watch_Pending"	"Väntar på att titta på match..."
"DOTA_Watch_GameServerNotFound"	"Servern som är värd för den här matchen hittades inte."
"DOTA_Watch_Unavailable"	"Kan inte titta på denna match för tillfället."
"DOTA_Watch_LobbyNotFound"	"Hittade inte lobbyn."
"DOTA_Watch_MissingLeagueSubscription"	"Denna match tillhör en liga som kräver ett abonnemang för att titta på."
"vs"	"VS"
"dota_matchmaking_language_title"	"Välj matchningsspråk"
"dota_matchmaking_language_primary_label"	"Ditt primära matchningsspråk är:"
"dota_matchmaking_language_primary"	"{s:environment_language}"
"dota_matchmaking_language_primary_invalid"	"Ditt språk, {s:environment_language}, är ej tillgängligt som ett matchningsspråk i Dota 2."
"dota_matchmaking_language_select_secondary"	"Om du vill, kan du välja ett sekundärt språk:"
"dota_matchmaking_language_select_primary"	"Var god välj ett matchningsspråk:"
"dota_matchmaking_language_no_selection"	"Inget val"
"dota_matchmaking_language_english"	"Engelska"
"dota_matchmaking_language_russian"	"Ryska"
"dota_matchmaking_language_chinese"	"Kinesiska"
"dota_matchmaking_language_schinese"	"Kinesiska"
"dota_matchmaking_language_korean"	"Koreanska"
"dota_matchmaking_language_koreana"	"Koreanska"
"dota_matchmaking_language_spanish"	"Spanska"
"dota_matchmaking_language_portuguese"	"Portugisiska"
"GameUI_Language_English"	"Engelska"
"GameUI_Language_German"	"Tyska"
"GameUI_Language_French"	"Franska"
"GameUI_Language_Italian"	"Italienska"
"GameUI_Language_Korean"	"Koreanska"
"GameUI_Language_Spanish"	"Spanska"
"GameUI_Language_Simplified_Chinese"	"Förenklad kinesiska"
"GameUI_Language_Traditional_Chinese"	"Traditionell kinesiska"
"GameUI_Language_Russian"	"Ryska"
"GameUI_Language_Thai"	"Thai"
"GameUI_Language_Japanese"	"Japanska"
"GameUI_Language_Portuguese"	"Portugisiska"
"GameUI_Language_Polish"	"Polska"
"GameUI_Language_Danish"	"Danska"
"GameUI_Language_Dutch"	"Nederländska"
"GameUI_Language_Finnish"	"Finska"
"GameUI_Language_Norwegian"	"Norska"
"GameUI_Language_Swedish"	"Svenska"
"GameUI_Language_Hungarian"	"Ungerska"
"GameUI_Language_Czech"	"Tjeckiska"
"GameUI_Language_Romanian"	"Rumänska"
"GameUI_Language_Turkish"	"Turkiska"
"GameUI_Language_Brazilian"	"Brasiliansk portugisiska"
"GameUI_Language_Bulgarian"	"Bulgariska"
"GameUI_Language_Greek"	"Grekiska"
"GameUI_Language_Ukrainian"	"Ukrainska"
"client_version_out_of_date_title"	"Uppdatering krävs"
"client_version_out_of_date"	"Spelklienten är föråldrad. Var god stäng ner Dota 2 och starta om för att få den senaste versionen."
"dota_matchmaking_region_title"	"Välj matchningsregioner"
"dota_matchmaking_region_auto"	"Välj automatiskt den bästa regionen baserat på mitt läge."
"dota_matchmaking_region_select"	"Välj upp till tre matchningsregioner. Välj bara regionerna som är närmast dig för den bästa upplevelsen."
"limited_heroes_abandon_header"	"Begränsade hjältar-läge"
"limited_heroes_abandon_explanation"	"Det är inte straffbart att lämna en match i Begränsade hjältar-läget, då din hjälte kommer att övertas av en bot. Att lämna något annat spelläge kan sluta med att du hamnar i lågprioriterad matchning."
"dota_abandon_dialog_title"	"Överge match"
"dota_abandon_dialog_confirm"	"Är du säker på att du vill överge denna matchen?"
"dota_abandon_dialog_yes"	"Ja, överge matchen."
"dota_leave_dialog_title"	"Lämna match"
"dota_leave_dialog_confirm"	"Är du säker på att du vill lämna denna match?"
"dota_leave_dialog_yes"	"Ja, lämna matchen."
"dota_accept_match_title"	"Din match är redo"
"dota_accept_match_readyup_title"	"Väntar på spelare"
"dota_accept_match_accept"	"Acceptera"
"dota_accept_match_accept_low_pri"	"Acceptera lågprioritetsmatch"
"dota_accept_match_accept_button"	"{s:accept}"
"dota_accept_match_decline"	"Avböj"
"dota_accept_match_subtitle"	"{s:subtitle}"
"dota_finding_match_players"	"(%s1 sökande)"
"dota_finding_match_time"	"Matchningstid: {s:find_match_time}"
"dota_finding_match_accept_count"	"accepterade match: {s:match_num_accepted} / {s:match_num_total}"
"dota_finding_match_generic"	"Normal match"
"dota_finding_match_ranked"	"Rankad match"
"dota_finding_match_bot"	"Bottmatch"
"dota_finding_match_bot_passive"	"Bottmatch ( Passiv )"
"dota_finding_match_bot_easy"	"Bottmatch ( Lätt )"
"dota_finding_match_bot_medium"	"Bottmatch ( Medium )"
"dota_finding_match_bot_hard"	"Bottmatch ( Svår )"
"dota_finding_match_bot_unfair"	"Bottmatch ( Orättvis )"
"dota_finding_match_team"	"Rankad lagmatch"
"dota_finding_1v1_match_casual"	"1v1 Match"
"dota_finding_match_practice_lobby"	"Lobbymatch"
"dota_safe_to_abandon_inline"	"Matchen är säker att lämna"
"dota_match_connected"	"Ansluten till match"
"dota_match_local_game"	"Ansluten till lokal match"
"dota_match_connecting"	"Ansluter till match..."
"dota_match_in_progress"	"Match pågår"
"dota_match_finished"	"Matchen är slut"
"matchmaking_waiting_for_players"	"Väntar på andra spelare"
"matchmaking_player_declined"	"En spelare avböjde matchen"
"dota_match_wait_for_host"	"Väntar på värd"
"dota_match_find_server"	"Söker efter server"
"ranked_disabled"	"Rankad matchning är temporärt inaktiverat."
"ranked_mmr"	"Din matchningsrang"
"ranked_mmr_solo_label"	"Solo"
"ranked_mmr_solo_value"	"{i:solo_mmr}"
"ranked_mmr_solo_calibrating"	"TBD - {i:solo_calibrating_games} matcher återstår"
"ranked_mmr_solo_no_data"	"Kräver {i:solo_calibrating_required_games} matcher för att kalibrera"
"ranked_mmr_party_label"	"Grupp"
"ranked_mmr_party_value"	"{i:party_mmr}"
"ranked_mmr_party_calibrating"	"TBD - {i:party_calibrating_games} matcher återstår"
"ranked_mmr_party_no_data"	"Kräver {i:party_calibrating_required_games} matcher för att kalibrera"
"ranked_mmr_locked_explain"	"Rankad matchning:\nUpplåst när Erfarenhetstrofén uppnår nivå 50.\nEtt mer tävlingsinriktat läge som spårar och visar varje spelares MMR (matchningsbetyg)."
"matchmaking_account_disabled"	"Du har varit för störsam och kommer inte kunna chatta eller gå med i matchningskön. Återstående tid: {t:r:match_denied_time}"
"matchmaking_match_disabled_party"	"{s:match_denied_player_name} kommer förhindra matchning på grund av att ej ha varit redo eller för att ha övergivit sin förra match. Återstående tid: {t:r:match_denied_time}"
"matchmaking_low_priority_party"	"{s:match_denied_player_name} kommer endast tillåta lågprioritetsmatchning på grund av att ha övergett matcher eller ha blivit anmäld för mycket. Återstående matcher: {d:match_denied_games}"
"matchmaking_match_disabled_local"	"Du är förhindrad från matchning på grund av att ej ha varit redo eller för att ha övergivit din förra match. Återstående tid: {t:r:match_denied_time}"
"matchmaking_low_priority_local"	"Du kommer bara kunna spela lågprioritetsmatcher på grund av att ha övergett matcher eller blivit anmäld för mycket. Återstående matcher: {d:match_denied_games}"
"dota_ready_up_count"	"{s:ready_up_ready} / {s:ready_up_lobby_members}"
"dota_play_normal_match"	"Normal match"
"dota_play_ranked_match"	"Rankad match"
"dota_play_practice_1v1"	"Träna 1v1"
"dota_play_practice_with_bots"	"Öva med bottar"
"dota_play_practice_1v1_playtab"	"TRÄNA 1v1"
"dota_play_1v1_desc"	"Träna på att spela på mittvägen mot en annan spelare. Träningen slutar när en spelare dör två gånger eller förlorar ett torn."
"dota_play_practice_1v1_party_warning"	"Grupper är ej tillåtna i 1v1-matchning"
"dota_play_button_label"	"{s:play_button_label}"
"dota_play"	"Spela Dota"
"dota_play_searching"	"Söker efter match"
"dota_play_connecting"	"Värden laddar..."
"dota_play_lobby_find_server"	"Söker efter server"
"dota_play_find_match_label"	"{s:find_match_label}"
"dota_reconnect"	"Återanslut"
"dota_abandon_game"	"Överge"
"dota_safe_leave_game"	"Lämna matchen"
"dota_disconnect"	"Koppla från"
"dota_play_unavailable"	"Otillgänglig"
"dota_leaver_consequence_tooltip_header"	"Konsekvenser"
"dota_leaver_consequences"	"{s:leaver_consequences}"
"dota_leaver_consequences_details"	"{s:leaver_consequences_details}"
"dota_leaver_view_tooltip"	"Visa detaljer"
"dota_leaver_consequence_header_failure_to_reconnect"	"Att inte återansluta sig kommer att leda till följande konsekvenser:"
"dota_leaver_consequence_header_leave_match"	"Att lämna denna match kommer att leda till negativa konsekvenser"
"dota_leaver_consequence_LetDownTeammates"	"Dina lagkamrater kommer att spela i underläge."
"dota_leaver_consequence_SmallMatchmakingCooldown"	"Du kommer inte att kunna använda matchning under en tidsperiod."
"dota_leaver_consequence_CreditWithAbandon"	"Du kommer att få en övergivningspoäng."
"dota_leaver_consequence_ForcedLossForLeaver"	"Du kommer att få en förlust."
"dota_leaver_consequence_ForcedLossForLeaversParty"	"<b>Alla i din grupp</b> kommer att få en förlust."
"dota_leaver_consequence_ForcedLossForLeaversTeam"	"<b>Ditt lag</b>, %s1, kommer få en förlust."
"dota_leaver_consequence_MMRLossForLeaver"	"Ditt MMR kommer att sjunka."
"dota_leaver_consequence_MMRLossForLeaversParty"	"MMR för <b>alla i din grupp</b> kommer att sjunka."
"dota_leaver_consequence_MMRLossForLeaversTeam"	"MMR för <b>ditt lag</b>, %s1, kommer att sjunka."
"dota_leaver_consequence_MatchDiscardedForOtherPlayers"	"Matchen kommer inte att räknas för övriga spelare."
"dota_leaver_consequence_NotDecrementLowPriGamesRemaining"	"Det kommer inte att räknas att du har slutfört matchen."
"dota_reconnect_popup_title"	"Återanslut?"
"dota_reconnect_popup_message"	"Placeholder text - skulle du vilja återansluta till matchen?"
"dota_matchmaking_regions_refresh"	"Uppdatera pings"
"dota_matchmaking_region_ping"	"{s:region_ping}"
"dota_matchmaking_region_offline"	"Offline för underhåll"
"dota_matchmaking_region_unknown_ping"	"Ping: Okänt"
"dota_matchmaking_region_ping_time"	"Ping: {i:ping_ms}ms"
"DOTA_VAC_Verification_Header"	"Valve Anti-Cheat (VAC)"
"DOTA_VAC_Verification_Header_Solo"	"Kunde inte gå med i matchning på grund av att ett problem med din dator blockerar VAC-systemet. Vänligen försäkra dig om att du inte använder några program som motstrider VAC och se efter så att Steam är korrekt installerat."
"DOTA_VAC_Verification_Header_Party"	"Kunde inte gå med i matchning på grund av att ett problem med din dator blockerar VAC-systemet hos en eller flera av dina gruppmedlemmar. Vänligen försäkra dig om att dina gruppmedlemmar inte använder några program som motstrider VAC och se efter att de har Steam korrekt installerat."
"DOTA_VAC_Verification_Button1"	"Mer information"
"DOTA_VAC_Verification_Button2"	"Stäng"
"dota_matchmaking_regions_button"	"{s:regions_selected}"
"dota_region_automatic"	"Region: Auto"
"dota_regions_selected"	"Regioner: "
"dota_lobby_region_invalid"	"Inga"
"dota_play_no_language_selected"	"VÄLJ SPRÅK"
"dota_play_language"	"{s:match_language}"
"dota_play_language_many"	"SPRÅK: {i:match_language_count}"
"dota_ready_fail"	"EJ REDO"
"dota_ready_fail_desc"	"Din match var redo, men du svarade inte och har nu tagits bort från matchningspoolen."
"dota_all_chat_label"	"[ALLA]"
"dota_chatwheel_label_Ok"	"Okej"
"dota_chatwheel_label_Care"	"Försiktigt"
"dota_chatwheel_label_GetBack"	"Backa"
"dota_chatwheel_label_NeedWards"	"Behöver wards"
"dota_chatwheel_label_Stun"	"Bedöva"
"dota_chatwheel_label_Help"	"Hjälp"
"dota_chatwheel_label_Push"	"Pusha"
"dota_chatwheel_label_GoodJob"	"Bra spelat"
"dota_chatwheel_label_Missing"	"Saknar"
"dota_chatwheel_label_Missing_Top"	"Saknar topp"
"dota_chatwheel_label_Missing_Mid"	"Saknar mitt"
"dota_chatwheel_label_Missing_Bottom"	"Saknar botten"
"dota_chatwheel_label_Go"	"Kör!"
"dota_chatwheel_label_Initiate"	"Initiera!"
"dota_chatwheel_label_Follow"	"Följ mig"
"dota_chatwheel_label_Group_Up"	"Gruppera"
"dota_chatwheel_label_Spread_Out"	"Sprid ut"
"dota_chatwheel_label_Split_Farm"	"Splitt-farma"
"dota_chatwheel_label_Attack"	"Attackera nu!"
"dota_chatwheel_label_BRB"	"Är strax tillbaka"
"dota_chatwheel_label_Dive"	"Dyk!"
"dota_chatwheel_label_OMW"	"Jag är på väg"
"dota_chatwheel_label_Get_Ready"	"Gör er redo"
"dota_chatwheel_label_Bait"	"Spela lockbete"
"dota_chatwheel_label_Heal"	"Hela"
"dota_chatwheel_label_Mana"	"Mana"
"dota_chatwheel_label_OOM"	"Slut på mana"
"dota_chatwheel_label_Skill_Cooldown"	"Cooldown"
"dota_chatwheel_label_Ulti_Ready"	"Ulti redo"
"dota_chatwheel_label_Enemy_Returned"	"Fienden tillbaka"
"dota_chatwheel_label_All_Missing"	"Alla saknas"
"dota_chatwheel_label_Enemy_Incoming"	"Inkommande"
"dota_chatwheel_label_Invis_Enemy"	"Osynlig fiende"
"dota_chatwheel_label_Enemy_Had_Rune"	"Fienden har runan"
"dota_chatwheel_label_Split_Push"	"Splitt-pusha"
"dota_chatwheel_label_Coming_To_Gank"	"Kommer för att ganka"
"dota_chatwheel_label_Request_Gank"	"Begär gank"
"dota_chatwheel_label_Fight_Under_Tower"	"Under tornet"
"dota_chatwheel_label_Deny_Tower"	"Neka torn"
"dota_chatwheel_label_Buy_Courier"	"Köp kurir"
"dota_chatwheel_label_Upgrade_Courier"	"Uppgradera kurir"
"dota_chatwheel_label_Need_Detection"	"Vi behöver upptäckning"
"dota_chatwheel_label_They_Have_Detection"	"De har upptäckning"
"dota_chatwheel_label_Buy_TP"	"Köp TP"
"dota_chatwheel_label_Reuse_Courier"	"Återanvänd kurir"
"dota_chatwheel_label_Deward"	"Förstör wards"
"dota_chatwheel_label_Building_Mek"	"Bygger Mekansm"
"dota_chatwheel_label_Building_Pipe"	"Bygger Pipe"
"dota_chatwheel_label_Stack_And_Pull"	"Stacka och led creeps"
"dota_chatwheel_label_Pull"	"Led iväg creeps"
"dota_chatwheel_label_Pulling"	"Leder iväg creeps"
"dota_chatwheel_label_Stack"	"Stacka neutrala"
"dota_chatwheel_label_Jungling"	"Djunglar"
"dota_chatwheel_label_Roshan"	"Roshan"
"dota_chatwheel_label_Affirmative"	"Ja"
"dota_chatwheel_label_Wait"	"Vänta"
"dota_chatwheel_label_Pause"	"Pausa"
"dota_chatwheel_label_Current_Time"	"Nuvarande tid"
"dota_chatwheel_label_Check_Runes"	"Kolla runor"
"dota_chatwheel_label_Smoke_Gank"	"Smoke-ganka!"
"dota_chatwheel_label_GLHF"	"Lycka till"
"dota_chatwheel_label_Nice"	"Bra"
"dota_chatwheel_label_Thanks"	"Tack"
"dota_chatwheel_label_Sorry"	"Förlåt"
"dota_chatwheel_label_No_Give_Up"	"Ge inte upp"
"dota_chatwheel_label_Just_Happened"	"Det där hände just"
"dota_chatwheel_label_Game_Is_Hard"	"Spelet är svårt"
"dota_chatwheel_label_New_Meta"	"Ny meta"
"dota_chatwheel_label_My_Bad"	"Mitt fel"
"dota_chatwheel_label_Regret"	"Ånger"
"dota_chatwheel_label_Relax"	"Slappna av"
"dota_chatwheel_label_GG"	"GG"
"dota_chatwheel_label_GGWP"	"GGWP"
"dota_chatwheel_label_All_GG"	"(Alla) GG"
"dota_chatwheel_label_All_GGWP"	"(Alla) GGWP"
"dota_chatwheel_label_What_To_Buy"	"Vad ska man köpa?"
"dota_chatwheel_label_Im_Retreating"	"Jag backar"
"dota_chatwheel_label_Space_Created"	"Utrymme skapat"
"dota_chatwheel_label_Whoops"	"Hoppsan"
"dota_chatwheel_label_Tower_then_Back"	"Ta tornet, backa sedan"
"dota_chatwheel_label_Barracks_then_Back"	"Ta baracker, backa sedan"
"dota_chatwheel_label_Ward_Bottom_Rune"	"Warda nedre runan"
"dota_chatwheel_label_Ward_Top_Rune"	"Warda övre runan"
"dota_chatwheel_label_Zeus_Ult"	"Zeus Ult"
"dota_chatwheel_header_positioning"	"Positionering"
"dota_chatwheel_header_status"	"Status"
"dota_chatwheel_header_enemy"	"Fiende"
"dota_chatwheel_header_lane"	"Väg"
"dota_chatwheel_header_items"	"Föremål"
"dota_chatwheel_header_neutrals"	"Neutrala"
"dota_chatwheel_header_misc"	"Övrigt"
"dota_chatwheel_header_flavor"	"Smak"
"dota_chatwheel_message_Ok"	"Ok."
"dota_chatwheel_message_Care"	"Försiktigt!"
"dota_chatwheel_message_GetBack"	"Backa!"
"dota_chatwheel_message_NeedWards"	"Vi behöver wards."
"dota_chatwheel_message_Stun"	"Bedöva nu!"
"dota_chatwheel_message_Help"	"Hjälp!"
"dota_chatwheel_message_Push"	"Pusha nu"
"dota_chatwheel_message_GoodJob"	"Bra spelat!"
"dota_chatwheel_message_Missing"	"Saknar!"
"dota_chatwheel_message_Missing_Top"	"Saknar topp!"
"dota_chatwheel_message_Missing_Mid"	"Saknar mitt!"
"dota_chatwheel_message_Missing_Bottom"	"Saknar botten!"
"dota_chatwheel_message_Go"	"Kör!"
"dota_chatwheel_message_Initiate"	"Initiera!"
"dota_chatwheel_message_Follow"	"Följ mig"
"dota_chatwheel_message_Group_Up"	"Gruppera"
"dota_chatwheel_message_Spread_Out"	"Sprid ut er"
"dota_chatwheel_message_Split_Farm"	"Dela upp er och farma"
"dota_chatwheel_message_Attack"	"Attackera nu!"
"dota_chatwheel_message_BRB"	"Är strax tillbaka"
"dota_chatwheel_message_Dive"	"Dyk!"
"dota_chatwheel_message_OMW"	"Jag är på väg"
"dota_chatwheel_message_Get_Ready"	"Gör er redo"
"dota_chatwheel_message_Bait"	"Spela lockbete"
"dota_chatwheel_message_Heal"	"Hela"
"dota_chatwheel_message_Mana"	"Mana"
"dota_chatwheel_message_OOM"	"Slut på mana"
"dota_chatwheel_message_Skill_Cooldown"	"Förmågor är på cooldown"
"dota_chatwheel_message_Ulti_Ready"	"Ultimatförmåga redo"
"dota_chatwheel_message_Enemy_Returned"	"Fienden är tillbaka"
"dota_chatwheel_message_All_Missing"	"Alla fientliga hjältar saknas!"
"dota_chatwheel_message_Enemy_Incoming"	"Fiende inkommande!"
"dota_chatwheel_message_Invis_Enemy"	"Osynlig fiende i närheten!"
"dota_chatwheel_message_Enemy_Had_Rune"	"Fienden har runan"
"dota_chatwheel_message_Split_Push"	"Splitt-pusha"
"dota_chatwheel_message_Coming_To_Gank"	"Kommer för att ganka"
"dota_chatwheel_message_Request_Gank"	"Begär gank"
"dota_chatwheel_message_Fight_Under_Tower"	"Slåss under tornet"
"dota_chatwheel_message_Deny_Tower"	"Neka tornet!"
"dota_chatwheel_message_Buy_Courier"	"Var snäll och köp en kurir"
"dota_chatwheel_message_Upgrade_Courier"	"Kan någon uppgradera kuriren?"
"dota_chatwheel_message_Need_Detection"	"Vi behöver upptäckning"
"dota_chatwheel_message_They_Have_Detection"	"De har upptäckning"
"dota_chatwheel_message_Buy_TP"	"Köp en Teleport Scroll"
"dota_chatwheel_message_Reuse_Courier"	"Återanvänd kuriren"
"dota_chatwheel_message_Deward"	"Var snäll och förstör fiendens wards"
"dota_chatwheel_message_Building_Mek"	"Bygger Mekansm"
"dota_chatwheel_message_Building_Pipe"	"Bygger Pipe"
"dota_chatwheel_message_Stack_And_Pull"	"Stacka och led creepsen tack"
"dota_chatwheel_message_Pull"	"Led iväg creepsen tack"
"dota_chatwheel_message_Pulling"	"Leder iväg creepsen"
"dota_chatwheel_message_Stack"	"Stacka de neutrala"
"dota_chatwheel_message_Jungling"	"Djunglar"
"dota_chatwheel_message_Roshan"	"Roshan"
"dota_chatwheel_message_Affirmative"	"Ja"
"dota_chatwheel_message_Wait"	"Vänta"
"dota_chatwheel_message_Pause"	"Var snäll och pausa!"
"dota_chatwheel_message_Current_Time"	"Aktuell tid"
"dota_chatwheel_message_Check_Runes"	"Kolla runorna tack"
"dota_chatwheel_message_Smoke_Gank"	"Kom så Smoke-gankar vi!"
"dota_chatwheel_message_GLHF"	"Lycka till och ha så kul - GL HF!"
"dota_chatwheel_message_Nice"	"Bra"
"dota_chatwheel_message_Thanks"	"Tack!"
"dota_chatwheel_message_Sorry"	"Förlåt"
"dota_chatwheel_message_No_Give_Up"	"Ge inte upp!"
"dota_chatwheel_message_Just_Happened"	"Det där hände just"
"dota_chatwheel_message_Game_Is_Hard"	"Spelet är svårt"
"dota_chatwheel_message_New_Meta"	"Ny meta"
"dota_chatwheel_message_My_Bad"	"Mitt fel"
"dota_chatwheel_message_Regret"	"Jag ångrar omedelbart detta beslut"
"dota_chatwheel_message_Relax"	"Slappna av, du gör bra ifrån dig"
"dota_chatwheel_message_MissingHero"	"%s1 saknas!"
"dota_chatwheel_message_ReturnedHero"	"%s1 har återvänt!"
"dota_chatwheel_message_GG"	"Bra match"
"dota_chatwheel_message_GGWP"	"Bra match, bra spelat"
"dota_chatwheel_message_All_GG"	"Bra match"
"dota_chatwheel_message_All_GGWP"	"Bra match, bra spelat"
"dota_chatwheel_message_What_To_Buy"	"Vad ska jag köpa?"
"dota_chatwheel_message_Im_Retreating"	"Jag backar"
"dota_chatwheel_message_Space_Created"	"Utrymme skapat"
"dota_chatwheel_message_Whoops"	"Hoppsan"
"dota_chatwheel_message_Tower_then_Back"	"Förstör tornet, backa sedan"
"dota_chatwheel_message_Barracks_then_Back"	"Förstör barackerna, backa sedan"
"dota_chatwheel_message_Ward_Bottom_Rune"	"Warda nedre runan"
"dota_chatwheel_message_Ward_Top_Rune"	"Warda övre runan"
"dota_chatwheel_message_Zeus_Ult"	"Zeus, ulta nu!"
"dota_settings_hotkeys"	"Snabbknappar"
"dota_settings_options"	"Alternativ"
"dota_settings_audio"	"Ljud"
"dota_settings_voice"	"Röst"
"dota_settings_voice_level"	"Aktuell inspelningsnivå"
"dota_settings_voice_steam_link"	"Inspelningsenhetens inställningar konfigureras via <a href=\"event:DOTAShowSteamVoiceSettings()\">Steams röstinställningar</a>."
"dota_settings_volume"	"Volym"
"dota_settings_video"	"Grafik"
"dota_settings_resetkeys"	"Återställ snabbknappar..."
"dota_settings_legacykeys"	"Använd Legacy-knappar"
"dota_settings_abilities"	"Förmågor"
"dota_settings_abilities_hero"	"Hjälte"
"dota_settings_abilities_neutrals"	"Neutrala"
"dota_settings_abilities_courier"	"Kurir"
"dota_settings_abilities_primary1"	"1"
"dota_settings_abilities_primary2"	"2"
"dota_settings_abilities_primary3"	"3"
"dota_settings_abilities_secondary1"	"4"
"dota_settings_abilities_secondary2"	"5"
"dota_settings_abilities_neutral1"	"1"
"dota_settings_abilities_neutral2"	"2"
"dota_settings_abilities_neutral3"	"3"
"dota_settings_abilities_neutral4"	"4"
"dota_settings_abilities_courier1"	"1"
"dota_settings_abilities_courier2"	"2"
"dota_settings_abilities_courier3"	"3"
"dota_settings_abilities_courier4"	"4"
"dota_settings_abilities_courier5"	"5"
"dota_settings_abilities_courier6"	"6"
"dota_settings_abilities_ultimate"	"U"
"dota_settings_cast"	"Användande"
"dota_settings_autocast"	"Auto-användande"
"dota_settings_quickcast"	"Snabbanvändande"
"dota_settings_mirror"	"Spegla snabbknappar från hjältepanel"
"dota_settings_abilitylearn"	"Förmågelärning"
"dota_settings_upgradestats"	"Uppgradera attribut"
"dota_settings_unitactions"	"Enhetshandlingar"
"dota_settings_attack"	"Attackförflyttning / Tvinga attack"
"dota_settings_move"	"Förflyttning"
"dota_settings_stop"	"Stopp"
"dota_settings_holdposition"	"Håll position"
"dota_settings_selecthero"	"Välj hjälte"
"dota_settings_selectall"	"Välj alla enheter"
"dota_settings_selectallothers"	"Välj alla andra enheter"
"dota_settings_selectcourier"	"Välj kurir"
"dota_settings_courierdeliver"	"Kurir - Leverera föremål"
"dota_settings_courierhaste"	"Kurir - Fartökning"
"dota_settings_useactionitem"	"Handlingsföremål"
"dota_settings_herotaunt"	"Hånföremål"
"dota_settings_items"	"Föremål"
"dota_settings_openshop"	"Öppna butik"
"dota_settings_purchasequickbuy"	"Snabbköp"
"dota_settings_purchasesticky"	"Stickyköp"
"dota_settings_grabstashitems"	"Ta förrådsföremål"
"dota_settings_camera"	"Kamera"
"dota_settings_cameraactions"	"Kamerahandlingar"
"dota_settings_cameraup"	"Kamera framåt"
"dota_settings_cameradown"	"Kamera bakåt"
"dota_settings_cameraleft"	"Kamera vänster"
"dota_settings_cameraright"	"Kamera höger"
"dota_settings_cameragrip"	"Kameragrepp"
"dota_settings_recentevent"	"Visa senaste händelse"
"dota_settings_inspectheroinworld"	"Visningsmonter"
"dota_settings_chat"	"Chatt"
"dota_settings_phrases"	"Fraser"
"dota_settings_chatwheel_page"	"Chatthjul"
"dota_settings_chatteam"	"Lagchatt"
"dota_settings_chatglobal"	"Chatta med alla"
"dota_settings_chatvoice_party"	"Tal (grupp)"
"dota_settings_chatvoice_team"	"Tal (lag)"
"dota_settings_chatwheel_show"	"Chatthjul"
"dota_settings_playeractions"	"Spelarhandlingar"
"dota_settings_activateglyph"	"Aktivera Glyph"
"dota_settings_scoreboardtoggle"	"Poängtavla"
"dota_settings_pause"	"Pausa"
"dota_settings_screenshot"	"Skärmdump"
"dota_settings_console"	"Konsol"
"dota_settings_controlgroups"	"Kontrollgrupper"
"dota_settings_controlgroupsadditional"	"Fler kontrollgrupper"
"dota_settings_controlgroupcycle"	"Kontrollgrupp Tab"
"dota_settings_group1"	"Grupp 1"
"dota_settings_group2"	"Grupp 2"
"dota_settings_group3"	"Grupp 3"
"dota_settings_group4"	"Grupp 4"
"dota_settings_group5"	"Grupp 5"
"dota_settings_group6"	"Grupp 6"
"dota_settings_group7"	"Grupp 7"
"dota_settings_group8"	"Grupp 8"
"dota_settings_group9"	"Grupp 9"
"dota_settings_group10"	"Grupp 10"
"dota_settings_advancedpanel_goto"	"Avancerat"
"dota_settings_standardpanel_goto"	"Standard"
"dota_settings_spectatorandreplay"	"Åskådar/Repriskontroller"
"dota_settings_spectatorandreplay_pt2"	"Åskådar/Repriskontroller forts."
"dota_settings_spectatorcameraup"	"Åskådarkamera framåt"
"dota_settings_spectatorcameradown"	"Åskådarkamera bakåt"
"dota_settings_spectatorcameraleft"	"Åskådarkamera vänster"
"dota_settings_spectatorcameraright"	"Åskådarkamera höger"
"dota_settings_spectatorcameragrip"	"Åskådarkameragrepp"
"dota_settings_spectatorpause"	"Åskådarpaus"
"dota_settings_spectatorchat"	"Åskådarchatt"
"dota_settings_spectatorscoreboard"	"Åskådare - poängtavla"
"dota_settings_spectatorbroadcastermenu"	"Öppna kommentatormeny"
"dota_settings_spectatorincreasereplayspeed"	"Öka reprishastighet"
"dota_settings_spectatordecreasereplayspeed"	"Minska reprishastighet"
"dota_settings_spectatorstatsharvest"	"Åskådare - Harveststatistik"
"dota_settings_spectatorstatsitem"	"Åskådare - Föremålstatistik"
"dota_settings_spectatorstatsgold"	"Åskådare - Guldgraf"
"dota_settings_spectatorstatsxp"	"Åskådare - XP-graf"
"dota_settings_spectatorstatsfantasy"	"Åskådare - Fantasistatistik"
"dota_settings_spectatorfowboth"	"Åskådare - FOW båda lagen"
"dota_settings_spectatorfowradient"	"Åskådare - FOW Radiant"
"dota_settings_spectatorfowdire"	"Åskådare - FOW Dire"
"dota_settings_statsdropdown"	"Statistiklista"
"dota_settings_spectatordropdown_sort"	"Ändra ordning"
"dota_settings_spectatordropdown_close"	"Rensa kategori"
"dota_settings_spectatordropdown_kda"	"Dödade/Dödsfall/Assister"
"dota_settings_spectatordropdown_lasthits_denies"	"Dödande träffar/Nekanden"
"dota_settings_spectatordropdown_level"	"Hjältenivå"
"dota_settings_spectatordropdown_xp_per_min"	"XP Per Minut"
"dota_settings_spectatordropdown_gold"	"Nuvarande guld"
"dota_settings_spectatordropdown_totalgold"	"Nettovärde"
"dota_settings_spectatordropdown_gold_per_min"	"Guld per minut"
"dota_settings_spectatordropdown_buyback"	"Återköpsstatus"
"dota_settings_spectatordropdown_fantasy"	"Fantasipoäng"
"dota_settings_coaching"	"Coaching"
"dota_settings_spectatorcoach_viewtoggle"	"Coach - Växla elevperspektiv"
"dota_settings_keyboardtemplate"	"Välj en tangentsbordsmall"
"dota_settings_or"	"eller"
"dota_settings_cancel"	"Avbryt"
"dota_settings_apply"	"Verkställ"
"dota_settings_game"	"Spel"
"dota_settings_autoattack"	"Auto-attack"
"dota_settings_attackafterspell"	"Auto-attackera efter förmåga"
"dota_settings_autopurchase"	"Köp föremål automatiskt"
"dota_settings_autoselect"	"Välj framkallade enheter automatiskt"
"dota_settings_doubletapself"	"Dubbelklickad förmåga används på dig själv"
"dota_settings_unifiedorders"	"Enade enhetsorder"
"dota_settings_teleportrequireshalt"	"Teleportering kräver stopp"
"dota_settings_herofinder"	"Håll inne ALT för att framhäva hjälte"
"dota_settings_alwaysshownames"	"Visa spelarnamn ovanför hälsomätare"
"dota_settings_showhitpoints"	"Visa HP ovanför spelares hälsomätare"
"dota_settings_forceshophotkeys"	"Butiken använder alltid snabbknappar"
"dota_settings_usebroadcastermenu"	"Använd kommentatorns statistik"
"dota_settings_colorblind"	"Färgblint läge"
"dota_settings_reducedflash"	"Reducera blixteffekter"
"dota_settings_minimap"	"Minikarta"
"dota_settings_minimapsimplecolors"	"Minikarta: Enkla färger"
"dota_settings_minimaphidebackground"	"Minikarta: Dölj bakgrund"
"dota_settings_minimapshowheroicon"	"Minikarta: Visa hjälteikoner med ALT"
"dota_settings_minimapalwaysshowname"	"Minikarta: ALT alltid på"
"dota_settings_minimapflip"	"Minikarta på höger sida"
"dota_settings_cameradecel"	"Kamerahastighetsminskning"
"dota_settings_cameraspeed"	"Kamerahastighet"
"dota_settings_camerareversegrip"	"Omvänt kameragrepp"
"dota_settings_cameraedgepan"	"Kantpanorering"
"dota_settings_camerascreenshake"	"Aktivera skärmskakningar"
"dota_settings_cameraresetonspawn"	"Flytta kamera vid återskapning"
"dota_settings_cameradeadcolorshift"	"Kamera: Färgändring vid dödsfall"
"dota_settings_profile"	"Profil"
"dota_settings_hideprofile"	"Dölj Dota- och Steam-profil"
"dota_settings_exposematchdata"	"Dela matchhistorik"
"dota_settings_ignorenonfriendparties"	"Blockera gruppinbjudningar från icke-vänner"
"dota_settings_ignorenonfriendguilds"	"Blockera gilleinbjudningar från icke-vänner"
"dota_settings_allowtradeinvitesheader"	"Bytesinbjudningar från:"
"dota_settings_trade_guildandfriends"	"Gillemedlemmar och vänner"
"dota_settings_trade_friends"	"Endast vänner"
"dota_settings_trade_anyone"	"Alla"
"dota_settings_network"	"Nätverk"
"dota_settings_networkquality"	"Nätverkskvalité"
"dota_settings_networkquality_low"	"Låg"
"dota_settings_networkquality_high"	"Hög"
"dota_settings_usenativeresolution"	"Använd min skärms nuvarande upplösning"
"dota_settings_customresolution"	"Använd avancerade inställningar"
"dota_settings_resolution"	"Upplösning"
"dota_settings_rendering"	"Rendering"
"dota_settings_aspectratio"	"Bildförhållande"
"dota_settings_aspectratio43"	"4:3"
"dota_settings_aspectratio169"	"16:9"
"dota_settings_aspectratio1610"	"16:10"
"dota_settings_resolution_size"	"Storlek"
"dota_settings_resolution_display_mode"	"Visningsläge"
"dota_settings_fullscreen"	"Exklusiv helskärm"
"dota_settings_window"	"Fönster"
"dota_settings_borderless"	"Kantfritt fönster"
"dota_settings_videodefaults"	"Återställ till standard"
"dota_settings_basicvideosettings"	"Använd grundläggande inställningar"
"dota_settings_fastestvideo"	"Snabbast"
"dota_settings_appearancevideo"	"Snyggast"
"dota_settings_advancedvideosettings"	"Använd avancerade inställningar"
"dota_settings_antialiasing"	"Anti-Aliasing"
"dota_settings_specular"	"Speglande"
"dota_settings_bloom"	"Speglande och Ljus-blooms"
"dota_settings_waterquality"	"Hög vattenkvalitet"
"dota_settings_fog"	"Atmosfärisk dimma"
"dota_settings_animateportrait"	"Animera porträtt"
"dota_settings_additivelight"	"Additivt ljuspass"
"dota_settings_worldlight"	"Världsljussättning"
"dota_settings_ambientocclusion"	"Ambient Occlusion"
"dota_settings_ambientcreatures"	"Varelser i omgivning"
"dota_settings_normal_maps"	"Normal Maps"
"dota_settings_vsync"	"VSync"
"dota_settings_renderquality"	"Renderingskvalitet"
"dota_settings_shadowquality"	"Skuggkvalitet"
"dota_settings_shadowquality_low"	"Låg"
"dota_settings_shadowquality_med"	"Med"
"dota_settings_shadowquality_high"	"Hög"
"dota_settings_texturequality"	"Texturkvalitet"
"dota_settings_texturequality_low"	"Låg"
"dota_settings_texturequality_med"	"Med"
"dota_settings_texturequality_high"	"Hög"
"dota_settings_mastervolume"	"Huvudvolym"
"dota_settings_gamevolume"	"Spelljud"
"dota_settings_musicvolume"	"Musik"
"dota_settings_voicevolume"	"Röst"
"dota_settings_gamevoicevolume"	"Enhetstal"
"dota_settings_openmic"	"Aktivera Open Mic för att kommunicera med gruppmedlemmar"
"dota_settings_openmicthreshold"	"Tröskelvärde för Open Mic"
"dota_settings_audiodefaults"	"Ljudstandard"
"dota_settings_defaultaudio"	"Standard"
"dota_settings_sounddevice"	"Ljudenhet:"
"dota_settings_speakerconfig"	"Högtalarkonfiguration:"
"dota_settings_headphones"	"Hörlurar"
"dota_settings_2speakers"	"2 högtalare"
"dota_settings_4speakers"	"4 högtalare"
"dota_settings_5speakers"	"5.1 högtalare"
"dota_settings_7speakers"	"7.1 högtalare"
"dota_settings_captions"	"Använd textning"
"dota_settings_playsoundinbackground"	"Spela ljud vid alt-tab"
"dota_settings_chatsounds"	"Ljud för chattmeddelanden"
"dota_settings_mutecobroadcasters"	"Stäng av medkommentators ljud"
"dota_settings_highqualityaudio"	"Hög ljudkvalitet"
"dota_settings_enhancestereo"	"Förbättrad stereo"
"dota_settings_unitspeeh"	"Enhetstal"
"dota_settings_unitspeech_off"	"Av"
"dota_settings_unitspeech_events"	"Händelser"
"dota_settings_unitspeech_all"	"Alla"
"OS_Default_Device"	"Standardenhet"
"DOTA_Keybind_ARROW"	"Pil (Standard)"
"DOTA_Keybind_WASD"	"WASD"
"DOTA_Keybind_MMO"	"MMO"
"DOTA_Keybind_LEGACY"	"Legacy Keys"
"DOTA_Keybind_LOL"	"League of Legends"
"DOTA_Keybind_HON"	"Heroes of Newerth"
"DOTA_Keybind_SMITE"	"Smite"
"DOTA_Hotkeys_Tooltip_LearnAbility"	"Gå in i Lära-förmåga-läget när du har förmågepoäng att spendera."
"DOTA_Hotkeys_Tooltip_LearnStats"	"Lägg till två poäng till var och en av dina stats när du har förmågepoäng att spendera."
"DOTA_Hotkeys_Tooltip_HeroAttack"	"Flytta till en plats men attackera fiender du ser på vägen dit / Attackera en allierad enhet om den går att neka."
"DOTA_Hotkeys_Tooltip_HeroMove"	"Flytta till en plats, eller följ efter en enhet utan att attackera den."
"DOTA_Hotkeys_Tooltip_HeroStop"	"Avbryt din pågående handling."
"DOTA_Hotkeys_Tooltip_HeroHold"	"Avbryt din pågående handling och håll din position."
"DOTA_Hotkeys_Tooltip_HeroSelect"	"Välj din hjälte."
"DOTA_Hotkeys_Tooltip_SelectAll"	"Välj alla enheter du kontrollerar."
"DOTA_Hotkeys_Tooltip_SelectAllOthers"	"Välj alla andra enheter du kontrollerar. (Din hjälte kommer inte att väljas.)"
"DOTA_Hotkeys_Tooltip_CourierSelect"	"Välj kuriren."
"DOTA_Hotkeys_Tooltip_CourierDeliver"	"Få kuriren att leverera föremål från ditt förråd till dig."
"DOTA_Hotkeys_Tooltip_CourierHaste"	"Aktivera en snabbhetsökning för kuriren när den är tillgänglig."
"DOTA_Hotkeys_Tooltip_UseActionItem"	"Använd handlingsföremål."
"DOTA_Hotkeys_Tooltip_HeroTaunt"	"Använd ditt hjältehån. Tillgängligt som ett utrustningsbart föremål."
"DOTA_Hotkeys_Tooltip_ShopToggle"	"Öppna butikspanelen."
"DOTA_Hotkeys_Tooltip_PurchaseQuickbuy"	"Köp nästa föremål i ditt snabbköpsområde om du har råd."
"DOTA_Hotkeys_Tooltip_PurchaseSticky"	"Köp föremålet som är i Sticky-området om du har råd med det."
"DOTA_Hotkeys_Tooltip_GrabStashItems"	"Överför alla föremålen från ditt förråd till din hjälte."
"DOTA_Hotkeys_Tooltip_RecentEvent"	"Flytta kameran till den senaste händelsen i världen."
"DOTA_Hotkeys_Tooltip_InspectHeroInWorld"	"Visa en enhet på nära håll."
"DOTA_Hotkeys_Tooltip_ChatTeam"	"Skicka ett meddelande till alla i ditt lag."
"DOTA_Hotkeys_Tooltip_ChatGlobal"	"Skicka ett meddelande till alla i din pågående match. (Lägger till en SHIFT-modifierare till snabbtangenten för lagchatt)"
"DOTA_Hotkeys_Tooltip_ChatVoiceParty"	"Använd din mikrofon för att kommunicera med alla gruppmedlemmar. Om Open Mic är aktiverad kommer den även att fungera i dashboard."
"DOTA_Hotkeys_Tooltip_ChatVoiceTeam"	"Använd din mikrofon för att kommunicera med alla lagkamrater."
"DOTA_Hotkeys_Tooltip_ChatWheel"	"Öppnar chatthjulet för enkel förmedling av vanligt förekommande fraser."
"DOTA_Hotkeys_Tooltip_CameraGrip"	"Håll nere och dra på världen för att flytta kameran. Är också bunden till musens mittknapp."
"DOTA_Hotkeys_Tooltip_ActivateGlyph"	"Aktiverar Glyph of Fortification för att göra ditt lags byggnader odödliga i 5 sekunder."
"DOTA_Hotkeys_Tooltip_ScoreboardToggle"	"Öppna poänglistan."
"DOTA_Hotkeys_Tooltip_Pause"	"Pausa och återaktivera en pågående match."
"DOTA_Hotkeys_Tooltip_ScreenshotSettings"	"Ta en skärmdump av den nuvarande spelvyn."
"DOTA_Hotkeys_Tooltip_Console"	"Öppna konsolen. (Endast för avancerade användare)"
"DOTA_Hotkeys_Tooltip_ControlGroupCycle"	"Växla mellan varje enhet i en vald grupp."
"DOTA_Hotkeys_Tooltip_Group"	"Välj en förinställd kontrollgrupp av enheter. För att definiera en kontrollgrupp, välj de önskade enheterna och håll inne CTRL + en av dessa snabbknappar."
"DOTA_Hotkeys_Tooltip_Legacy"	"Använd alla snabbknappar som associeras med Dota 1. Snabbknapparna för förmågor kommer att variera efter hjälte."
"DOTA_Hotkeys_Tooltip_Quickcast"	"En snabbanvänd förmåga kommer att användas där musen pekar så fort snabbknappen trycks ned."
"DOTA_Hotkeys_Tooltip_Autocast"	"Växla för att automatiskt använda en förmåga när den är redo. Tillämpas bara på vissa förmågor."
"DOTA_Hotkeys_Tooltip_Cast"	"Snabbknappar för att använda en hjälteförmåga."
"DOTA_Hotkeys_Tooltip_ItemCast"	"Snabbknappar för att använda ett föremål i din ryggsäck."
"DOTA_Hotkeys_Tooltip_ItemQuickcast"	"Ett snabbanvänt föremål kommer att användas där musen pekar så fort snabbknappen trycks ned."
"DOTA_Settings_Tooltip_Autoattack"	"Flytta automatiskt till och attackera fiender i närheten."
"DOTA_Settings_Tooltip_AutoattackAfterSpell"	"Om omarkerad kommer hjälten stanna på plats efter att en förmåga använts och invänta nästa order."
"DOTA_Settings_Tooltip_AutoPurchase"	"Köper nästa föremål i listan över föreslagna föremål när du har råd med den."
"DOTA_Settings_Tooltip_AutoSelectSummons"	"När nya enheter framkallas av hjälten, läggs de till i din markeringsgrupp."
"DOTA_Settings_Tooltip_DoubleTap"	"Dubbelklicka på en förmåga eller ett föremål, eller tryck på dess tilldelade snabbtangent två gånger för att använda den på dig själv när det går."
"DOTA_Settings_Tooltip_UnifiedOrders"	"Om du håller ned CTRL när du utfärdar en order skickas den till alla enheter som du styr."
"DOTA_Settings_Tooltip_TeleportStop"	"Förflyttning eller användandet av en förmåga kommer inte att avbryta en pågående teleportering. Gäller endast Teleport Scrolls och Boots of Travel."
"DOTA_Settings_Tooltip_BroadcasterStats"	"När du tittar på en match, visa samma statistik-dropdown som kommentatorn använder."
"DOTA_Settings_Tooltip_Deceleration"	"Den hastighet med vilken kameran kommer till vila efter att ha flyttats. Ett större nummer motsvarar ett snabbare stopp."
"DOTA_Settings_Tooltip_Screenshake"	"Vissa trollformler och bedövningar skakar kameran."
"DOTA_Settings_Tooltip_CameraRespawn"	"Kameran fokuserar på din hjälte så snart den återskapats."
"DOTA_Settings_Tooltip_HideProfile"	"Din Dota 2-profil kommer inte kunna kommas åt av någon. Din Steam-profil kommer inte kunna kommas åt från Dota 2."
"DOTA_Settings_Tooltip_ShareMatchData"	"Delar matchdata från dina allmänna matcher till tredjepartsorgan."
"DOTA_Settings_Tooltip_NetworkQuality"	"Om du har en mindre bra nätverksanslutning kan det kanske hjälpa att ställa in det här alternativet till \\\"LÅG\\\"."
"DOTA_Settings_Tooltip_MinimapSimple"	"Färger på minikartan bestäms av lagen istället för individuella spelare."
"DOTA_Settings_Tooltip_MinimapDrawHeroes"	"När du håller ALT, visa en ikon av hjälten på minikartan, istället för hjältens namn."
"DOTA_Settings_Tooltip_MinimapNamesIcon"	"Visar alltid hjälteikonen eller hjältens namn i minikartan, håll inne ALT för att temporärt visa X och O."
"DOTA_Settings_Tooltip_ShopHotkeys"	"Snabbknappar i butiken överskrider alla knappar som tilldelats andra funktioner när butiken är öppen."
"DOTA_Settings_LegacyKeysActive"	"Legacy Keys från Dota 1 är för närvarande aktiverade. För att anpassa individuella snabbtangenter, stäng först av Legacy Keys."
"DOTA_create_bot_practice_desc"	"Spela en match mot bottar. Du kan använda matchning för att spela med andra mänskliga lagkamrater eller fylla dina tomma lagplatser med bottar."
"DOTA_Lobby_BotDifficulty"	"Bottars svårighetsgrad"
"DOTA_Lobby_BotDifficulty_no_bot"	"Ingen Bot"
"DOTA_Lobby_BotDifficulty_passive"	"Passiva"
"DOTA_Lobby_BotDifficulty_easy"	"Lätt"
"DOTA_Lobby_BotDifficulty_medium"	"Medium"
"DOTA_Lobby_BotDifficulty_hard"	"Svår"
"DOTA_Lobby_BotDifficulty_unfair"	"Orättvis"
"DOTA_Lobby_BotTeam"	"Välj Lag"
"DOTA_create_bot_practice_solo"	"Solo"
"DOTA_create_bot_practice_solo_desc"	"Öva själv mot bottar i en lokal match. Använder inte matchning och du kan lämna närsomhelst."
"DOTA_create_bot_practice_coop"	"Co-Op"
"DOTA_create_bot_practice_coop_desc"	"Använd matchning för att spela med andra mot bottar. <font color='#dd6666'>OBS:</font> Att överge denna bot-match kommer leda till en bestraffning."
"DOTA_Lobby_BotDifficulty_bot_passive"	"Passiv Bot"
"DOTA_Lobby_BotDifficulty_bot_easy"	"Lätt Bot"
"DOTA_Lobby_BotDifficulty_bot_medium"	"Medium Bot"
"DOTA_Lobby_BotDifficulty_bot_hard"	"Svår Bot"
"DOTA_Lobby_BotDifficulty_bot_unfair"	"Orättvis Bot"
"dota_lobby_title"	"{s:lobby_name}"
"dota_lobby_title_local_game"	"Lokal Lobby"
"dota_lobby_title_default"	"Lobby"
"lobby_row_player_name"	"{s:player_name}"
"dota_lobby_row_game_name"	"{s:game_name}"
"dota_lobby_row_slots"	"{s:slots}"
"dota_lobby_row_game_mode"	"{s:game_mode}"
"dota_lobby_row_join"	"Gå med"
"dota_lobby_row_leave"	"Lämna"
"dota_lobby_coaches_title"	"Coacher"
"dota_lobby_browser_all_game_modes"	"Alla spellägen"
"dota_lobby_browser_title"	"Bläddra Dota-lobbyer"
"dota_lobby_browser_num_available"	"( {d:lobbies_available} tillgängliga )"
"dota_lobby_browser_no_lobbies"	"Inga lobbyer hittades"
"dota_lobby_browser_no_matching_lobbies"	"Hittade inga lobbyer som matchade din sökning"
"dota_lobby_browser_updating"	"Uppdaterar lobbylistan..."
"dota_lobby_browser_search_placeholder"	"Sök lobbyer"
"dota_lobby_browser_game_mode"	"Spelläge"
"dota_lobby_browser_refresh"	"Uppdatera"
"dota_lobby_browser_filter_title"	"Filtrera lobbyer"
"dota_lobby_submit_filter"	"Ange"
"dota_popup_lobby_password_title"	"Ange lobbylösenord"
"DOTA_AttackCapability_Melee"	"Närstrid"
"DOTA_AttackCapability_Ranged"	"Avstånd"
"DOTA_Item_OnMarket"	"Marknad"
"DOTA_Items_DefaultSet"	"Standardset"
"DOTA_Items_SetEquipped_Label"	"Utrustad"
"DOTA_EquippedItem_Label"	"Utrustad"
"DOTA_PreviewingItem_Label"	"Förhandsvisar"
"DOTA_EquippedItem_Rarity"	"{s:equipped_econ_set_rarity}"
"DOTA_EquippedItem_SetName"	"{s:equipped_econ_set_name}"
"DOTA_EquippedItem_DefaultSet"	"Standardset"
"DOTA_EquippedItem_PartialSet"	"Ofullständigt set"
"DOTA_EquippedItem_Style"	"{i:equipped_econ_set_style_count} stil(ar)"
"DOTA_EquippedItem_Button_Details"	"{s:equipped_details_button_text}"
"DOTA_EquippedItem_Customize"	"Anpassa"
"DOTA_EquippedItem_CustomSet"	"Anpassat set"
"DOTA_EquippedItem_Equip"	"Utrusta"
"DOTA_EquippedItem_Unpack_And_Equip"	"Packa upp och utrusta"
"DOTA_EquippedItem_Details"	"{s:equipped_econ_set_type_name} detaljer"
"DOTA_EquippedItem_Purchase_Button"	"Köp"
"DOTA_EquippedItem_Marketplace_Button"	"Marknad"
"DOTA_EquippedItem_BundleName"	"I paketet \"{s:equipped_econ_set_bundle}\""
"DOTA_EquippedItem_FilterText"	"Förhandsvisar"
"DOTA_EquippedItem_SaleAmount"	"-{i:equipped_econ_set_sale_amount}%"
"DOTA_EquippedItem_RegularSetPrice"	"{s:equipped_econ_regular_set_price}"
"DOTA_EquippedItem_SetPrice"	"{s:equipped_econ_set_price}"
"DOTA_EquippedItem_TreasurePrice"	"{s:equipped_econ_treasure_price}"
"DOTA_HeroDemo_Button"	"Demo {s:econ_item_category_name}"
"DOTA_HeroDemo_Button_Tooltip"	"Starta demoläget för att prova detta föremålsset eller hjältens förmågor"
"DOTA_HeroDemo_Button_Return"	"Tillbaka till demo"
"DOTA_HeroDemo_Button_Return_Tooltip"	"Gå tillbaka till demoläget och läs in det föremålsset eller hjälte som valts"
"DOTA_HeroDemo_Button_DBQuit"	"Avsluta demo"
"DOTA_EquippedItem_Bundle"	"Paket"
"DOTA_EquippedItem_ItemSet"	"Set"
"DOTA_EquippedItem_Item"	"Föremål"
"DOTA_EconItemSet_Name"	"{s:econ_set_name}"
"DOTA_EconItemSet_Rarity"	"{s:econ_set_rarity}"
"DOTA_EconItemSet_Status"	"{s:econ_set_status}"
"DOTA_EconItemSet_Price"	"{s:econ_set_price}"
"DOTA_EconItemSet_SaleAmount"	"-{i:econ_sale_amount}%"
"DOTA_EconItemSet_DeveloperOnly"	"Ej offentlig"
"DOTA_EconItemSet_Tooltip_InBundle"	"Detta set finns i ett paket"
"DOTA_EconItemSet_Tooltip_PartialSet"	"Innehåller bara en del av det fullständiga setet"
"DOTA_EconItemSet_Tooltip_MultipleStyles"	"Har flera stilar"
"DOTA_HeroRole_Carry"	"Carry"
"DOTA_HeroRole_Support"	"Support"
"DOTA_HeroRole_Nuker"	"Nuker"
"DOTA_HeroRole_Disabler"	"Disabler"
"DOTA_HeroRole_Jungler"	"Jungler"
"DOTA_HeroRole_Durable"	"Durable"
"DOTA_HeroRole_Escape"	"Escape"
"DOTA_HeroRole_LaneSupport"	"Lane Support"
"DOTA_HeroRole_Pusher"	"Pusher"
"DOTA_HeroRole_Initiator"	"Initiator"
"DOTA_HeroRole_Description_Carry"	"Blir mer användbar senare i matchen om de får ett betydande övertag i guld."
"DOTA_HeroRole_Description_Support"	"Kan fokusera mindre på att samla guld och föremål, och mer på att använda sina förmågor för att ge sitt lag ett övertag."
"DOTA_HeroRole_Description_Nuker"	"Kan snabbt döda fiendehjältar med förmågor som skadar mycket och har låga cooldowns."
"DOTA_HeroRole_Description_Disabler"	"Har en eller fler förmågor som garanterat hindrar fiender på något vis."
"DOTA_HeroRole_Description_Jungler"	"Kan effektivt döda neutrala creeps i djungeln tidigt i matchen."
"DOTA_HeroRole_Description_Durable"	"Har förmågan att överleva längre i lagstrider."
"DOTA_HeroRole_Description_Escape"	"Har förmågan att snabbt undvika döden."
"DOTA_HeroRole_Description_LaneSupport"	"Hjälpsam med att beskydda sitt lags bärande hjälte och låta honom farma under matchens tidiga skede."
"DOTA_HeroRole_Description_Pusher"	"Kan snabbt skada och förstöra torn och baracker närsomhelst under matchen."
"DOTA_HeroRole_Description_Initiator"	"Bra på att inleda en lagstrid."
"DOTA_HeroGrid_OptionCategory_Role"	"Roller:"
"DOTA_HeroGrid_OptionCategory_Attributes"	"Attribut:"
"DOTA_HeroGrid_OptionCategory_AttackType"	"Attacktyp:"
"DOTA_HeroLoadout_PreviousHeroName"	"{s:previous_hero_name}"
"DOTA_HeroLoadout_NextHeroName"	"{s:next_hero_name}"
"DOTA_HeroLoadout_CurrentHeroName"	"{s:hero_name}"
"DOTA_HeroLoadout_AttackType"	"{s:hero_attack_type}"
"DOTA_HeroLoadout_HeroFilterName"	"Hjälte"
"DOTA_HeroLoadout_Search"	"Sök efter föremål till {s:hero_name}"
"DOTA_HeroCustomize_Title"	"Anpassa hjälte"
"DOTA_HeroCustomize_OwnedItems"	"Ägda föremål"
"DOTA_HeroCustomize_Slot"	"Plats"
"DOTA_HeroCustomize_SlotName"	"{s:slot_name}"
"DOTA_HeroCustomize_SlotEquippedItemName"	"{s:equipped_item_name}"
"DOTA_HeroCustomize_DefaultItemName"	"Standardföremål"
"DOTA_HeroCustomize_PreviewItemName"	"{s:preview_item_name}"
"DOTA_HeroCustomize_PreviewStyle"	"{s:preview_style_name}"
"DOTA_HeroCustomize_PreviewItemSlot"	"{s:preview_item_slot}"
"DOTA_HeroCustomize_Rarity"	"{s:preview_item_rarity}"
"DOTA_HeroCustomize_StyleLocked"	"Förutsättning krävs för att utrustas"
"DOTA_UIEconItem_StyleIndex"	"{i:style_index}"
"dota_ready_up_num_accepted"	"{i:num_accepted} / {i:total_players} accepterade"
"returning_top_of_queue"	"Går tillbaka till matchning med hög prioritet"
"returning_to_lobby"	"Återgår till lobbyn för att hitta fler spelare..."
"GC_reconnecting"	"Återställer anslutningen till Dota 2-nätverket..."
"GC_nosteam"	"Ingen anslutning till Steam"
"GC_searching"	"Söker efter Dota 2-nätverket..."
"GC_noconnection"	"Ej ansluten till Dota 2-nätverket."
"GC_connecting"	"Ansluter till Dota 2-nätverket..."
"GC_connected"	"Ansluten till Dota 2-nätverket."
"GC_down"	"Dota 2-nätverket är för tillfället offline."
"GC_Network_Full"	"Dota 2-nätverket är för tillfället fullt."
"GC_Queue_Position"	"Dota 2 matchkoordinator är för närvarande full. Köplats: {i:gc_queue_position}"
"GC_Queue_Wait_Time"	"Dota 2 matchkoordinator är för närvarande full. Köplats: {i:gc_queue_position}, Beräknad väntetid: {s:gc_queue_wait_time}"
"GC_Wait_Time"	"Ungefärlig väntetid: %s1"
"GC_Wait_Time_Unknown"	"Okänd"
"GC_suspended"	"Konto avstängt efter att VAC har upptäckt externa verktyg som kopplats till Dota 2."
"dota_practice_vs_bots"	"Börja träna mot bottar"
"dota_practice_vs_bots_desc"	"Spela en träningsmatch mot bottar. Detta använder inte matchning och du kan lämna matchen närsomhelst."
"dota_practice_vs_bots_difficulty"	"Bottars svårighetsgrad"
"dota_practice_vs_bots_team"	"Spela som vilket lag?"
"DOTA_practice_vs_bots_team_radiant"	"Radiant"
"DOTA_practice_vs_bots_team_dire"	"Dire"
"DOTA_practice_vs_bots_team_random"	"Slumpvalt"
"DOTA_EmoticonUpsell"	"Uttryckssymboler låses upp genom att köpa vissa hjälteföremål eller turneringsbiljetter."
"DOTA_CurrentTime"	"{t:t:current_time}"
"DOTA_MonthlyPlayers"	"{s:users_last_month}"
"DOTA_MonthlyPlayersLabel"	"Unika spelare senaste månaden"
"DOTA_CurrentPlayers"	"{s:current_users}"
"DOTA_CurrentPlayersLabel"	"Spelare i spelet nu"
"DOTA_Search_NoResults"	"Inga resultat"
"DOTA_Search_ItemShortDescription"	"<span class=\"ItemRarityColor\">{s:item_rarity}</span> {s:item_slot}"
"join_error_already_in_game"	"Du kan inte gå med i övningslobbyn eftersom du redan är med i ett spel."
"join_error_invalid_lobby"	"Den lobby som du angav finns inte längre."
"join_error_incorrect_password"	"Felaktigt lösenord."
"join_error_access_denied"	"Tillgång nekad."
"join_error_generic"	"
"
"join_error_in_team_party"	"Kunde inte gå med i övningslobby. Du måste upphäva din laggrupp innan du går med i övningsspel."
"join_error_lobby_full"	"Lobbyn är full."
"join_error_timed_out"	"Begäran överskred tidsgränsen."
"DOTA_Friends_Ready_To_Play"	"Öppna matcher"
"DOTA_Friend_Finding_Match"	"Letar match..."
"DOTA_Friend_In_Match"	"I match"
"DOTA_Friend_Solo_Open_Party"	"{s:player_name} vill spela"
"DOTA_Friend_In_Party_Open"	"{s:player_name} är en öppen grupp"
"DOTA_Friend_Solo_Open_Party_Self"	"Du letar efter gruppmedlemmar"
"DOTA_Friend_In_Open_Party_Self"	"Du är med i en öppen grupp"
"DOTA_Friends_In_Party_Open"	"{d:num_friends} vänner i öppen grupp"
"DOTA_Friend_Lobby_Mode_Self"	"Du är i en {s:game_mode} lobby"
"DOTA_Friend_Lobby_Mode_1_Friend"	"{s:player_name} i {s:game_mode} lobby"
"DOTA_Friend_Lobby_Mode_N_Friends"	"{d:num_friends} vänner i {s:game_mode} lobby"
"DOTA_Friend_Lobby_Mode_Small"	"{s:game_mode} lobby"
"DOTA_Friend_Lobby_Players"	"{d:player_count} / {d:max_player_count}"
"DOTA_Friend_Lobby_Join_Button"	"{s:join_button_text}"
"DOTA_Friend_Lobby_Friend_Count"	"+{d:extra_friend_count}"
"DOTA_Friend_Invite_To_Party"	"Bjud in till grupp"
"DOTA_Friend_SuggestInviteToParty"	"Föreslå inbjudan till grupp"
"DOTA_Request_Join_Party"	"Begär inbjudan till grupp"
"DOTA_Request_Merge_Parties"	"Begär hopslagning av grupper"
"DOTA_Request_Merge_Parties_NotLeader"	"Gruppledaren kan begära hopslagning av grupper."
"DOTA_Friend_PartyInvitePending"	"Pågående gruppinbjudan"
"DOTA_Friend_PartyInvitePending_Leader"	"Pågående gruppinbjudan<br/>Klicka för att avbryta inbjudan"
"DOTA_Friend_PartyMergeRequestPending"	"Väntande begäran på grupphopslagning"
"DOTA_Friend_PartyMergeRequestPending_Leader"	"Väntande begäran på grupphopslagning<br/>Klicka för att avbryta begäran"
"DOTA_Friend_JoinParty"	"Gå med i grupp"
"DOTA_Friend_Watch"	"Titta"
"DOTA_PartyVisTooltip_SoloTitleOpen"	"Vill spela"
"DOTA_PartyMerge_Error_Title"	"Grupphopslagning misslyckades"
"DOTA_PartyMerge_Error_NOT_LEADER"	"Grupphandlingar kan endast utföras av gruppledaren."
"DOTA_PartyMerge_Error_TOO_MANY_PLAYERS"	"Grupper kan inte slås ihop för att det är för många spelare."
"DOTA_PartyMerge_Error_TOO_MANY_COACHES"	"Grupper kan inte slås ihop för det är för många coacher."
"DOTA_PartyMerge_Error_ENGINE_MISMATCH"	"Grupper kan inte slås ihop för att de spelar olika versioner av Dota."
"DOTA_PartyMerge_Error_NO_SUCH_GROUP"	"Gruppen finns inte längre."
"DOTA_PartyMerge_Error_OTHER_GROUP_NOT_OPEN"	"Gruppen är inte öppen för begäran om hopslagning."
"DOTA_Feed_Timestamp_Recently"	"Just nu"
"DOTA_Feed_Timestamp_MinutesAgo"	"{i:value} minuter sedan"
"DOTA_Feed_Timestamp_HourAgo"	"{i:value} timme sedan"
"DOTA_Feed_Timestamp_HoursAgo"	"{i:value} timmar sedan"
"DOTA_Feed_Timestamp_Yesterday"	"Igår"
"DOTA_Feed_Timestamp_Date"	"{s:month} {s:day}"
"dota_lobby_type_general"	"Orankad"
"dota_lobby_type_practice"	"Träningsspel"
"dota_lobby_type_practice_game_mode_custom"	"Anpassat spel"
"dota_lobby_type_tournament"	"Turneringsspel"
"dota_lobby_type_coop_bot"	"Co-op Bot"
"dota_lobby_type_competitive"	"Rankad Match"
"dota_lobby_type_casual_1v1"	"1v1 Match"
"dota_lobby_unknown"	"Okänd"
"DOTA_Lobby_No_Players_Title"	"INGA SPELARE I ETT LAG"
"DOTA_Lobby_No_Players_Desc"	"Du måste ha minst en spelare i Radiant eller Dire."
"dota_match_result_won"	"Vann"
"dota_match_result_lost"	"Förlorade"
"dota_match_result_none"	"???"
"dota_social_feed_loading"	"Laddar..."
"DOTA_LoadingPlayerUnknown"	"-"
"DOTA_LoadingPlayerLoading"	"Laddar..."
"DOTA_LoadingPlayerFullyConnected"	"Redo"
"DOTA_LoadingPlayerFailed"	"Misslyckades"
"LoadingScreenTimer"	"{t:d:countdown_timer_seconds}"
"HeroSelectionTimer"	"{i:timer_seconds}"
"LoadingScreenMapInfo"	"Bana: {s:map_name}"
"LoadingScreenPlayersInfo"	"Spelare: {i:players_loaded}/{i:players_total}"
"LoadingScreenSpectatorsInfo"	"Åskådare: {i:spectators_loaded}/{i:spectators_total}"
"custom_end_screen_victory_message"	"{s:winning_team_name} vinner!"
"custom_end_screen_legend_player"	"Spelare"
"custom_end_screen_legend_level"	"Nivå"
"custom_end_screen_legend_hero"	"Hjälte"
"custom_end_screen_legend_kills"	"K"
"custom_end_screen_legend_deaths"	"D"
"custom_end_screen_legend_assists"	"A"
"custom_end_screen_legend_items"	"Föremål"
"custom_end_screen_legend_gold"	"Guld"
"custom_end_screen_legend_team_score"	"Poäng"
"custom_scoreboard_hero_name_and_desc"	"Nivå {i:hero_level} {s:hero_name}"
"CustomEndScreenClose"	"Stäng"
"DOTA_Armory_Category_Heroes"	"Hjältar"
"DOTA_Armory_Category_Companions"	"Kompanjoner"
"DOTA_Armory_Category_Couriers"	"Kurirer"
"DOTA_Armory_Category_Pets"	"Husdjur"
"DOTA_Armory_Category_World"	"Värld"
"DOTA_Armory_Category_Wards"	"Wards"
"DOTA_Armory_Category_Weather"	"Vädereffekter"
"DOTA_Armory_Category_Effigies"	"Statyer"
"DOTA_Armory_Category_Interface"	"Gränssnitt"
"DOTA_Armory_Category_Emoticons"	"Uttryckssymboler"
"DOTA_Armory_Category_LoadingScreens"	"Laddningsskärmar"
"DOTA_Armory_Category_HUDs"	"HUD:s"
"DOTA_Armory_Category_CursorPacks"	"Muspekarpaket"
"DOTA_Armory_Category_Audio"	"Ljud"
"DOTA_Armory_Category_VoicePacks"	"Röstpaket"
"DOTA_Armory_Category_AnnouncerPacks"	"Utroparpaket"
"DOTA_Armory_Category_Music"	"Musik"
"DOTA_Armory_Category_All"	"Alla"
"DOTA_Armory_Category_Other"	"Annat"
"DOTA_Armory_Category_View"	"Kategorivy"
"DOTA_Armory_Filter"	"Ställ in filter"
"DOTA_Armory_SortBy"	"Sortera efter:"
"DOTA_Armory_SortBy_Rarity"	"Sällsynthet"
"DOTA_Armory_SortBy_Quality"	"Kvalitet"
"DOTA_Armory_SortBy_Name"	"Namn"
"DOTA_Armory_SortBy_Recent"	"Inköpsdatum"
"DOTA_Armory_SortBy_Sockets"	"Antal fattningar"
"DOTA_Armory_Search"	"Sök efter vapenförrådsföremål"
"DOTA_Armory_ContextMenu_Preview"	"Föremålsdetaljer"
"DOTA_Armory_ContextMenu_PreviewSet"	"Förhandsvisa fullständigt set"
"DOTA_Armory_ContextMenu_Equip"	"Utrusta föremål"
"DOTA_Armory_ContextMenu_Unequip"	"Avrusta föremål"
"DOTA_Armory_ContextMenu_Socketing"	"Fattning"
"DOTA_Armory_ContextMenu_GiftWrap"	"Slå in föremål"
"DOTA_Armory_ContextMenu_Delete"	"Ta bort"
"dota_page_match_details_loading"	"Laddar match..."
"dota_page_match_details_victory"	"Vinnare: {s:winner}"
"dota_page_match_details_legend_player"	"Spelare"
"dota_page_match_details_legend_level"	"Nivå"
"dota_page_match_details_legend_hero"	"Hjälte"
"dota_page_match_details_legend_kills"	"K"
"dota_page_match_details_legend_deaths"	"D"
"dota_page_match_details_legend_assists"	"A"
"dota_page_match_details_legend_items"	"Föremål"
"dota_page_match_details_legend_gold"	"Guld"
"dota_page_match_details_legend_last_hits"	"LH"
"dota_page_match_details_legend_denies"	"DN"
"dota_page_match_details_legend_gold_per_min"	"GPM"
"dota_page_match_details_legend_xp_per_min"	"XPM"
"dota_page_match_details_legend_winner_tooltip"	"Vinnande lag"
"dota_page_match_details_legend_kills_tooltip"	"Dödade"
"dota_page_match_details_legend_deaths_tooltip"	"Dödsfall"
"dota_page_match_details_legend_assists_tooltip"	"Assister"
"dota_page_match_details_legend_last_hits_tooltip"	"Dödade creeps"
"dota_page_match_details_legend_denies_tooltip"	"Nekade creeps"
"dota_page_match_details_legend_gold_per_min_tooltip"	"Guld per minut"
"dota_page_match_details_legend_xp_per_min_tooltip"	"Erfarenhet per minut"
"dota_page_match_details_header_league_name"	"Liga"
"dota_page_match_details_header_custom_game_map_name"	"Bana"
"dota_page_match_details_header_match_id"	"Match-ID"
"dota_page_match_details_header_game_mode"	"Spelläge"
"dota_page_match_details_header_duration"	"Varaktighet"
"dota_page_match_details_header_timestamp"	"Matchdatum / Tid"
"dota_page_match_details_voting_votes"	"{i:num_votes} röster"
"dota_page_match_details_match_discussion"	"Matchdiskussion"
"dota_page_match_details_comment_placeholder"	"Skriv en kommentar..."
"dota_page_match_details_comment_loading_comments"	"Laddar kommentarer..."
"dota_page_match_details_comment_no_comments"	"Inga kommentarer har lagts upp för denna match"
"dota_page_match_details_replay_existence_unknown"	"Letar efter repris..."
"dota_page_match_details_replay_existence_cdn_found"	"Ladda ned repris"
"dota_page_match_details_replay_existence_not_found"	"Repris otillgänglig"
"dota_page_match_details_replay_existence_downloading"	"Laddar ned..."
"dota_page_match_details_replay_existence_disk_found_replay"	"Se på repris"
"dota_page_match_details_replay_existence_disk_found_highlights"	"Se på höjdpunkter"
"dota_page_match_details_replay_existence_wrong_engine"	"Source 1-repriser är otillgängliga i Source 2"
"dota_profile_content_tab_activity_feed"	"Aktivitetsflöde"
"dota_profile_content_tab_recent_games"	"Senaste matcher"
"dota_profile_recent_games_option_show_practice_matches"	"Visa träningsmatcher"
"dota_profile_recent_game_header_timestamp"	"Datum / Tid"
"dota_profile_recent_game_header_hero_name"	"Hjälte spelad"
"dota_profile_recent_game_header_result"	"Resultat"
"dota_profile_recent_game_header_duration"	"Varaktighet"
"dota_profile_recent_game_header_type"	"Typ"
"dota_profile_recent_game_result_win"	"Vinst"
"dota_profile_recent_game_result_loss"	"Förlust"
"dota_profile_recent_game_result_abandon"	"Övergav"
"dota_profile_recent_game_icon_source1"	"S1"
"dota_profile_hero_with_index"	"{d:hero_index} {s:hero_name}"
"dota_profile_hero"	"{s:hero_name}"
"dota_replay_manager_error_not_found"	"Kunde inte hitta repris på CDN."
"dota_replay_manager_error_existing_partial"	"Kunde inte radera befintlig partiell reprisfil."
"dota_replay_manager_error_creation_failure"	"Kunde inte skapa partiell reprisfil."
"dota_replay_manager_error_disk_full"	"Kunde inte allokera utrymme för reprisfil."
"dota_replay_manager_error_chunk_failed"	"Kunde inte ladda ned reprisfil."
"dota_replay_manager_error_write_failure"	"Kunde inte skriva till partiell reprisfil."
"dota_replay_manager_error_partial_compressed_open_failure"	"Kunde inte öppna komprimerad reprisfil."
"dota_replay_manager_error_partial_decompressed_open_failure"	"Kunde inte öppna dekomprimerad reprisfil."
"dota_replay_manager_error_partial_decompression_failure"	"Kunde inte dekomprimera reprisfil."
"dota_replay_manager_error_partial_decompression_write_failure"	"Kunde inte skriva dekomprimerad reprisfil."
"dota_page_match_details_replay_error_not_found"	"Repris hittades ej på hårddisken."
"DOTA_tooltip_econ_item_name"	"{s:item_name}"
"DOTA_tooltip_econ_item_description"	"{s:item_description}"
"DOTA_tooltip_econ_item_set"	"Del av: <font color='#dddddd'>{s:item_set}</font>"
"DOTA_tooltip_econ_item_rarity_label"	"Sällsynthet:"
"DOTA_tooltip_econ_item_rarity"	"{s:item_rarity}"
"DOTA_tooltip_econ_item_slot"	"Plats: {s:item_slot}"
"DOTA_tooltip_econ_item_gifter"	"{g:dota_persona:gifter_name}"
"DOTA_tooltip_econ_item_gift_received_date"	"Erhållen: {t:T:gift_received_date_time}"
"DOTA_tooltip_econ_item_trade_restriction_permanent"	"Ej byt- eller säljbar"
"DOTA_tooltip_econ_item_trade_restriction_date"	"Kan bytas och säljas på marknaden efter: {t:s:tradable_after_date_time}"
"DOTA_tooltip_econ_item_market_restriction_permanent"	"Ej säljbar"
"DOTA_tooltip_econ_item_gift_restriction_permanent"	"Ej skänkbar"
"DOTA_tooltip_econ_item_gift_restriction_date"	"Ej skänkbar tills: {t:T:giftable_after_date_time} {t:s:giftable_after_date_time}"
"DOTA_tooltip_econ_item_gem_type"	"{s:gem_type}"
"DOTA_tooltip_econ_item_gem_strange_count"	"{d:strange_count}"
"DOTA_tooltip_econ_item_gem_description"	"{s:gem_description}"
"DOTA_tooltip_econ_item_partner"	"{s:partner}"
"DOTA_econ_item_details_item_name"	"{s:item_name}"
"DOTA_econ_item_details_item_creation_date"	"SKAPELSEDATUM: {t:l:creation_date}"
"DOTA_econ_item_details_set_includes"	"Inkluderar följande:"
"DOTA_econ_item_details_item_set"	"Del av: <font color='#dddddd'>{s:item_set}</font>"
"DOTA_econ_item_details_rarity_label"	"Sällsynthet:"
"DOTA_econ_item_details_item_rarity"	"{s:item_rarity}"
"DOTA_econ_item_details_item_slot"	"Plats: {s:item_slot}"
"DOTA_econ_item_details_item_description"	"{s:item_description}"
"DOTA_econ_item_details_gem_type"	"{s:gem_type}"
"DOTA_econ_item_details_gem_strange_count"	"{d:strange_count}"
"DOTA_econ_item_details_gem_description"	"{s:gem_description}"
"DOTA_Treasure_Name"	"{s:treasure_name}"
"DOTA_Treasure_Rarity"	"<span class=\"ItemRarityColor\">{s:treasure_rarity}</span> skatt"
"DOTA_Voice_Party"	"Gruppröst"
"custom_game_mismatch_title"	"Data för anpassat spel matchar ej"
"custom_game_mismatch_desc"	"Det anpassade spelarkivet matcher inte mellan spelservern och -klienten."
"custom_game_team_select"	"Lagval"
"custom_game_team_select_timer"	"{i:countdown_timer_seconds}"
"custom_game_team_select_shuffle"	"Blanda"
"custom_game_team_select_auto_start"	"Auto-Start"
"custom_game_team_select_starting"	"Startar"
"custom_game_team_select_unassigned_players"	"Otilldelade spelare"
"custom_game_team_select_lock_start"	"Lås + Starta"
"custom_game_team_select_cancel_unlock"	"Avbryt + Lås upp"
"custom_game_team_select_join"	"Gå med"
"custom_game_team_select_empty_slot"	"Ledig plats"
"custom_game_team_select_auto_assign"	"Autotilldela"
"custom_game_default_gameinfo_text"	"Kom tillbaka snart för mer information om detta anpassade spel!"
"CouldntFindCompendium"	"Kunde inte ladda kompendium-testfilen: %s1"
"CompendiumPageError_Pages"	"Kunde inte hitta ett block i kompendium-datafilen."
"CompendiumPageError_Template"	"Kunde inte hitta en rad för kompendium-sida \\'%s1\\' (sidonummer %s2)"
"CompendiumPageError_Template2"	"Kunde inte hitta en mall vid namn \\'%s1\\' på kompendium-sida \\'%s2\\'"
"CompendiumPageError_Image"	"Kunde inte hitta en bild vid namn \\'%s1\\' på kompendium-sida \\'%s2\\'"
"CompendiumPageError_Text"	"Kunde inte hitta ett textblock vid namn \\'%s1\\' på kompendium-sida \\'%s2\\'"
"CompendiumPageError_Video"	"Ingen video med namnet \\'%s1\\' hittades på sida \\'%s2\\' i kompendiet"
"CompendiumPageError_Scrollbar"	"Kunde inte hitta en rullningslista kallad \\'%s1\\' på kompendium-sida \\'%s2\\'."
"CompendiumPageError_Selection"	"Kunde inte hitta en markering vid namn \\'%s1\\' på kompendium-sida \\'%s2\\'"
"CompendiumPageError_PageNames"	"Den inbäddade sidan \\'%s1\\' använder samma namn som en annan sida. Sidonamn måste vara unika."
"CompendiumPageError_CustomText"	"Fel i anpassade textblocket \\'%s1\\' på sida \\'%s2\\' i kompendiet"
"CompendiumPageError_CustomImg"	"Fel i anpassade bildblocket \\'%s1\\'"
"CompendiumPageError_CustomBar"	"Fel med det anpassade framstegsblocket \\'%s1\\' på kompendium-sida \\'%s2\\'."
"CompendiumPageError_CustomEle"	"Kunde inte instansiera det anpassade elementet \\'%s1\\' på kompendium-sida \\'%s2\\'."
"CompendiumPageError_CTFont"	"Ogiltigt typsnitt \\'%s1\\' angett på sida \\'%s2\\' i kompendiet. Giltiga typsnitt:\\\ntext, textbold, title"
"CompendiumPageError_CTAlign"	"Ogiltig placering \\'%s1\\' angiven på sida \\'%s2\\' i kompendiet. Giltiga placeringar:\\\n left, right, center"
"CompendiumPageError_CTDepth"	"Ogiltigt djup \\'%s1\\'. Giltiga djup:\\\n front, back"
"CompendiumPageError_LinePos"	"Linjen \\'%s1\\' har inte både \\'start\\'-och \\'end\\'-positionsblock."
"CompendiumPageError_CTPoints"	"Ogiltigt valindex \\'%s1\\' i sektionen \\'points\\' av den anpassade texten \\'%s2\\'."
"CompendiumPageError_CTPoints2"	"Ogiltigt valindex \\'%s1\\' i sektionen \\'points\\' av den anpassade texten \\'%s2\\'. Inget val hittades med det indexet."
"CompendiumPageError_SelDesc"	"Kunde inte hitta en beskrivningsnyckel för markering \\'%s1\\' på kompendium-sida \\'%s2\\'"
"CompendiumPageError_Points"	"Saknar (eller inga) poäng specificerade för markeringen \\'%s1\\' på kompendium-sida \\'%s2\\'"
"CompendiumPageError_SelType"	"Saknar \\'choice_type\\' för markering \\'%s1\\' på kompendium-sida \\'%s2\\'"
"CompendiumPageError_BarType"	"Saknar \\'data\\' för förloppsmätaren \\'%s1\\' i kompendiumet, sida \\'%s2\\'"
"CompendiumPageError_NoTime"	"Saknar eller ogiltig \\'time\\' angiven för valet \\'%s1\\' i \\'%s2\\'."
"CompendiumPageError_ElementType"	"Saknar eller en ogiltig \\'elementtype\\' för elementet \\'%s1\\' på kompendium-sida \\'%s2\\'."
"CompendiumPageError_SelTimer"	"Okänd timer vid namn \\'%s1\\' på kompendium-sida \\'%s2\\'"
"CompendiumPageError_BadElement"	"Okänt SF-element kallat \\'%s1\\' på kompendium-sida \\'%s2\\'."
"CompendiumPageError_SelNoTimer"	"Inga timers hittades på kompendium-sida \\'%s1\\' (den har markeringar som behöver en timer)"
"CompendiumPageError_SelUnknown"	"Ogiltig \\'choice_type\\' av \\'%s1\\' för markering \\'%s2\\'"
"CompendiumPageError_BarUnknown"	"Ogiltig \\'data\\' av \\'%s1\\' för valet \\'%s2\\'."
"CompendiumPageError_InvalidEquation"	"Ogiltig ekvation angiven: \\'%s1\\' för \\'%s2\\'"
"CompendiumPageError_SelChoices"	"Saknar \\'choices\\' block för markering \\'%s1\\' på kompendium-sida \\'%s2\\'"
"CompendiumPageError_NoHero"	"Kunde ej hitta hjälte med hjälte-ID:t \\'%s1\\' för valet \\'%s2\\'"
"CompendiumPageError_Unknown"	"Internt logikfel i kompendium. Kontakta Valve för att lösa detta."
"CompendiumPageError_ImageDL"	"Misslyckades med att starta nedladdningen av kompendiebilden \\'%s1\\' (%s2)"
"CompendiumPageError_ImageDLErr"	"Misslyckades med att ladda ned kompendiebilden \\'%s\\' (%s2)"
"CompendiumPageError_BtnNoElem"	"Inget \\'selection_elements\\' block hittades för knappen \\'%s1\\' på kompendium-sida \\'%s2\\'."
"CompendiumPageError_BtnBadVal"	"Valvärde \\'%s1\\' för knappen \\'%s2\\' är inte i vallistan för det valindexet."
"CompendiumPageError_BtnBadSel"	"Inställningen \\\"selection_force_to\\\" för elementet \\\"%s1\\\" är inte i vallistan för valet \\\"%s2\\\"."
"CompendiumPageError_BtnSelIdx"	"Knappen \\'%s1\\' på kompendium-sida \\'%s2\\' saknar eller har ogiltig \\'selection_index\\'."
"CompendiumPageError_CmdSelIdx"	"Elementet \\'%s1\\' på sida \\'%s2\\' i kompendiet har saknande eller ogiltigt kommando \\'selection_index\\' eller \\'force_selection_index\\'"
"CompendiumPageError_ImgSelIdx"	"Ogiltig \\'selection_index\\' för \\'%s1\\' i bilden \\'%s2\\'."
"CompendiumPageError_ImgShowSelIdx"	"Ogiltig \\'show_selection_index\\' för \\'%s1\\' i bilden \\'%s2\\'."
"CompendiumPageError_ImgSelVal"	"Ogiltigt val \\'%s1\\' i sektionen \\'show_selection_images\\' för bilden \\'%s2\\'."
"CompendiumPageError_ImgBadStyle"	"Ogiltig bildstil \\'%s1\\' för bilden \\'%s2\\'."
"CompendiumPageError_DynTxtSel"	"Texten \\'%s1\\' på sida \\'%s2\\' innehåller ogiltig % selection_X %. Inget förregistrerat val med det indexet."
"CompendiumPageError_NoTxtList"	"Kunde inte hitta en textlista kallat \\'%s1\\' på sida \\'%s2\\'."
"CompendiumPageError_TOCPage"	"table_of_contents_page sida \\'%s1\\' finns inte."
"CompendiumPageError_SelIndex"	"Valet \\'%s1\\' på sida \\'%s2\\' i kompendiet saknar eller har ogiltigt \\'selection_index\\'"
"CompendiumPageError_SelUsed"	"Valet \\'%s1\\' på sida \\'%s2\\' i kompendiet saknar en unik \\'selection_index\\'"
"CompendiumPageError_SelVal"	"Valet \\'%s1\\' på sida \\'%s2\\' i kompendiet har valmöjligheter med likadana värden"
"CompendiumPageError_SelValInv"	"Valet \\'%s1\\' på sida \\'%s2\\' i kompendiet har ett val med ett värde <= 0. Valens värden måste vara högre än 0."
"CompendiumPageError_SelTTVal"	"Valet \\'%s1\\' på kompendium-sida \\'%s2\\' har en tooltip_data-post med ett värde som inte finns i dess vallista."
"CompendiumPageError_NoAnswer"	"Valet \\'%s1\\'på kompendium-sida \\'%s2\\' har inget \\'answer\\' eller \\'answers\\'-nyckel i sin \\'result\\'-sektion."
"CompendiumPageError_MissAnswer"	"Valet \\'%s1\\' på kompendium-sida \\'%s2\\' har en \\'answer\\' eller \\'answers\\'-nyckel som inte matchar några av sina val."
"CompendiumPageError_Timer"	"Timern \\'%s1\\' har en ogiltig tidsangivelse"
"CompendiumPageError_UnknownAction"	"Objektet \\'%s1\\' hänvisar till den okända handlingen \\'%s2\\'."
"CompendiumPageError_SameElement"	"Synlighetssystem hittade flera element som heter \\'%s1\\' på sidan \\'%s2\\'."
"CompendiumPageError_DupeKey"	"Nyckelvärdesblocket \\'%s1\\' innehåller flera nycklar med samma namn: \\'%s2\\'."
"CompendiumError_Template"	"Kunde inte hitta en mall med namnet \\'%s1\\'"
"CompendiumError_DupeTemplate"	"Hittade flera mallar som heter \\'%s1\\'."
"CompendiumError_NoDefines"	"Mallen \\'%s1\\' kräver definitioner, men instansen \\'%s2\\' av den har inget \\'defines\\' block."
"CompendiumError_MissingDef"	"Den härledde instansen \\'%s1\\' innehåller ingen definition som heter \\'%s2\\', men mallen den härleds ifrån kräver det."
"CompendiumError_BadDef"	"Den härledde instansen \\'%s1\\' innehåller en nödvändig definition som heter \\'%s2\\' som inte börjar med \\'%def\\', vilket krävs."
"CompendiumError_FailedPanoramaGen"	"Kunde inte generera panoramalayout för sida '{s:s1}'."
"CompendiumError_FailedXMLWrite"	"Kunde inte skriva XML för sida '{s:s1}' till filen '{s:s2}'."
"CompendiumError_FailedCSSWrite"	"Kunde inte skriva CSS för sida '{s:s1}' till filen '{s:s2}'."
"DOTA_GlobalItems_Companions"	"Kompanjoner"
"DOTA_GlobalItems_Couriers"	"Kurirer"
"DOTA_GlobalItems_Pets"	"Husdjur"
"DOTA_GlobalItems_World"	"Värld"
"DOTA_GlobalItems_Wards"	"Wards"
"DOTA_GlobalItems_Effigies"	"Statyer"
"DOTA_GlobalItems_Weather"	"Vädereffekter"
"DOTA_GlobalItems_Interface"	"Gränssnitt"
"DOTA_GlobalItems_Emoticons"	"Uttryckssymboler"
"DOTA_GlobalItems_LoadingScreens"	"Laddningsskärmar"
"DOTA_GlobalItems_HUDs"	"HUD:s"
"DOTA_GlobalItems_Audio"	"Ljud"
"DOTA_GlobalItems_Announcers"	"Utroparpaket"
"DOTA_GlobalItems_Music"	"Musik"
"DOTA_Search"	"Sök"
"DOTA_Start"	"Starta"
"DOTA_PleaseWait"	"Vänligen vänta..."
"DOTA_ProfileCard_HeroHover"	"Visa när pekaren hålls över:"
"DOTA_ChallengeGroup_2_Desc"	"Träna med och mot AI-kontrollerade hjältar i en stressfri miljö."
"DOTA_ChatTab_ToggleSounds"	"Spela ett ljud när du får ett meddelande i denna kanal."
"dota_lobby_balanced_shuffle"	"Balanserad blandning"
"dota_lobby_swap_teams"	"Byt lag"
"dota_lobby_unassigned_players"	"Otilldelade spelare"
"dota_lobby_broadcast_channels"	"Växla kommentatorskanaler"
"dota_lobby_settings"	"Lobbyinställningar"
"dota_lobby_settings_edit"	"Ändra"
"dota_lobby_leave"	"Lämna denna lobby"
"DOTA_Custom_Game_View_Lobby_List"	"Visa lobbylista"
"DOTA_Custom_Game_Lobby_List_Title"	"Lobbylista"
"DOTA_Custom_Game_Browse_All"	"Bläddra bland alla matcher"
"DOTA_Custom_Game_Friends_Ready"	"Vänner som är redo att spela"
"DOTA_Custom_Game_Friends_Who_Play"	"Vänner som spelar"
"DOTA_Custom_Game_Friends_Playing_Now"	"Vänner som spelar nu"
"DOTA_Custom_Game_Browse_Sort"	"Sortera:"
"DOTA_Custom_Game_Sort_Popular_Today"	"Topplista (Idag)"
"DOTA_Custom_Game_Sort_Popular_Week"	"Topplista (Denna vecka)"
"DOTA_Custom_Game_Sort_Top_Rated"	"Topplista (All tid)"
"DOTA_Custom_Game_Sort_Date"	"Publiceringsdatum"
"DOTA_WatchLive_WatchLabel"	"TITTA:"
"DOTA_WatchLive_ThirdParty"	"TREDJEPART"
"DOTA_WatchLive_Steam"	"STEAM"
"DOTA_WatchLive_InGame"	"I SPELET"
"DOTA_WatchLive_Broadcaster0"	"Titta på {g:dota_persona:b:broadcaster_account_id_0}"
"DOTA_WatchLive_Broadcaster1"	"Titta på {g:dota_persona:b:broadcaster_account_id_1}"
"DOTA_WatchLive_Broadcaster2"	"Titta på {g:dota_persona:b:broadcaster_account_id_2}"
"DOTA_WatchLive_Broadcaster3"	"Titta på {g:dota_persona:b:broadcaster_account_id_3}"
"DOTA_WatchLive_Broadcaster4"	"Titta på {g:dota_persona:b:broadcaster_account_id_4}"
"DOTA_WatchLive_Broadcaster5"	"Titta på {g:dota_persona:b:broadcaster_account_id_5}"
"DOTA_WatchLive_Broadcaster6"	"Titta på {g:dota_persona:b:broadcaster_account_id_6}"
"DOTA_WatchLive_Broadcaster7"	"Titta på {g:dota_persona:b:broadcaster_account_id_7}"
"DOTA_WatchLive_Broadcaster8"	"Titta på {g:dota_persona:b:broadcaster_account_id_8}"
"DOTA_WatchLive_Broadcaster9"	"Titta på {g:dota_persona:b:broadcaster_account_id_9}"
"dota_matchmaking_region_title_confirm"	"Bekräfta matchningsregioner"
"dota_play_lobby_games"	"Visa lobbyer"
"dota_play_host_loading"	"Värd laddar..."
"dota_play_connecting_to_server"	"Ansluter..."
"dota_reconnecting"	"Återansluter..."
"dota_matchmaking_regions_retry"	"Försök igen"
"dota_matchmaking_region_ping_calculating"	"Ping: Beräknar..."
"dota_matchmaking_region_ping_failed"	"Ping: MISSLYCKADES"
"dota_matchmaking_region_or"	"eller"
"dota_matchmaking_region_selected_offline"	"En eller flera valda region(er) är temporärt nedkopplade."
"dota_matchmaking_region_selected_unreachable"	"Kan inte bekräfta nätverksanslutning till valda regioner."
"dota_matchmaking_region_all_unavailable"	"Kan inte pinga någon region. Kontrollera din Internetanslutning."
"dota_matchmaking_region_check_internet"	"Kontrollera din internetanslutning."
"dota_matchmaking_region_poor_choices"	"Nuvarande val av regioner kan resultera i en dålig anslutning till spelservern."
"dota_settings_hide_party_unless_open"	"Dölj gruppstatus när jag inte är i en öppen grupp"
"dota_settings_open_party_manual_accept_invites"	"Acceptera inte gruppinbjudningar automatiskt när jag är i en öppen grupp"
"dota_settings_networkhud"	"Visa nätverksinformation"
"dota_settings_fullscreenbrightness"	"Ljusstyrka"
"dota_settings_dashboard_renderquality"	"Högkvalitets-dashboard"
"dota_settings_lowlatency_audio"	"Upptäck ljudlatens automatiskt"
"dota_settings_quicktargetattack"	"Snabb attack"
"dota_settings_chat_whispers"	"Visa Steam-meddelanden som viskningar"
"dota_settings_no_mode_resolutions"	"Inga upplösningar som stöds"
"DOTA_Settings_Tooltip_QuickTargetAttack"	"När attacktangenten trycks kommer attacken att ske mot muspekarens plats."
"dota_lobby_browser_header_name"	"Lobbynamn"
"dota_lobby_browser_header_slots"	"Platser"
"dota_lobby_browser_header_game_mode"	"Spelläge"
"dota_lobby_browser_region"	"Region"
"dota_lobby_browser_lobby_name"	"Lobbynamn"
"DOTA_Friend_Game_Mode_Self"	"Du är i en {s:game_mode}-match"
"DOTA_Friend_Game_Mode_1_Friend"	"{s:player_name} spelar {s:game_mode}"
"DOTA_Friend_Game_Mode_N_Friends"	"{d:num_friends} vänner spelar {s:game_mode}"
"custom_game_lobby_mismatch"	"Anpassat spelarkiv matchar inte lobbyledarens."
"CompendiumError_XMLLoadFail"	"Fel vid inläsning av XML för sidan '{s:s1}' i filen '{s:s2}'."
"CompendiumError_XMLParseFail"	"Fel vid parsning av XML för sidan '{s:s1}' i filen '{s:s2}'."
"Compendium_DefaultText_TimerTitle_Active"	"VAL STÄNGER OM"
"Compendium_DefaultText_TimerTitle_Expired"	"VAL ÄR STÄNGDA"
"Compendium_DefaultText_CD_Days"	"Dagar"
"Compendium_DefaultText_CD_Hours"	"Timmar"
"Compendium_DefaultText_CD_Minutes"	"Minuter"
"Compendium_DefaultText_CD_Seconds"	"Sekunder"
"NetGraph_FPS"	"fps: {d:fps}"
"NetGraph_Ping"	"ping: {d:ping}ms"
"NetGraph_Loss"	"loss: {d:loss}%"
"DOTA_Credits"	"Erkännanden"
"DOTA_ActorCredits_1_Name"	"Dee Bradley Baker"
"DOTA_ActorCredits_1_Heroes"	"techies"
"DOTA_ActorCredits_2_Name"	"Dennis Bateman"
"DOTA_ActorCredits_2_Heroes"	"invoker"
"DOTA_ActorCredits_3_Name"	"Tom Chantler"
"DOTA_ActorCredits_3_Heroes"	"centaur,lion,obsidian_destroyer,riki,slark,tusk,witch_doctor"
"DOTA_ActorCredits_4_Name"	"Merle Dandridge"
"DOTA_ActorCredits_4_Heroes"	"legion_commander,winter_wyvern"
"DOTA_ActorCredits_5_Name"	"Barry Dennen"
"DOTA_ActorCredits_5_Heroes"	"chaos_knight,phantom_lancer,rubick"
"DOTA_ActorCredits_6_Name"	"Dave Fennoy"
"DOTA_ActorCredits_6_Heroes"	"batrider,ember_spirit,faceless_void,jakiro,venomancer,skeleton_king"
"DOTA_ActorCredits_7_Name"	"Jim French"
"DOTA_ActorCredits_7_Heroes"	"elder_titan"
"DOTA_ActorCredits_8_Name"	"Michael Gregory"
"DOTA_ActorCredits_8_Heroes"	"bounty_hunter,clinkz,silencer"
"DOTA_ActorCredits_9_Name"	"Gin Hammond"
"DOTA_ActorCredits_9_Heroes"	"crystal_maiden,drow_ranger,enchantress,mirana,phantom_assassin,spectre,vengefulspirit"
"DOTA_ActorCredits_10_Name"	"John Patrick Lowrie"
"DOTA_ActorCredits_10_Heroes"	"ancient_apparition,dark_seer,doom_bringer,earthshaker,pudge,nevermore,storm_spirit"
"DOTA_ActorCredits_11_Name"	"Ellen McLain"
"DOTA_ActorCredits_11_Heroes"	"broodmother,death_prophet"
"DOTA_ActorCredits_12_Name"	"Bruce Miles"
"DOTA_ActorCredits_12_Heroes"	"alchemist,life_stealer,omniknight"
"DOTA_ActorCredits_13_Name"	"Linda K. Morris"
"DOTA_ActorCredits_13_Heroes"	"luna,naga_siren,queenofpain,templar_assassin"
"DOTA_ActorCredits_13_Extra"	"Utroparen"
"DOTA_ActorCredits_14_Name"	"Sam A. Mowry"
"DOTA_ActorCredits_14_Heroes"	"antimage,beastmaster,rattletrap,necrolyte,slardar,warlock"
"DOTA_ActorCredits_14_Extra"	"Hemliga butiksinnehavaren"
"DOTA_ActorCredits_15_Name"	"Eric Newsome"
"DOTA_ActorCredits_15_Heroes"	"chen,leshrac,furion,razor,tidehunter,tiny,zuus"
"DOTA_ActorCredits_16_Name"	"Nolan North"
"DOTA_ActorCredits_16_Heroes"	"brewmaster,earth_spirit,gyrocopter,keeper_of_the_light,lone_druid,lycan,meepo,ogre_magi,shadow_demon,troll_warlord"
"DOTA_ActorCredits_17_Name"	"Dempsey Pappion"
"DOTA_ActorCredits_17_Heroes"	"magnataur,nyx_assassin,visage"
"DOTA_ActorCredits_18_Name"	"TJ Ramini"
"DOTA_ActorCredits_18_Heroes"	"abaddon,bristleback,skywrath_mage,shredder"
"DOTA_ActorCredits_19_Name"	"Harry S. Robins"
"DOTA_ActorCredits_19_Heroes"	"tinker"
"DOTA_ActorCredits_20_Name"	"Gary Schwartz"
"DOTA_ActorCredits_20_Heroes"	"lich,pugna"
"DOTA_ActorCredits_21_Name"	"David Scully"
"DOTA_ActorCredits_21_Heroes"	"bane,dazzle,juggernaut,morphling,sand_king,sven,weaver"
"DOTA_ActorCredits_22_Name"	"Mike Shapiro"
"DOTA_ActorCredits_22_Heroes"	"oracle"
"DOTA_ActorCredits_23_Name"	"David Sobolov"
"DOTA_ActorCredits_23_Heroes"	"terrorblade"
"DOTA_ActorCredits_24_Name"	"Jon St. John"
"DOTA_ActorCredits_24_Heroes"	"axe,bloodseeker,enigma,kunkka"
"DOTA_ActorCredits_25_Name"	"Fred Tatasciore"
"DOTA_ActorCredits_25_Heroes"	"disruptor,spirit_breaker,treant,undying,ursa"
"DOTA_ActorCredits_25_Extra"	"Warlock's Golem"
"DOTA_ActorCredits_26_Name"	"Jen Taylor"
"DOTA_ActorCredits_26_Heroes"	"lina,medusa,puck,windrunner"
"DOTA_ActorCredits_27_Name"	"Tony Todd"
"DOTA_ActorCredits_27_Heroes"	"dragon_knight,night_stalker,viper"
"DOTA_ActorCredits_28_Name"	"
"
"DOTA_ActorCredits_28_Heroes"	"
"
"DOTA_PlayerContextMenu_Trade"	"Bjud in till byte"
"DOTA_Custom_Game_Finished_Vote_Title"	"Anpassad spelomröstning"
"DOTA_Custom_Game_Finished_Vote_Question"	"Vad tycker du om detta anpassade spel?"
"DOTA_Custom_Game_Finished_Vote_Skip"	"Hoppa över"
"DOTA_TabName_ModsLobbyList"	"Lobbylista"
"DOTA_WatchLive_Fullscreen"	"HELSKÄRM"
"DOTA_JoinChatChannel_ChannelName"	"Kanalnamn"
"DOTA_JoinChatChannel_ChannelMemberCount"	"Medlemmar"
"DOTA_Chat_ChannelMemberCount"	"{d:channel_member_count}"
"dota_settings_coop_fullscreen"	"Skrivbordsvänlig helskärm"
"DOTA_Trading_UI_Body_Outgoing"	"Väntar på att {s:player_name} ska svara på din förfrågan..."
"DOTA_GiftWrap_Item"	"Slår in {g:dota_item_name:gift_item_def}."
"DOTA_GiftWrap_ConfirmDedication_Title"	"Bekräfta dedikation"
"DOTA_GiftWrap_ConfirmDedication_Message"	"Är du säker på att du vill dedikera gåvan med \"{s:gift_dedication}\"?"
"DOTA_GiftWrap_Success_Header"	"Klart"
"DOTA_GiftWrap_Success"	"Din gåva har levererats."
"DOTA_GiftWrap_Error_RateLimitedNormal"	"Du kan endast skänka {d:gift_limit_count} föremål inom {d:gift_limit_hours} timmar. Du har redan skickat så många gåvor, vänligen vänta innan du skickar denna gåva."
"DOTA_GiftWrap_Error_RateLimitedCharge"	"På din stridspoängsnivå kan du endast skänka {d:gift_limit_count} icke-bytbara föremål inom {d:gift_limit_hours} timmar. Denna gåva kunde inte skickas för närvarande."
"DOTA_GiftWrap_Error_RateLimitedChargeNone"	"På din stridspoängsnivå kan du inte skänka icke-bytbara föremål. Denna gåva kunde inte skickas för närvarande."
"DOTA_Custom_Game_Sort_Most_Played"	"Mest populära (Denna vecka)"
"dota_settings_about"	"Om"
"dota_settings_fullscreen_focus_behavior"	"Skrivbordsvänlig helskärm minimeras vid fokusförlust"
"DOTA_EquippedItem_AddToShuffle"	"Lägg till i blandning"
"DOTA_EquippedItem_RemoveFromShuffle"	"Ta bort från blandning"
"DOTA_EquippedItem_Unpack_And_AddToShuffle"	"Packa upp och lägg till i blandning"
"DOTA_ClientVersion"	"Version: <span class=\"VersionNumber\">{d:client_version_number}</span>"
"DOTA_GameplayVersion"	"Spelversion: <span class=\"VersionNumber\">{s:gameplay_version_number}</span>"
"DOTA_CurrentGameplayVersion"	"6.85"
"DOTA_Credits_LindaKMorris_Extra"	"& den ursprungliga utroparen"
"DOTA_Credits_SamAMowry_Extra"	"& den hemliga butiksinnehavaren"
"DOTA_Credits_FredTatasciore_Extra"	"& Warlocks golem"
"DOTA_Recycling"	"Återvinning"
"DOTA_Recycling_Action"	"Återvinn"
"DOTA_Recycling_DragItems"	"Dra oönskade föremål hit"
"DOTA_Recycling_Outputs"	"Få"
"DOTA_Recycling_Confirm"	"Är du säker på att du vill återvinna dessa föremål?"
"DOTA_RecyclingCharm_Name"	"Charm of the Crucible Jewel II"
"DOTA_RecyclingCharm_Bonus"	"+25 Kompendiummynt"
"custom_game_file_error"	"Fel vid åtkomst av anpassade spelfiler."
"DOTA_Previous"	"Föregående"
"DOTA_PreviousShort"	"Föreg."
"DOTA_Next"	"Nästa"
"DOTA_Friends_Add_Friend_Tooltip"	"Lägg till vän"
"DOTA_Friends_Add_Friend_Entry_Placeholder"	"Ange Vän-ID att söka efter"
"DOTA_Friends_Add_Friend_Your_ID"	"Ditt Vän-ID är:"
"dota_settings_voice_always_sample_mic"	"Rationaliserad PTT-funktion"
"dota_settings_voice_always_sample_mic_tooltip"	"Håller inspelningsenheten aktiv för att undvika att spelet fryser fast på viss hårdvara."
"DOTA_EconItemSet_Tooltip_MultipleTeams"	"Har olika stilar för Radiant och Dire"
"DOTA_HeroLoadout_Shuffle_Count"	"Föremål i blandning ({i:loadout_items_in_shuffle})"
"DOTA_HeroLoadout_Add_All_To_Shuffle"	"Lägg till allt till blandning"
"DOTA_HeroLoadout_Clear_Shuffle"	"Rensa blandning"
"DOTA_Armory_ActiveFilter"	"{s:filter_field} {s:filter_op} {s:filter_value}"
"DOTA_Treasure_Purchase"	"Köp skatt"
"DOTA_Treasure_CharmPurchase"	"Köp berlock"
"DOTA_Treasure_SearchPlaceholder"	"Sök efter skatter"
"DOTA_Treasure_ViewAll"	"Visa alla skatter"
"DOTA_Treasure_QuantityOption"	"St: {d:quantity}"
"DOTA_Treasure_Gift"	"Skänk som gåva"
"DOTA_Treasure_Open"	"Öppna"
"DOTA_Treasure_OpenQuantity"	"{d:owned_quantity}"
"DOTA_Treasure_Owned"	"Ägs"
"DOTA_Treasure_Received"	"Mottog"
"DOTA_Treasure_Autographed"	"Autograf:"
"DOTA_Treasure_AutographName"	"{s:treasure_autograph_name}"
"DOTA_OpenTreasureTooltip_NormalTitle"	"Innehåller följande föremål:"
"DOTA_OpenTreasureTooltip_NoDupeDescription"	"Du kommer inte att få dubbletter förrän du fått en av varje."
"DOTA_OpenTreasureTooltip_DupeDescription"	"Du kan få dubbletter innan du fått en av varje."
"DOTA_OpenTreasureTooltip_RareTitle"	"Med en chans att få bonusföremål"
"DOTA_OpenTreasureTooltip_UnitName"	"{g:dota_item_unit_name:item_def}"
"DOTA_OpenTreasureTooltip_ItemName"	" - {g:dota_item_name:item_def}"
"dota_profile_content_tab_official_info"	"Proffsinformation"
"dota_profile_oi_player_name"	"VISNINGSNAMN"
"dota_profile_oi_player_name_sub"	"Det ska kännas igen av spelare över hela världen och inte innehålla några lag- eller sponsoranknytningar."
"dota_profile_oi_team"	"LAG"
"dota_profile_oi_team_sub"	"Välj denna om du spelar för ett Dota-lag i officiell kapacitet. Detta lags tagg kommer att läggas till innan ditt namn."
"dota_profile_oi_sponsor"	"SPONSOR"
"dota_profile_oi_sponsor_sub"	"Sponsorer kommer att läggas till efter ditt namn."
"dota_profile_oi_country"	"LAND"
"dota_profile_oi_role"	"ROLL"
"dota_profile_oi_role_sub"	"Om du spelar en specifik roll, välj den. Core inkluderar spelare som spelar carry, mid och off-lane."
"dota_profile_oi_preview"	"Så här kommer ditt namn att visas på ledartavlor och i turneringsmatcher:"
"dota_profile_oi_preview_warning"	"Dessa uppgifter kan endast ändras en gång varannan vecka, så se till att de stämmer innan du uppdaterar dem!"
"dota_profile_oi_submit_info"	"Skicka in"
"dota_profile_oi_submit_pending"	"Skickar..."
"dota_profile_oi_submit_success"	"Klart!"
"dota_profile_oi_submit_failure"	"Fel - Försök igen."
"dota_role_core"	"Core"
"dota_role_support"	"Support"
"Compendium_GenerateFail"	"Kunde inte generera resursfil '{s:s1}'."
"Compendium_PreparePublish"	"Förbered publicering"
"Compendium_PublishError"	"Kunde inte kopiera '{s:s1}' till kompendiumfilmappen '{s:s2}'."
"Compendium_PublishFinishedTitle"	"Publicering slutförd"
"Compendium_PublishFinished"	"Kompilerade filer har nu kopierats till datafilmappen.\n\nLadda upp alla filer av filtyp .vxml_c, .vtex_c, och .vcss_c när du skickar in ditt kompendium till ligans hemsida."
"DOTA_Treasure"	"Skatt"
"DOTA_Blog"	"Nytt i Dota 2"
"DOTA_SortBy"	"Sortera efter"
"DOTA_SortOption_Newest"	"Nyaste"
"DOTA_SortOption_Owned"	"Ägs"
"DOTA_SortOption_Price"	"Pris"
"DOTA_SortOption_Alphabetical"	"Alfabetisk"
"Action_Use"	"Använd"
"DOTA_BadgeLevel"	"{d:badge_level}"
"DOTA_AHC_CurrentHero"	"Nuvarande hjälte"
"DOTA_AHC_CurrentHeroName"	"{s:current_hero_name}"
"DOTA_AHC_InProgress"	"Framsteg"
"DOTA_AHC_CurrentHeroAttempts"	"{s:current_hero_attempts} försök"
"DOTA_AHC_CurrentHeroAverage"	"Världsgenomsnitt"
"DOTA_AHC_CurrentHeroAverageAttempts"	"{s:current_hero_average_attempts} försök"
"DOTA_AHC_NextHero"	"Nästa hjälte"
"DOTA_AHC_NextHeroName"	"{s:next_hero_name}"
"DOTA_AHC_ChallengeProgress"	"Utmaningsframsteg ({d:challenge_progress_percent}%)"
"DOTA_AHC_HeroesCompleted"	"Hjältar slutförda"
"DOTA_AHC_HeroesCompletedValue"	"{d:heroes_completed} / {d:heroes_total}"
"DOTA_AHC_TotalAttempts"	"Antal försök"
"DOTA_AHC_TotalAttemptsValue"	"{d:challenge_total_attempts} matcher"
"DOTA_AHC_EquivalentWorldAverage"	"Motsvarande världsgenomsnitt"
"DOTA_AHC_EquivalentWorldAverageValue"	"{d:challenge_average_total_attempts} matcher"
"DOTA_AHC_LifetimeStats"	"Utmaningsstatistik"
"DOTA_AHC_FullChallengesCompleted"	"Fullständiga utmaningar slutförda"
"DOTA_AHC_FullChallengesCompletedValue"	"{d:full_challenges_completed}"
"DOTA_AHC_BestFullChallenge"	"Bästa fullständiga utmaning"
"DOTA_AHC_BestFullChallengeValueNone"	"N/A"
"DOTA_AHC_BestFullChallengeValue"	"{d:best_full_challenge} matcher"
"DOTA_AHC_FullChallengeAverage"	"Världsgenomsnitt för fullständig utmaning"
"DOTA_AHC_FullChallengeAverageValue"	"{s:full_challenge_average} matcher"
"DOTA_AHC_ChallengeReward"	"Utmaningsbelöning"
"DOTA_AHC_ChallengeTrophyName"	"{s:challenge_trophy_name}"
"DOTA_AHC_ChallengeTrophyLevel"	"Nivå {d:challenge_trophy_level}"
"DOTA_Trophies_ViewEarned"	"Uppnådd"
"DOTA_Party_Add_Friends"	"Lägg till vänner för att skapa en grupp"
"DOTA_ItemSet_Count_text"	"{d:item_current_group} / {d:item_group_count}"
"DOTA_Custom_Game_Map_AnyNumbered"	"Alla ({d:map_choices})"
"dota_settings_enable_console"	"Aktivera konsol"
"dota_settings_enable_console_tooltip"	"Om du har startalternativ som -dev eller -consol som aktiverar konsolen så åsidosätter de denna inställning."
"dota_settings_binding_options"	"Bindningsalternativ"
"dota_settings_allow_gui_key_to_bind"	"Tillåt bindning av tangenten Windows / Command"
"DOTA_HeroLoadout_Loadout"	"Utrustning"
"DOTA_HeroLoadout_About"	"Om"
"DOTA_HeroLoadout_Guides"	"Guider"
"DOTA_HeroLoadout_Roles"	"Roller"
"DOTA_HeroLoadout_Biography"	"Biografi"
"DOTA_Feed_Say_Something"	"Skriv något i ditt flöde..."
"DOTA_Armory_ClearFilter"	"Rensa filter"
"DOTA_Armory_ContextMenu_Tags"	"Taggar..."
"DOTA_Armory_ContextMenu_EffigyPose"	"Posering..."
"DOTA_Armory_ContextMenu_EffigyReforge"	"Bygg om..."
"DOTA_EffigyEditor_CreateEffigy"	"Skapa staty"
"DOTA_EffigyEditor_PoseEffigy"	"Posera staty"
"DOTA_EffigyEditor_ReforgeEffigy"	"Bygg om staty"
"DOTA_EffigyEditor_Model"	"Hjälte"
"DOTA_EffigyEditor_Loadout"	"Gå till utrustning"
"DOTA_EffigyEditor_Inscription"	"Inskrift:"
"DOTA_EffigyEditor_Animation"	"Animation:"
"DOTA_EffigyEditor_Frame"	"Välj bild:"
"DOTA_EffigyEditor"	"Statyredigerare"
"DOTA_EffigyEditor_ConfirmCreate"	"När du skapar en staty så förbrukas statyblocket. Efter skapelsen kan den bara modifieras med en statyombyggare. Är du säker på att du vill fortsätta?"
"DOTA_EffigyEditor_ConfirmReforge"	"När du bygger om en staty så förbrukas en statyombyggare. Är du säker på att du vill fortsätta?"
"DOTA_EffigyEditor_Error"	"Kunde inte generera staty."
"DOTA_EffigyEditor_ErrorReforge"	"Kunde inte bygga om staty."
"DOTA_EffigyEditor_ErrorPose"	"Kunde inte posera staty."
"DOTA_EffigyEditor_Success"	"Din staty har skapats."
"DOTA_EffigyEditor_SuccessReforge"	"Din staty har byggts om."
"DOTA_EffigyEditor_SuccessPose"	"Din staty har poserats."
"dota_profile_content_tab_all_hero_challenge"	"Alla Hjältar-utmaning"
"DOTA_tooltip_econ_item_delete_restriction"	"Ej borttagbar"
"DOTA_tooltip_econ_item_modifiers"	"Modifierare"
"DOTA_tooltip_econ_item_modifier_animation"	"Animation"
"DOTA_tooltip_econ_item_modifier_announcer"	"Utropare"
"DOTA_tooltip_econ_item_modifier_HUD"	"HUD"
"DOTA_tooltip_econ_item_modifier_health_bar"	"Hälsomätare"
"DOTA_tooltip_econ_item_modifier_ability_name"	"Förmågenamn"
"DOTA_tooltip_econ_item_modifier_loading_screen"	"Laddningsskärm"
"DOTA_tooltip_econ_item_modifier_cursor_pack"	"Muspekarpaket"
"DOTA_tooltip_econ_item_modifier_portrait"	"Porträtt"
"DOTA_tooltip_econ_item_modifier_ambient_effects"	"Omgivningseffekter"
"DOTA_tooltip_econ_item_modifier_kill_effects"	"Dödseffekter"
"DOTA_tooltip_econ_item_modifier_spell_effects"	"Förmågeeffekter"
"DOTA_tooltip_econ_item_modifier_model"	"Modell"
"DOTA_tooltip_econ_item_modifier_scale"	"Skala"
"DOTA_tooltip_econ_item_modifier_wearable"	"Utrustning"
"DOTA_tooltip_econ_item_modifier_courier"	"Kurir"
"DOTA_tooltip_econ_item_modifier_flying_courier"	"Flygande kurir"
"DOTA_tooltip_econ_item_modifier_pet"	"Husdjur"
"DOTA_tooltip_econ_item_modifier_weather"	"Väder"
"DOTA_tooltip_econ_item_modifier_sound"	"Ljud"
"DOTA_tooltip_econ_item_modifier_soundscape"	"Ljudbild"
"DOTA_tooltip_econ_item_modifier_voice"	"Röst"
"DOTA_tooltip_econ_item_modifier_icon"	"Ikon"
"DOTA_econ_item_details_style_label"	"Stil:"
"DOTA_econ_item_details_gift_label"	"Gåva från:"
"Compendium_Downloading"	"Laddar ned kompendium..."
"Compendium_DLFailed"	"Nedladdning misslyckades"
"Compendium_DLFailed_Desc"	"Kunde inte ladda ned kompendiet.\n\nFörsök igen senare."
"Compendium_Error"	"Kompendiumfel"
"Compendium_Error_Desc"	"Något är fel med kompendiet. Vi jobbar på att lösa problemet.\n\nFörsök igen senare."
"Compendium_Retry"	"Försök igen"
"Compendium_preview_mode"	"ENDAST FÖRHANDSGRANSKNING"
"Compendium_preview_click"	"Klicka här för mer information"
"Compendium_level"	"NIVÅ"
"Compendium_to_next_level"	"TILL NÄSTA NIVÅ"
"Compendium_LevelupPts_Singular"	"1 poäng"
"Compendium_LevelupPts_Plural"	"{d:next_comp_level} poäng"
"DOTA_GlobalItems_MegaKill"	"Mega Kill-paket"
"DOTA_Treasure_BonusReward"	"Bonusbelöning"
"DOTA_OpenTreasureTooltip_ExtraItems"	"... och {d:extra_items_count} till!"
"DOTA_AASystem_Green"	"Ackumulerad speltid online: {s:playtime}. Du spelar lagom just nu. Ha så kul!"
"DOTA_AASystem_Yellow"	"Ackumulerad speltid online: {s:playtime}. Du har spelat ohälsosamt länge. Kom ihåg att vila!"
"DOTA_AASystem_Red"	"Ackumulerad speltid online: {s:playtime}. Du har spelat ohälsosamt länge. Vi rekommenderar att du loggar ut och vilar!"
"DOTA_AntiAddiction_Initial_With_ID_18Plus"	"Senast online: %s1\nSenaste IP-adressen: %s2"
"DOTA_AntiAddiction_Initial_With_ID_Under_18"	"Du är under 18 år. Antimissbruk-systemet är aktiverat.\nSenast online: %s1\nSenaste IP-adressen: %s2"
"DOTA_AntiAddiction_Initial_No_ID"	"Ditt konto är inte registrerat.\nSenast online: %s1\nSenaste IP-adressen: %s2"
"DOTA_AntiAddiction_Blocked_Time_Exceeded"	"Antimissbruk-systemets tillåtna speltid har överskridits. Stänger ned."
"DOTA_AntiAddiction_Initial_No_ID_Popup"	"Ditt konto är inte fullständigt registrerat. Vill du ange dina uppgifter nu?"
"DOTA_AntiAddiction_CompleteInfoNow"	"Ange information"
"DOTA_AntiAddiction_CompleteInfoNotNow"	"Inte nu"
"DOTA_AntiAddiction_Initial_DateFormat"	"%s1Y%s2M%s3D %s4:%s5:%s6"
"DOTA_AntiAddiction_Label_Green"	"Speltid: {s:playtime} ( Hälsosam )"
"DOTA_AntiAddiction_Label_Yellow"	"Speltid: {s:playtime} ( Ohälsosamt )"
"DOTA_AntiAddiction_Label_Red"	"Speltid: {s:playtime} ( Överskriden )"
"DOTA_Workshop_Browse"	"Bläddra"
"DOTA_Workshop_TextureName_color"	"Color"
"DOTA_Workshop_MaterialName_MetalnessTexture"	"Metalness"
"DOTA_Workshop_MaterialName_NormalTexture"	"Normal Map"
"DOTA_Workshop_MaterialName_RimMaskTexture"	"Rim Mask"
"DOTA_Workshop_TextureName_selfillummask"	"Self-Illumination Mask"
"DOTA_Workshop_MaterialName_SpecMaskTexture"	"Specular Mask"
"DOTA_Workshop_MaterialDetail_ColorTexture"	"Detta är färgtexturen! Det är färgen det."
"DOTA_Workshop_MaterialDetail_MetalnessTexture"	"Detta är metalltexturen! Så metallig den är."
"DOTA_Workshop_MaterialDetail_NormalTexture"	"Detta är normal-texturen! Normalen."
"DOTA_Workshop_MaterialDetail_RimMaskTexture"	"Detta är rim mask-texturen! Det är rim masken."
"DOTA_Workshop_MaterialDetail_SelfIllumTexture"	"Detta är self illum-texturen! Det är self illumen."
"DOTA_Workshop_MaterialDetail_SpecMaskTexture"	"Detta är spec mask-texturen! Spec mask."
"DOTA_Workshop_Model"	"Modell"
"DOTA_Workshop_Animations"	"Animationer"
"DOTA_Workshop_Misc"	"Övrigt"
"DOTA_Workshop_SubmissionType_Ward"	"Ward"
"DOTA_Workshop_ImportP4"	"Importera (P4)"
"DOTA_Workshop_ImportNoP4"	"Importera (Ingen P4)"
"DOTA_Workshop_SaveSettings"	"Spara inställningar"
"DOTA_Workshop_LoadSettings"	"Ladda inställningar"
"DOTA_Workshop_Ready"	"Redo"
"DOTA_Workshop_Optional"	"Valfri"
"DOTA_Workshop_Required"	"Krävs"
"DOTA_Workshop_Required_Texture"	"Krävs (Texturer kommer att få storleken ändrad till: %s1)"
"DOTA_Workshop_Required_Geometry"	"Krävs (Max. antal trianglar: %s1)"
"DOTA_Workshop_NotRequired_Geometry"	"(Max. antal trianglar: %s1)"
"DOTA_Workshop_NotRequired_Texture"	"(Texturer kommer att få storleken ändrad till: %s1)"
"DOTA_Workshop_ItemName"	"Artikelnamn"
"DOTA_Workshop_ItemName_Desc"	"Detta är utmatningsfilnamnet för din artikel. Det kommer inte att synas för spelare, och måste vara mindre än 50 tecken långt."
"DOTA_Workshop_GenericModelName_Desc"	"Detta är namnet på ditt importerade innehåll, den används internt hos Valve så var god och använd ett unikt eller beskrivande namn. Det kommer inte att synas för spelare, och måste vara mindre än 50 tecken långt."
"DOTA_Workshop_UnknownLOD"	"Okänd geometrifil"
"DOTA_Workshop_LOD0Title"	"Porträttgeometri"
"DOTA_Workshop_LOD0Desc"	"Det här är .DMX-, .SMD- eller .FBX-filen som innehåller den högre upplösta geometrin för din artikel. Den kommer användas i porträtt-, utrustnings- och uppvisningsvyer. Kontrollera meshen efter bakytor som saknas. Om ingen fil anges, kommer spelgeometrin användas istället."
"DOTA_Workshop_LOD1Title"	"Geometri i spelet"
"DOTA_Workshop_LOD1Desc"	"Detta är .DMX-, .SMD-, eller .FBX-filen som innehåller den skinnade geometrin för ditt föremål. Den kommer att användas i spelet."
"DOTA_Workshop_Texture_Title"	"Texturfiler"
"DOTA_Workshop_Texture_Desc"	"Det här är en uppsättning av fyra .TGA-filer som tillsammans texturerar den här geometrifilen. Bläddra och välj någon av .TGA-filerna med ändelserna _color, _normal, _mask1 eller _mask2, så kommer vi leta efter resten i samma mapp."
"DOTA_Workshop_Texturing"	"Textureringshjälp"
"DOTA_Workshop_Modelling"	"Modelleringshjälp"
"DOTA_Workshop_Animation"	"Animationshjälp"
"DOTA_Workshop_AbilityIconsHelp"	"Hjälp med förmågeikoner"
"DOTA_Workshop_DisableNICE"	"Inaktivera texturfiltrering"
"DOTA_Workshop_DisableNICE_Desc"	"På vissa texturer kan NICE-filtret vi använder resultera i \"mipmaps\" som inte bibehåller vissa specifika texturdetaljer. Om du ser detta hända med dina texturer, testa att stänga av och sätta på detta alternativ och se om texturerna blir mer läsliga."
"DOTA_Workshop_Reimport"	"Uppdatera"
"DOTA_Workshop_Models_Title"	"Modeller"
"DOTA_Workshop_Materials_Title"	"Material"
"DOTA_Workshop_Attachments_Title"	"Bilagor"
"DOTA_Workshop_Marketing_Title"	"Marknadsföring"
"DOTA_Workshop_Marketing_Desc"	"En .PSD-fil som innehåller ett urval av marknadsföringsbilder att använda för att marknadsföra ditt bidrag. Klicka på Marknadsföringshjälp-länken för att se kraven och det föreslagna formatet för din .PSD-fil."
"DOTA_Workshop_Marketing_Help"	"Marknadsföringhjälp"
"DOTA_Workshop_Particles_Title"	"Partiklar"
"DOTA_Workshop_Particles_Desc"	"Den här modellen kommer att ha ett partikelsystem fäst vid sig i spelet för speländamål. Det här är .DMX-, .SMD- eller .FBX-filen som innehåller brytpunkterna som anger hur partikelsystemet ska fästas."
"DOTA_Workshop_Particles_Help"	"Partikelhjälp"
"DOTA_Workshop_Images_Title"	"Bilder"
"DOTA_Workshop_AbilityIcons_Title"	"Förmågeikoner"
"DOTA_Workshop_HudSkin_Intro"	"HUD-utseenden är set med bilder som kombineras för att ersätta HUD:en i spelet."
"DOTA_Workshop_HudSkin_Desc"	"Ett set med .PNG-filer som skapades genom exportverktyget för HUD-utseenden i Photoshop. Bläddra och välj någon av .PNG-filerna, så kommer vi att hitta resten. De måste finnas i den mappstruktur som skapats av exportverktyget."
"DOTA_Workshop_HudSkin_Help"	"Hjälp för HUD-utseenden"
"DOTA_Workshop_CursorPack_Intro"	"Muspekarpaket är en uppsättning bilder som kombineras för att ersätta spelets muspekare."
"DOTA_Workshop_CursorPack_Desc"	"En uppsättning .BMP- och .ANI-filer som representerar de olika muspekarna för UI:t. Källan för muspekarna krävs även i rått .PNG-format. Bläddra efter icon.png som kommer vara ditt pakets ikon så hittar vi de andra filerna."
"DOTA_Workshop_CursorPack_Help"	"Hjälp för muspekarpaket"
"DOTA_Workshop_ImportLoadingScreen"	"IMPORTERA LADDNINGSSKÄRM"
"DOTA_Workshop_LoadingScreen_Intro"	"En bild som ersätter den vanliga laddningsskärmen i Dota 2"
"DOTA_Workshop_LoadingScreen_Desc"	"Bläddra efter loadingscreen.png."
"DOTA_Workshop_LoadScreen_Preview_Title"	"Förhandsvisa bildförhållande-beskärning"
"DOTA_UI_LoadScreen_16_9"	"16:9 Bildförhållande"
"DOTA_UI_LoadScreen_16_10"	"16:10 Bildförhållande"
"DOTA_UI_LoadScreen_4_3"	"4:3 Bildförhållande"
"DOTA_Workshop_ImportChatEmoticon"	"IMPORTERA UTTRYCKSSYMBOL"
"DOTA_Workshop_ChatEmoticon_Intro"	"En animerad uttryckssymbol för chatten"
"DOTA_Workshop_ChatEmoticon_Help"	"Hjälp för uttryckssymboler"
"DOTA_Workshop_ChatEmoticon_Title"	"Bildfil"
"DOTA_Workshop_ChatEmoticon_ItemName"	"Nyckelord för uttryckssymbol"
"DOTA_Workshop_ChatEmoticon_ItemName_Desc"	"Föreslaget nyckelord för uttryckssymbol"
"DOTA_Workshop_ChatEmoticon_AnimationSpeed"	"Tid/Bildruta"
"DOTA_Workshop_ZipError"	"Filfel!"
"DOTA_Armory_Tags_Popup_Title"	"Ange taggar"
"DOTA_Profile_SaveChanges"	"Spara ändringar"
"DOTA_Workshop_SubmissionType_Courier"	"Kurir"
"DOTA_GameMode_2"	"Kaptensläge"
"DOTA_GameMode_3"	"Slumpat Val"
"DOTA_GameMode_4"	"Enkelt Val"
"DOTA_GameMode_12"	"Minst spelade"
"DOTA_GameMode_18"	"Förmågeval"
"DOTA_ChatCommand_FlipCoin_Description"	"Singla slant för att få krona eller klave."
"DOTA_Chat_UnableToShareProfile"	"Kunde inte dela din profil med denna chattkanal."
"DOTA_CoinFlip_Heads"	"singlade slant: <span class=\"CoinFlipResult\">KRONA</span>"
"DOTA_CoinFlip_Tails"	"singlade slant: <span class=\"CoinFlipResult\">KLAVE</span>"
"DOTA_CoinFlip_UnableToFlip"	"Kunde inte singla slant i denna chattkanal."
"DOTA_Chat_ShareProfileMessage"	"Min profil är: <span class=\"ShareChatPersona\">[{s:share_persona}]</span>"
"DOTA_PlayerContextMenu_Ignore"	"Ignorera användare"
"DOTA_Frontpage_LastMatch_Title"	"Din senaste match"
"DOTA_Frontpage_LastMatch_Mode"	"Läge"
"DOTA_Frontpage_LastMatch_KDA"	"K / D / A"
"DOTA_Frontpage_LastMatch_Duration"	"Varaktighet"
"DOTA_Frontpage_LastMatch_Result"	"Resultat"
"DOTA_Frontpage_LastMatch_Items"	"Föremål"
"DOTA_Frontpage_WatchLive_Title"	"Mest sedda match nu"
"DOTA_Frontpage_FriendCustom_Title"	"Anpassat spel"
"DOTA_Frontpage_FriendCustom_IsPlaying"	"spelar"
"dota_settings_chat_join_regional"	"Gå med i regional chattkanal vid start"
"DOTA_Teams_NoInfo"	"Ingen information angiven"
"DOTA_Armory_Category_ScratchPad"	"Kollektion"
"dota_profile_oi_cancel"	"Avbryt"
"DOTA_tooltip_econ_item_tournament_drop"	"Turneringsfynd"
"DOTA_tooltip_econ_item_leaguename"	"{s:league_name}"
"DOTA_tooltip_econ_item_matchevent"	"{s:tournament_event}"
"DOTA_tooltip_econ_item_matchid"	"MATCH-ID: {s:tournament_matchID}"
"DOTA_tooltip_econ_item_matchdate"	"ERHÅLLEN: {t:l:tournament_date}"
"DOTA_tooltip_econ_item_team1_name"	"{s:team1_name}"
"DOTA_tooltip_econ_item_unknown_team"	"Okänt lag"
"DOTA_tooltip_econ_item_team2_name"	"{s:team2_name}"
"DOTA_tooltip_econ_item_VS"	"VS"
"DOTA_tooltip_econ_item_event_description"	"{s:event_description}"
"DOTA_Compendium_Coins_Increased"	"Du har fått fler kompendiummynt"
"DOTA_Compendium_Coin_Bank"	"{d:coin_bank}"
"DOTA_Compendium_Coin_Plus"	"+"
"DOTA_Compendium_Coins_Gained"	"{d:coins_gained}"
"DOTA_Workshop_ImportS1Normal"	"Importera Normal i Source1-stil"
"DOTA_Workshop_Items_Err_UpdateNeedsSelection"	"Måste välja ett föremål att uppdatera"
"DOTA_ItemPicker_Title"	"Välj ett föremål"
"DOTA_StyleUnlock_Title"	"{g:dota_item_name:header_item_def} Stilupplåsning"
"DOTA_StyleUnlock_ConfirmTitle"	"Stilupplåsning"
"DOTA_StyleUnlock_Text"	"Välj ett föremål att applicera denna stilupplåsning på"
"DOTA_StyleUnlock_NoValidItems"	"Du har inget av dessa föremål i ditt vapenförråd som kan använda denna stilupplåsning."
"DOTA_ProfileCard_WageredCoinsWon"	"Mynt vunna i vadslagning"
"DOTA_Crafting_Title"	"Tillverkning med höstsäsongskompendiet 2015"
"DOTA_CoinTreasure_CraftingButton"	"Tillverkning"
"DOTA_CoinTreasure_RewardsButton"	"Gå till belöningskartan"
"GC_steamoffline"	"Offline-läge"
}
