"dota"
{
"DOTA_Accept"	"接受"
"DOTA_Cancel"	"取消"
"DOTA_Console"	"命令列"
"DOTA_Create"	"	建立"
"DOTA_Decline"	"拒絕"
"DOTA_Error"	"錯誤"
"DOTA_Join"	"加入"
"DOTA_Leave"	"離開"
"DOTA_New"	"全新"
"DOTA_Ok"	"確定"
"DOTA_Sale"	"特價"
"DOTA_Close"	"關閉"
"DOTA_Continue"	"繼續"
"DOTA_Add"	"新增"
"DOTA_Edit"	"編輯"
"DOTA_Enable"	"啟用"
"DOTA_Disable"	"停用"
"DOTA_Refresh"	"重新整理"
"DOTA_Loading"	"讀取中"
"DOTA_None"	"無"
"DOTA_Customize"	"自訂"
"DOTA_AcceptChanges"	"接受變更"
"dota_team_radiant"	"聖輝"
"dota_team_dire"	"魔魘"
"Unknown"	"未知"
"UI_Yes"	"是"
"UI_No"	"否"
"UI_File_Filter_Any"	"所有檔案 (*.*)"
"DOTA_MainMenu_Heroes"	"英雄"
"DOTA_MainMenu_Watch"	"觀戰"
"DOTA_MainMenu_Learn"	"學習"
"DOTA_TabName_GlobalItems"	"通用物品"
"DOTA_TabName_Treasury"	"寶庫"
"DOTA_TabName_Armory"	"軍械庫"
"DOTA_ConfirmQuit"	"確定離開"
"DOTA_ConfirmQuitDesc"	"您確定要離開《Dota 2》嗎？"
"DOTA_ConfirmQuitDescUnsafe"	"在遊戲結束前退出將會影響遊戲中的其他玩家。您確定要離開《Dota 2》嗎？"
"DOTA_InvalidPersonaName"	"[不明人士]"
"DOTA_Friends_WindowTitle"	"好友列表"
"DOTA_FriendsCategory_ReadyToPlay"	"在公開遊戲中<font color='#63C290'><b></b>（{d:friend_count}）</font>"
"DOTA_FriendsCategory_PlayingDota"	"在 Dota 中<font color='#ACEBA9'>（{d:friend_count}）</font>"
"DOTA_FriendsCategory_Online"	"線上<font color='#6a9dcc'>（{d:friend_count}）</font>"
"DOTA_FriendsCategory_Pending"	"待處理<font color='#eeee82'>（{d:friend_count}）</font>"
"DOTA_FriendsCategory_Offline"	"離線<font color='#676666'>（{d:friend_count}）</font>"
"DOTA_Friends_Empty"	"您的好友清單目前為空白"
"DOTA_FriendsMenu_Tooltip_NoneReady"	"好友"
"DOTA_UserName"	"{g:dota_persona:user_account_id}"
"DOTA_UserNamePro"	"{g:dota_persona_pro:user_account_id}"
"DOTA_UserNickname"	"{g:dota_persona_nickname:user_account_id}"
"DOTA_UserRichPresence"	"{s:user_rich_presence}"
"DOTA_ProfileCard_StatTitle_SoloRank"	"單人配對積分"
"DOTA_ProfileCard_StatTitle_PartyRank"	"團隊配對積分"
"DOTA_ProfileCard_StatTitle_Wins"	"勝場"
"DOTA_ProfileCard_StatTitle_Commends"	"受稱讚次數"
"DOTA_ProfileCard_StatTitle_GamesPlayed"	"對戰次數"
"DOTA_ProfileCard_StatTitle_FirstMatchDate"	"第一場對戰"
"DOTA_ProfileCard_StatValue_Int"	"{d:stat_value}"
"DOTA_ProfileCard_StatValue_Date"	"{t:s:stat_value}"
"DOTA_ProfileCard_StatValue_String"	"{s:stat_value}"
"DOTA_ProfileCard_SlotTab_Trophies"	"獎盃"
"DOTA_ProfileCard_SlotTab_Items"	"軍械庫"
"DOTA_ProfileCard_SlotTab_Heroes"	"英雄"
"DOTA_ProfileCard_SlotTab_Emoticons"	"表情符號"
"DOTA_ProfileCard_NoTrophies"	"尚無可用獎盃。"
"DOTA_ProfileCard_NoItems"	"尚無可用物品。"
"DOTA_ProfileCard_HeroOnly"	"僅列出英雄"
"DOTA_ProfileCard_HeroShowWins"	"顯示勝場"
"DOTA_ProfileCard_HeroShowWinsAndLosses"	"顯示勝敗"
"DOTA_ProfileCard_ItemSearchPrefix"	"搜尋："
"DOTA_ProfileCard_ItemSearchPlaceholder"	"物品（依名稱排列）"
"DOTA_ProfileCard_ItemArmoryLink"	"檢視完整軍械庫"
"DOTA_HeroTooltip_HeroName"	"{s:hero_name}"
"DOTA_HeroTooltip_HeroRecord"	"{s:hero_wins_string}, {s:hero_losses_string}"
"DOTA_ProfileCard_HeroSearchPlaceholder"	"依照名稱搜尋英雄"
"DOTA_Wins_Singular"	"1 勝"
"DOTA_Wins_Plural"	"{d:hero_wins} 勝"
"DOTA_Losses_Singular"	"1 負"
"DOTA_Losses_Plural"	"{d:hero_losses} 負"
"DOTA_Profile_TotalGames"	"總場數"
"DOTA_Profile_Solo_MMR"	"單排積分"
"DOTA_Profile_Team_MMR"	"隊伍積分"
"DOTA_Profile_Party_MMR"	"團隊積分"
"DOTA_Profile_VictoryCount"	"獲勝次數"
"DOTA_Profile_ProfilePage"	"個人檔案"
"DOTA_Profile_RecentGamesPage"	"最近遊戲"
"DOTA_Profile_HeroPage"	"英雄"
"DOTA_Profile_PlayStyle"	"遊戲風格分析圖"
"DOTA_Profile_MostRecent"	"（近 {s:num_style_games} 場遊戲）"
"DOTA_Profile_RecentActivity"	"最近動態"
"DOTA_Profile_Fighting"	"戰鬥"
"DOTA_Profile_Fighting_TooltipTitle"	"戰鬥能力"
"DOTA_Profile_Fighting_Tooltip"	"顯示玩家與敵將交手時有多麼驍勇善戰的指標。"
"DOTA_Profile_Farming"	"賺錢"
"DOTA_Profile_Farming_TooltipTitle"	"賺錢能力"
"DOTA_Profile_Farming_Tooltip"	"顯示玩家有多會農兵賺錢的指標。"
"DOTA_Profile_Supporting"	"輔助"
"DOTA_Profile_Supporting_TooltipTitle"	"輔助能力"
"DOTA_Profile_Supporting_Tooltip"	"顯示玩家是否善於藉由提供治療、鞏固視野，和物品功能去輔佐隊伍的指標。"
"DOTA_Profile_Pushing"	"推進"
"DOTA_Profile_Pushing_TooltipTitle"	"推進能力"
"DOTA_Profile_Pushing_Tooltip"	"顯示玩家對於攻下防禦塔和局面有多麼擅長的指標。"
"DOTA_Profile_Versatility"	"彈性"
"DOTA_Profile_Versatility_TooltipTitle"	"選角彈性"
"DOTA_Profile_Versatility_Tooltip"	"顯示玩家在選角方面有著多少變化的指標。"
"DOTA_Profile_Tooltip_Value"	"{s:CurrentStatValue}"
"DOTA_Profile_Tooltip_Comparison"	"{s:CurrentComparisonValue}"
"DOTA_Profile_StatsCompare"	"與我的走向比較"
"DOTA_Profile_Self"	"我自己"
"DOTA_Profile_GPM"	"平均 GPM"
"DOTA_Profile_XPM"	"平均 XPM"
"DOTA_Profile_LH"	"平均正補"
"DOTA_Profile_Rampages"	"暴走次數"
"DOTA_Profile_TripleKills"	"三連殺次數"
"DOTA_Profile_FirstBlood"	"首殺次數"
"DOTA_Profile_FirstBled"	"首送次數"
"DOTA_Profile_CourierKills"	"信使擊殺次數"
"DOTA_Profile_Aegises"	"不朽守護竊取數"
"DOTA_Profile_CheeseEaten"	"乳酪食用次數"
"DOTA_Profile_CreepStack"	"野怪堆疊次數"
"DOTA_Profile_GPMValue"	"{s:GPM}"
"DOTA_Profile_XPMValue"	"{s:XPM}"
"DOTA_Profile_LHValue"	"{s:LH}"
"DOTA_Profile_RampagesValue"	"{d:Rampages}"
"DOTA_Profile_TripleKillsValue"	"{d:TripleKills}"
"DOTA_Profile_FirstBloodValue"	"{d:FirstBlood}"
"DOTA_Profile_FirstBledValue"	"{d:FirstBled}"
"DOTA_Profile_CourierKillsValue"	"{d:CourierKills}"
"DOTA_Profile_AegisesValue"	"{d:Aegises}"
"DOTA_Profile_CheeseEatenValue"	"{d:CheeseEaten}"
"DOTA_Profile_CreepStackValue"	"{d:CreepStack}"
"DOTA_Profile_GPMLocalValue"	"{s:GPMLocal}"
"DOTA_Profile_XPMLocalValue"	"{s:XPMLocal}"
"DOTA_Profile_LHLocalValue"	"{s:LHLocal}"
"DOTA_Profile_RampagesLocalValue"	"{d:RampagesLocal}"
"DOTA_Profile_TripleKillsLocalValue"	"{d:TripleKillsLocal}"
"DOTA_Profile_FirstBloodLocalValue"	"{d:FirstBloodLocal}"
"DOTA_Profile_FirstBledLocalValue"	"{d:FirstBledLocal}"
"DOTA_Profile_CourierKillsLocalValue"	"{d:CourierKillsLocal}"
"DOTA_Profile_AegisesLocalValue"	"{d:AegisesLocal}"
"DOTA_Profile_CheeseEatenLocalValue"	"{d:CheeseEatenLocal}"
"DOTA_Profile_CreepStackLocalValue"	"{d:CreepStackLocal}"
"DOTA_RecentGames_Title"	"最近遊戲"
"DOTA_RecentGames_TimeStamp"	"日期 / 時間"
"DOTA_RecentGames_HeroSelection"	"使用英雄"
"DOTA_RecentGames_GameResult"	"戰果"
"DOTA_RecentGames_GameLength"	"持續時間"
"DOTA_RecentGames_Team"	"陣營"
"DOTA_RecentGames_GameType"	"遊戲模式"
"DOTA_RecentGames_Items"	"身上物品"
"DOTA_RecentGame_Timestamp_Entry"	"{t:s:timestamp} {t:t:timestamp}"
"DOTA_RecentGame_Duration"	"{t:d:duration}"
"DOTA_RecentGame_Downloading"	"{s:DownloadPercent} Downloading"
"DOTA_RecentGame_Watch"	"觀賞重播"
"DOTA_RecentGame_NoReplay"	"無重播可用"
"DOTA_RecentGame_Expired"	"重播逾期"
"DOTA_RecentGame_Finding"	"尋找中…"
"DOTA_RecentGame_Download"	"下載重播"
"DOTA_RecentGame_Pending"	"重播尚在處理中"
"DOTA_RecentGame_Unavailable"	"重播不可用"
"DOTA_RecentGame_MatchID"	"場次編號：#{s:match_id}"
"DOTA_No_Team_Name"	"--"
"DOTA_TrophyCount"	"{d:trophy_count} 座獎盃"
"DOTA_TrophiesCount"	"{d:trophy_count} 座獎盃"
"DOTA_TrophyCount_Number"	"{d:trophy_count}"
"DOTA_TrophyCount_NoNum"	"獎盃"
"DOTA_TrophiesCount_NoNum"	"獎盃"
"DOTA_Trophies_ViewAll"	"全部"
"DOTA_TrophyName"	"{s:trophy_name}"
"DOTA_TrophyCategory"	"{s:trophy_category}"
"DOTA_TrophyDescription"	"{s:trophy_description}"
"DOTA_TrophyXP"	"{d:trophy_xp}<span class=\"TrophyPointTextSmall\">TP</span>"
"DOTA_NextTrophy"	"後續獎盃"
"DOTA_NewPlayerQuestion_Title"	"歡迎來到《Dota 2》"
"DOTA_PlayerOriginQuestion_Question"	"為改善您的遊戲體驗，請分享您對 Dota 2 的熟悉度和其它類似遊戲的經驗："
"DOTA_PlayerOriginQuestion_BeginnerButton"	"我是新手。"
"DOTA_PlayerOriginQuestion_RTSButton"	"我玩過即時戰略遊戲。"
"DOTA_PlayerOriginQuestion_MOBAButton"	"我玩過類似 Dota 2 的遊戲。"
"DOTA_PlayerOriginQuestion_Dota2Button"	"我玩過 Dota 2。"
"DOTA_PlayerOriginQuestion_MOBAExplanation"	"請選擇您最常玩的遊戲："
"DOTA_OtherGames_LOL"	"英雄聯盟（League of Legends）"
"DOTA_OtherGames_DOTA"	"初代 DotA"
"DOTA_OtherGames_HON"	"紐爾斯群英傳（Heroes of Newerth）"
"DOTA_OtherGames_Smite"	"諸神爭霸（Smite）"
"DOTA_OtherGames_Other"	"其它遊戲"
"DOTA_PlayerOriginQuestion_ConfirmationButton"	"開始吧！"
"DOTA_PlayerOriginQuestion_ConfirmationTutorial"	"身為新來乍到的 Dota 玩家，您或許對「進行遊戲」分頁中「訓練」區塊底下的各種教學關卡感興趣。那可是能幫助您開始打垮全球各地其他玩家的偉大第一步。"
"DOTA_PlayerOriginQuestion_ConfirmationSettings"	"現在您的按鍵配置與選項已設置成與您具有相同經驗的玩家最常用的設置。您隨時可以藉由點擊設置圖示來自訂設置。"
"DOTA_Tutorial_SkipButton"	"略過新手教學"
"DOTA_ConfirmSkip"	"略過 Dota 2 介紹？"
"DOTA_ConfirmSkipDesc"	"您真的確定要略過 Dota 2 的新手教學嗎？"
"DOTA_Tutorial_Start_Quest"	"開始任務"
"DOTA_Tutorial_Quest0_Title"	"任務 1"
"DOTA_Tutorial_Quest0_TitleDesc"	"遠程英雄"
"DOTA_Tutorial_Quest0DetailsDesc"	"此任務約可在\n\n十分鐘之內完成。"
"DOTA_Tutorial_QuestDetailsLearn"	"您將在此學到："
"DOTA_Tutorial_Quest0DetailsLesson"	"角色移動\n角色升級\n使用技能\n裝備\n基礎戰鬥操作\n取得正補"
"DOTA_Tutorial_Quest1_Title"	"任務 2"
"DOTA_Tutorial_Quest1_TitleDesc"	"對線"
"DOTA_Tutorial_Quest1DetailsDesc"	"此任務約可在\n\n十分鐘之內完成。"
"DOTA_Tutorial_Quest1DetailsLesson"	"遠程戰鬥 \n 範圍技能 \n 小地圖 \n 防禦塔 \n 信使以及貯藏庫 \n  傳送"
"DOTA_Tutorial_Quest2_Title"	"任務 3"
"DOTA_Tutorial_Quest2_TitleDesc"	"對線"
"DOTA_Tutorial_Quest2DetailsDesc"	"此任務約可在\n\n10 到 15 分鐘之內完成。"
"DOTA_Tutorial_Quest2DetailsLesson"	"進行對線 \n 防禦塔攻防 \n 開局物品"
"DOTA_Challenges_Title"	"學習"
"DOTA_ChallengeGroup_0_Title"	"遊戲介紹"
"DOTA_ChallengeGroup_1_Title"	"引導式實戰入門"
"DOTA_ChallengeGroup_1_Desc"	"從這開始！"
"DOTA_ChallengeGroup_2_Title"	"對抗電腦遊戲"
"DOTA_ChallengeGroup_More"	"未來還有更多"
"DOTA_ChallengeGroup_Locked"	"鎖定"
"DOTA_LearnMechanics_Title"	"遊戲介紹"
"DOTA_Mechanics_0_Title"	"遊戲機制 1"
"DOTA_Mechanics_0_Desc"	"角色移動\n角色升級\n使用技能\n裝備\n基礎戰鬥操作\n正補"
"DOTA_Mechanics_1_Title"	"遊戲機制 2"
"DOTA_Mechanics_1_Desc"	"遠程戰鬥\n範圍技能\n小地圖\n防禦塔\n信使以及貯藏庫\n傳送卷軸"
"DOTA_LearnGuidedBotMatches_Title"	"引導式實戰入門"
"DOTA_LearnGuidedBotMatches_SubTitle"	"引導式實戰入門有著由電腦操控的隊友和敵手，以及可即時暫停遊戲的說明功能。您可安心的讓遊戲系統帶您逐步走過一場 Dota 遊戲的每個環節，助您扮演的英雄成長茁壯，過關斬將，贏得勝利。"
"DOTA_GuidedBotMatches_0_Title"	"露娜"
"DOTA_GuidedBotMatches_0_Desc"	"│短距遠攻\n│普攻傷害先天較高\n│移動速度較快\n│較不耐打\n│敏捷英雄"
"DOTA_GuidedBotMatches_1_Title"	"斯溫"
"DOTA_GuidedBotMatches_1_Desc"	"│近戰肉搏\n│爆發性普攻傷害\n│耐打不易死\n│易受移動速度減緩效果牽制\n│力量英雄"
"DOTA_GuidedBotMatches_2_Title"	"莉娜"
"DOTA_GuidedBotMatches_2_Desc"	"│攻擊距離遠\n│爆發性技能傷害\n│技能冷卻時間短\n│體質非常脆弱\n│智力英雄"
"DOTA_LearnBotMatches_Title"	"實戰練習系統"
"DOTA_BotMatches_0_Title"	"簡單難度"
"DOTA_BotMatches_0_Desc"	"我只是想玩玩看新英雄。"
"DOTA_BotMatches_1_Title"	"一般難度"
"DOTA_BotMatches_1_Desc"	"讓我練個角色。"
"DOTA_BotMatches_2_Title"	"困難難度"
"DOTA_BotMatches_2_Desc"	"自我挑戰。"
"DOTA_BotMatches_3_Title"	"變態難度"
"DOTA_BotMatches_3_Desc"	"折磨自己。"
"FileOpenDialog_Open"	"開啟"
"FileOpenDialog_Save"	"儲存"
"FileOpenDialog_Select"	"選擇"
"FileOpenDialog_FileType_Folder"	"檔案資料夾"
"DOTA_FindMatch"	"尋找比賽配對"
"DOTA_FindingMatch"	"比賽配對尋找中 ( {s:find_match_time} )"
"DOTA_FindMatchTime"	"{s:find_match_time}"
"DOTA_Searching"	"搜場中"
"DOTA_StartSoloBotMatch"	"開始對抗電腦遊戲"
"DOTA_Create_Lobby"	"建立大廳"
"DOTA_Join_Lobby"	"加入大廳"
"DOTA_LobbyStartGame"	"開始遊戲"
"DOTA_ReturnToLobby"	"返回大廳"
"DOTA_FindMatchStatus"	"{s:searching_matchtype} / {s:searching_gamemodes} / {s:searching_region}"
"DOTA_FindGameModesMany"	"遊戲模式："
"DOTA_FindRegionsMany"	"地區："
"DOTA_GameMode_AllPick"	"自由選取"
"DOTA_GameMode_SingleDraft"	"徵召模式"
"DOTA_GameMode_CaptainsMode"	"隊長模式"
"DOTA_GameMode_RandomDraft"	"隨機徵召"
"DOTA_GameMode_AbilityDraft"	"技能徵召"
"DOTA_GameMode_LeastPlayed"	"生疏模式"
"DOTA_GameMode_AllRandom"	"隨機模式"
"DOTA_GameMode_LimitedHeroes"	"限定英雄"
"DOTA_GameMode_CaptainsDraft"	"隊長徵召"
"DOTA_GameMode_AllRandomDeathMatch"	"全隨機死鬥模式"
"DOTA_ImmediatePurchase_SendFailed"	"購買要求傳送失敗。可能是因為 Dota 伺服器目前離線所導致。請待之後再試。"
"DOTA_ImmediatePurchase_Timeout"	"等待購買要求回應逾時。請稍後再試。"
"DOTA_ImmediatePurchase_InitFailed"	"目前無法向完美世界伺服器傳送購買要求。請稍後再試。"
"DOTA_ImmediatePurchase_InsufficientFundsPW"	"您的完美世界帳戶沒有足夠餘額以完成購買。請儲值後再試。"
"DOTA_ImmediatePurchase_Success_Title"	"成功"
"DOTA_ImmediatePurchase_Success_Text"	"購買作業成功完成！請至軍械庫查收您購買的物品。"
"DOTA_ImmediatePurchase_Cancelled_Title"	"已取消"
"DOTA_ImmediatePurchase_UnbundleTimeout"	"打開要求回應逾時。請稍後再試。"
"DOTA_ImmediatePurchase_UnbundleFailure"	"無法打開您的同捆包。請稍後再試。"
"DOTA_ImmediatePurchase_LateCancel"	"交易取消。您並沒有被收取費用。"
"DOTA_ConfirmPurchaseTitle"	"確認購買"
"DOTA_ConfirmPurchaseText"	"您確定要購買此物品嗎？"
"DOTA_PurchaseInProgress_Title"	"購買作業處理中"
"DOTA_PurchaseInProgress_Text"	"系統正在處理您的購買要求。"
"DOTA_UnbundleInProgress_Title"	"打開中"
"DOTA_UnbundleInProgress_Text"	"正在打開您的同捆包。"
"DOTA_ConfirmUnbundleTitle"	"確認打開"
"DOTA_ConfirmUnbundleText"	"您必須打開此同捆包才能裝備其內容物。確定繼續？"
"DOTA_RequestingBalance_Title"	"查詢餘額中"
"DOTA_RequestingBalance_Text"	"正在查您的完美世界帳戶餘額..."
"DOTA_PartnerPurchaseRecharge_Title"	"儲值額度"
"DOTA_PartnerPurchaseRecharge_Text"	"正在切換帳戶以為您儲值..."
"DOTA_PartnerPurchase_Purchase"	"{g:dota_item_price:item_def}"
"DOTA_PartnerPurchase_Recharge"	"儲值帳戶"
"DOTA_PartnerPurchase_Balance"	"剩餘額度：{m:balance}"
"DOTA_PartnerRecharge_Close"	"繼續購買"
"RequestBalanceBadAccount"	"餘額查詢失敗：找不到帳戶。"
"RequestBalanceAccountNotLinked"	"餘額查詢失敗：您的帳戶尚未與完美世界連結。"
"RequestBalanceUnsupportedPartner"	"餘額查詢失敗：您的帳戶尚未與受官方認可的合作夥伴連結。"
"StoreCheckout_Error_Title"	"錯誤"
"StoreCheckout_NoItems"	"您的購物車是空的！"
"StoreCheckout_TooManyItems"	"您的購物車物品太多了！"
"StoreCheckout_Loading"	"結帳中..."
"StoreCheckout_Unavailable"	"目前無法進行結帳。"
"StoreCheckout_Cancelling"	"取消中..."
"StoreCheckout_Fail"	"遊戲商店目前關閉中。"
"StoreCheckout_InvalidParam"	"有個程式設計師搞砸啦！一個無效的參數被傳送至遊戲協調器。請嘗試重新購買。"
"StoreCheckout_InternalError"	"您的交易在初始化或更新時發生錯誤。請稍後幾分鐘後再試一次，或是聯絡客服中心尋求協助。"
"StoreCheckout_ContactSupport"	"在處理您的交易時發生錯誤，請聯絡客服中心以取得相關協助。"
"StoreCheckout_NotApproved"	"遊戲協調器無法透過 Steam 核准您的交易。請稍後嘗試重新購買。"
"StoreCheckout_NotLoggedin"	"您必須登入 Steam 以完成購買。"
"StoreCheckout_WrongCurrency"	"此交易的貨幣和您的錢包貨幣並不相符。"
"StoreCheckout_NoAccount"	"您的 Steam 帳戶目前無法使用。請稍後再次進行購買。"
"StoreCheckout_InsufficientFunds"	"您的資金不足以完成購買。"
"StoreCheckout_TimedOut"	"交易逾時。請再嘗試一次。"
"StoreCheckout_SteamAccountDisabled"	"您的 Steam 帳戶已停用，無法進行購買。"
"StoreCheckout_SteamAccountNoPurchase"	"此帳戶的 Steam 錢包交易已遭停用。"
"StoreCheckout_OldPriceSheet"	"您的本機產品清單過期。正在要求新的產品清單。"
"StoreCheckout_TransactionNotFound"	"遊戲協調器無法找到這筆交易的 ID。請重新嘗試購買。"
"StoreCheckout_TransactionCancelled"	"交易取消。您並沒有被收取費用。"
"StoreCheckout_TransactionCompleted"	"交易完成！\\\n享受你的戰利品吧！"
"StoreCheckout_CompleteButUnfinalized"	"目前無法確認交易狀況。如果成功的話，您的物品將於幾天後送達。"
"StoreCheckout_NotEnoughRoom"	"您的軍械庫空間不足以購買那麼多的項目。"
"StoreCheckout_ContactSupport_Dialog_Title"	"警告"
"StoreCheckout_ContactSupport_Dialog_Btn"	"聯絡"
"StoreCheckout_LimitedQuantityItemsUnavailable"	"一項您嘗試購買的物品已賣完或無法取得。"
"StoreCheckout_Nexon_InsufficientFunds"	"資金不足無法完成購買。"
"StoreCheckout_Nexon_FundsLocked"	"Nexon 現金鎖定已開啟。"
"DOTA_AbilityTooltip_Name"	"{s:name}"
"DOTA_AbilityTooltip_Level"	"等級 {s:level}"
"DOTA_AbilityTooltip_TargetType"	"影響對象：{s:targettype}"
"DOTA_AbilityTooltip_CastType"	"使用方式：{s:casttype}"
"DOTA_AbilityTooltip_DamageType"	"傷害類型：{s:damagetype}"
"DOTA_AbilityTooltip_SpellImmunityType"	"穿透技能免疫：{s:spellimmunity}"
"DOTA_AbilityTooltip_Description"	"{s:description}"
"DOTA_AbilityTooltip_ScepterDescription"	"{s:scepterdescription}"
"DOTA_AbilityTooltip_ExtraDescription"	"{s:extradescription}"
"DOTA_AbilityTooltip_Attributes"	"{s:attributes}"
"DOTA_AbilityTooltip_Cooldown"	"{s:cooldown}"
"DOTA_AbilityTooltip_ManaCost"	"{s:manacost}"
"DOTA_AbilityTooltip_Lore"	"{s:lore}"
"DOTA_AbilityTooltip_UpgradeLevel"	"英雄等級 {d:upgradelevel} 時可再次升級"
"DOTA_AbilityTooltip_BuildHeader"	"配點攻略"
"DOTA_AbilityTooltip_BuildComment"	"{s:buildcomment}"
"DOTA_PersonaTooltip_Title"	"{g:dota_persona:account_id}"
"DOTA_PersonaTooltip_TitlePro"	"{g:dota_persona_pro:account_id}"
"DOTA_PendingInvites"	"團隊邀請"
"DOTA_PendingInvitesTooltip_None"	"沒有待處理的邀請"
"DOTA_PendingInvitesTooltip_1"	"尚有 1 個邀請待處理"
"DOTA_PendingInvitesTooltip_N"	"尚有 {d:pending_invite_count} 個邀請待處理"
"DOTA_PendingInvitesTooltip_Leader"	"點此管理邀請"
"DOTA_PendingInvitesTooltip_NonLeader"	"點此檢視邀請狀態。"
"DOTA_PendingInvitesCancelAll"	"取消所有的邀請"
"DOTA_PendingInvitesNotPartyLeader"	"僅有團長能管裡邀請"
"DOTA_ChatTab_NotInChannelMessage"	"沒人聽的見您說話。"
"DOTA_ChatTab_ToggleGlobal"	"令此頻道的訊息顯示在所有分頁中。"
"DOTA_ChatTab_Close"	"關閉此分頁。"
"DOTA_ChatTab_Leave"	"離開此頻道。"
"DOTA_JoinChatChannel_Title"	"加入頻道"
"DOTA_JoinChatChannel_Description"	"建立或加入一個聊天頻道。"
"DOTA_JoinChatChannel_AddToCurrentTab"	"添加至目前的分頁 '{s:current_tab_name}'"
"DOTA_JoinChatChannel_CreateNewTab"	"新增一個分頁："
"DOTA_Chat_ChannelName"	"{s:channel_name}"
"DOTA_Chat_ChannelMemberCount_Singular"	"1 位成員"
"DOTA_Chat_ChannelMemberCount_Plural"	"{d:channel_member_count} 位成員"
"DOTA_EditChatTab_Title"	"修改聊天分頁"
"DOTA_EditChatTab_Description"	"選擇要在此分頁顯示哪些訊息。"
"DOTA_EditChatTab_AddNewChannel"	"加入新的頻道..."
"DOTA_EditChatTab_TabName"	"分頁名稱："
"DOTA_EditChatTab_ChannelToggleDisabled"	"{s:target} 須至少存在於一個分頁中。"
"DOTA_EditChatTab_Target"	"{s:target}"
"DOTA_Chat_TimestampFormat"	"{t:t:timestamp}"
"DOTA_Chat_Autocomplete_Title"	"{s:autocomplete_title}"
"DOTA_Chat_Autocomplete_NoMatches"	"無符合結果"
"DOTA_Chat_Autocomplete_WhisperFriends"	"對好友發送悄悄話"
"DOTA_Chat_Autocomplete_InviteFriends"	"邀請好友"
"DOTA_Chat_Autocomplete_Channels"	"頻道"
"DOTA_Chat_Autocomplete_Commands"	"指令"
"DOTA_Chat_Autocomplete_CommandName"	"/{s:command_name}"
"DOTA_Chat_Autocomplete_CommandDescription"	"{s:command_description}"
"dota_suggest_invite_format"	"請邀請 %s1 至團隊。"
"dota_suggest_invite_format_leader"	"請邀請 {s:invite_persona} 至團隊。( <a href=\"event:DOTAInviteToParty({s:invite_persona_steamid})\" class=\"InviteButton\">送出邀請</a> )"
"dota_suggest_invite_format_lobby"	"請邀請 {s:invite_persona} 至大廳。"
"dota_suggest_invite_format_lobby_leader"	"請邀請 {s:invite_persona} 至大廳。( <a href=\"event:DOTAInviteToLobby({s:invite_persona_steamid})\" class=\"InviteButton\">送出邀請</a> )"
"DOTA_ChatMessage_Default"	"<span class=\"{s:target_class} {s:sender_class} {s:visitor_class}\"><span class=\"ChatTarget\">({s:target})</span> <span class=\"ChatPersona\">{s:event_crest}{s:persona}</span>: {g:dota_filtered_string:message}</span>"
"DOTA_ChatMessage_WhisperTo"	"<span class=\"{s:target_class} {s:sender_class} {s:visitor_class}\">至<span class=\"ChatPersona\">{s:event_crest}{s:persona}</span>：{g:dota_filtered_string:message}</span>"
"DOTA_ChatMessage_WhisperFrom"	"<span class=\"{s:target_class} {s:sender_class} {s:visitor_class}\">來自<span class=\"ChatPersona\">{s:event_crest}{s:persona}</span>：{g:dota_filtered_string:message}</span>"
"DOTA_ChatMessage_System"	"<span class=\"{s:target_class} {s:sender_class} {s:visitor_class}\"><span class=\"ChatTarget\">({s:target})</span>: {g:dota_filtered_string:message}</span>"
"DOTA_ChatTarget_Format_Default"	"{s:target}"
"DOTA_ChatTarget_Prompt_Default"	"給({s:target})："
"DOTA_ChatTarget_Format_Whisper"	"{s:persona}"
"DOTA_ChatTarget_Prompt_Whisper"	"給[{s:persona}]："
"DOTA_ChatTarget_Party"	"團隊"
"DOTA_ChatTarget_Lobby"	"大廳"
"DOTA_ChatTarget_Team"	"隊伍"
"DOTA_ChatTarget_Guild"	"公會"
"DOTA_ChatTarget_Fantasy"	"夢幻"
"DOTA_ChatTarget_Console"	"控制台"
"DOTA_ChatTarget_Whisper"	"悄悄話"
"DOTA_ChatTarget_Invalid"	"沒有頻道"
"DOTA_ChatTarget_GameAll"	"所有"
"DOTA_ChatTarget_GameAllies"	"友方"
"DOTA_ChatTarget_GameCoaching"	"教練"
"DOTA_ChatTarget_GameSpectator"	"觀眾"
"DOTA_ChatTargetMenu_Title"	"{s:target}"
"DOTA_ChatTargetMenu_ToggleEnabled"	"{s:toggle_enabled}"
"DOTA_ChatTargetMenu_NotActive"	"（未啟用）"
"DOTA_Chat_Placeholder"	"在此輸入文字來進行交談。以 / 起首來使用斜線命令。"
"DOTA_Chat_MissedMessages"	"{s:missed_message_count}"
"DOTA_ChatCommand_Party"	"p"
"DOTA_ChatCommand_Party_Name"	"團隊"
"DOTA_ChatCommand_Party_Description"	"與目前所處的團隊聊天。"
"DOTA_ChatCommand_Lobby"	"l"
"DOTA_ChatCommand_Lobby_Name"	"大廳"
"DOTA_ChatCommand_Lobby_Description"	"與目前所處的大廳聊天。"
"DOTA_ChatCommand_Channel"	"c"
"DOTA_ChatCommand_Channel_Name"	"頻道"
"DOTA_ChatCommand_Channel_Description"	"在指定的頻道內聊天。"
"DOTA_ChatCommand_Whisper"	"w"
"DOTA_ChatCommand_Whisper_Name"	"悄悄話"
"DOTA_ChatCommand_Whisper_Description"	"對一名好友發送私訊。"
"DOTA_ChatCommand_Reply"	"r"
"DOTA_ChatCommand_Reply_Name"	"回覆"
"DOTA_ChatCommand_Reply_Description"	"回覆來自好友的私訊。"
"DOTA_ChatCommand_Help"	"?"
"DOTA_ChatCommand_Help_Name"	"幫助"
"DOTA_ChatCommand_InviteToParty"	"partyinvite"
"DOTA_ChatCommand_InviteToParty_Name"	"邀請至團隊"
"DOTA_ChatCommand_InviteToParty_Description"	"邀請好友加入您目前所處的團隊。"
"DOTA_ChatCommand_LeaveParty"	"leaveparty"
"DOTA_ChatCommand_LeaveParty_Name"	"離開團隊"
"DOTA_ChatCommand_LeaveParty_Description"	"離開您目前所處的團隊。"
"DOTA_ChatCommand_JoinChannel"	"joinchannel"
"DOTA_ChatCommand_JoinChannel_Name"	"加入頻道"
"DOTA_ChatCommand_JoinChannel_Description"	"加入或建立一個聊天頻道。"
"DOTA_ChatCommand_LeaveChannel"	"leavechannel"
"DOTA_ChatCommand_LeaveChannel_Name"	"離開頻道"
"DOTA_ChatCommand_LeaveChannel_Description"	"離開指定的聊天頻道。"
"DOTA_ChatCommand_GameAll"	"全部"
"DOTA_ChatCommand_GameAll_Name"	"所有"
"DOTA_ChatCommand_GameAll_Description"	"與同場遊戲的所有人聊天。"
"DOTA_ChatCommand_GameAllies"	"allies"
"DOTA_ChatCommand_GameAllies_Name"	"友方"
"DOTA_ChatCommand_GameAllies_Description"	"與同場遊戲的隊友聊天。"
"DOTA_ChatCommand_GameCoaching"	"coach"
"DOTA_ChatCommand_GameCoaching_Name"	"教練"
"DOTA_ChatCommand_GameCoaching_Description"	"與同場遊戲的學徒或教練聊天。"
"DOTA_ChatCommand_GameSpectator"	"spectator"
"DOTA_ChatCommand_GameSpectator_Name"	"觀眾"
"DOTA_ChatCommand_GameSpectator_Description"	"與旁觀同場遊戲的觀眾聊天。"
"DOTA_ChatCommand_Clear"	"clear"
"DOTA_ChatCommand_Clear_Name"	"清除"
"DOTA_ChatCommand_Clear_Description"	"清除目前分頁中所有可見的訊息。"
"DOTA_Chat_UnknownCommandMessage"	"未知的聊天指令「{s:chat_command}」"
"DOTA_ChatHelp_Targets"	"對象"
"DOTA_ChatHelp_Commands"	"指令"
"DOTA_ChatHelp_NameFormat"	"{s:command_name}："
"DOTA_ChatHelp_CommandFormat"	"/{s:command}"
"DOTA_Chat_JoinedParty"	"玩家 {s:party_members} 已加入團隊"
"DOTA_Chat_LeftParty"	"團隊已解散。"
"DOTA_Chat_MemberJoinedParty"	"玩家 {s:party_members} 已加入團隊"
"DOTA_Chat_MemberLeftParty"	"玩家 {s:party_members} 已退出團隊"
"DOTA_Chat_InvitedToJoinParty"	"已邀請玩家 {s:party_members} 加入團隊"
"DOTA_Chat_RequestedToJoinParty"	"玩家 {s:party_members} 要求加入團隊"
"DOTA_Chat_PartyMemberSeparator"	", "
"DOTA_Feature_Under_Construction_Title"	"建構中"
"DOTA_Feature_Under_Construction_Text"	"本功能尚在建構中故還無法使用。"
"DOTA_PartyJoinRequest_Title"	"加入團隊申請"
"DOTA_PartyInvite_Title"	"團隊邀請"
"DOTA_PartyInvite_BlockPartyLeader"	"封鎖所有來自 {g:dota_persona:b:inviter} 的訊息"
"DOTA_LobbyInvite_BlockInviter"	"封鎖所有來自這位玩家的訊息"
"DOTA_PartyInvite_BlockNonFriendInvites"	"封鎖所有不是來自好友的邀請"
"DOTA_PartyInvite_BlockNonFriendInvitesDescription"	"可到設定面板中的【選項 / 個人檔案】底下進行開關"
"DOTA_PartyInvite_Expired"	"要求已取消或不再有效。"
"DOTA_PartyInvite_Coach"	"教練："
"DOTA_PartyVisTooltip_SoloNotOpen"	"- 點擊來變更我的狀態。"
"DOTA_PartyVisTooltip_SoloOpen"	"- 好友能向您傳送加入請求。<br/>- 再按一次來取消想號召團隊。"
"DOTA_PartyVisTooltip_LeaderOpen"	"系統將會自動接受來自團隊成員的好友的加入請求。<br/>點此來取消團隊的公開狀態。"
"DOTA_PartySettings"	"團隊設定"
"DOTA_LobbyInvite_Title"	"大廳邀請"
"DOTA_PartyJoinedLobby_Title"	"已加入大廳"
"DOTA_PartyLeader"	"團長"
"DOTA_LobbyKicked_Header"	"從大廳踢出"
"DOTA_LobbyKicked_Message"	"您被大廳廳主從遊戲大廳踢出。"
"DOTA_PlayerContextMenu_ViewProfile"	"檢視個人檔案"
"DOTA_PlayerContextMenu_ChatWithPlayer"	"傳送訊息"
"DOTA_PlayerContextMenu_InviteToParty"	"邀請至團隊"
"DOTA_PlayerContextMenu_SuggestInviteToParty"	"建議邀請加入團隊"
"DOTA_PlayerContextMenu_LeaveParty"	"離開團隊"
"DOTA_PlayerContextMenu_AddFriend"	"新增好友"
"DOTA_PlayerContextMenu_RemoveFriend"	"移除好友"
"DOTA_PlayerContextMenu_Spectate"	"觀看遊戲"
"DOTA_FeaturedHero_ViewGrid"	"方格排列檢視"
"DOTA_FeaturedHero_HeroName"	"{s:hero_name}"
"DOTA_FeaturedHero_ItemName"	"{g:dota_item_name:item_def}"
"DOTA_FeaturedHeroReason_NewItem"	"新{s:item_rarity}"
"DOTA_FeaturedHeroReason_PopularItem"	"暢銷項目"
"DOTA_FeaturedHeroReason_SaleItem"	"特價項目"
"DOTA_HeroSelectorCategory_Default"	"所有英雄"
"DOTA_HeroSelectorCategory_NewItems"	"新物品"
"DOTA_HeroSelectorCategory_PrimaryAttribute_Strength"	"力量"
"DOTA_HeroSelectorCategory_PrimaryAttribute_Agility"	"敏捷"
"DOTA_HeroSelectorCategory_PrimaryAttribute_Intelligence"	"智力"
"DOTA_HeroSelectorCategory_AttackRange_Melee"	"近程"
"DOTA_HeroSelectorCategory_AttackRange_Ranged"	"遠程"
"DOTA_OwnedItemSet_Selector_Title"	"已擁有"
"DOTA_EquippedItemSet_Selector_Title"	"裝備中"
"DOTA_OwnedItemSet_Available_Title"	"可選物品"
"DOTA_FeaturedItemSet_Selector_Title"	"精選項目"
"DOTA_AllItemSet_Selector_Title"	"全部"
"DOTA_ConfirmLANLobby_title"	"區域網路大廳"
"DOTA_ConfirmLANLobby_desc"	"本地遊戲將會以您自己的裝置作為伺服主機，故要讓遊戲順暢運作的系統需求也相對較高。"
"DOTA_Lobby_Settings_General"	"綜合大廳設定"
"DOTA_Lobby_Settings_Required"	"必填"
"DOTA_Lobby_Settings_Confirm"	"{s:lobby_confirm_label}"
"DOTA_Lobby_Settings_Game_Mode"	"遊戲模式"
"DOTA_Lobby_Settings_Region"	"伺服器位置"
"DOTA_Lobby_Settings_Password"	"大廳密碼"
"DOTA_Lobby_Settings_Game_Name"	"遊戲名稱"
"DOTA_Lobby_Settings_Advanced"	"進階大廳設定"
"DOTA_Lobby_Settings_Competitive"	"競技"
"DOTA_Lobby_Settings_Starting_Team"	"起始隊伍"
"DOTA_Lobby_Settings_Starting_Team_Random"	"隨機"
"DOTA_Lobby_Settings_Starting_Team_Radiant"	"聖輝"
"DOTA_Lobby_Settings_Starting_Team_Dire"	"魔魘"
"DOTA_Lobby_Settings_Penalty_Radiant"	"懲罰 - 聖輝"
"DOTA_Lobby_Settings_Penalty_Dire"	"懲罰 - 魔魘"
"DOTA_Lobby_Settings_Penalty_Level_0"	"無"
"DOTA_Lobby_Settings_Series_Best_of_3"	"三戰兩勝制"
"DOTA_Lobby_Settings_Series_Best_of_5"	"五戰三勝制"
"DOTA_Lobby_Settings_Enable_Cheats"	"允許作弊指令"
"DOTA_Lobby_Settings_All_Chat"	"全頻交談"
"DOTA_Lobby_Settings_Fill_Bots"	"以電腦玩家遞補空位"
"DOTA_Lobby_Settings_Bot_Difficulty"	"電腦玩家難度"
"DOTA_Lobby_Settings_Bot_Difficulty_Passive"	"消極"
"DOTA_Lobby_Settings_Bot_Difficulty_Easy"	"簡單"
"DOTA_Lobby_Settings_Bot_Difficulty_Medium"	"中等"
"DOTA_Lobby_Settings_Bot_Difficulty_Hard"	"困難"
"DOTA_Lobby_Settings_Bot_Difficulty_Unfair"	"變態"
"DOTA_Lobby_Settings_Version"	"版本"
"DOTA_Lobby_Settings_Version_Latest"	"最新"
"DOTA_Lobby_Settings_Version_Tournament"	"職業聯賽"
"DOTA_Lobby_Settings_Spectator_Section"	"觀眾"
"DOTA_Lobby_Settings_Dota_TV_Delay"	"DOTA TV 延遲"
"DOTA_Lobby_Settings_Dota_TV_Delay_2_Minutes"	"2 分鐘"
"DOTA_Lobby_Settings_Dota_TV_Delay_5_Minutes"	"5 分鐘"
"DOTA_Lobby_Settings_Dota_TV_Delay_10_Seconds"	"10 秒"
"DOTA_Lobby_Settings_Spectators"	"觀眾"
"DOTA_Lobby_Settings_Spectators_Enabled"	"啟用"
"DOTA_Lobby_Settings_Spectators_Disabled"	"停用"
"dota_lobby_settings_hide_password"	"隱藏密碼"
"dota_lobby_settings_local_host"	"直接以本機當作伺服器"
"DOTA_Lobby_Settings_Visibility"	"大廳可見度"
"DOTA_Lobby_Settings_Visibility_Public"	"公開"
"DOTA_Lobby_Settings_Visibility_Friends"	"僅限好友"
"DOTA_Lobby_Settings_Visibility_Unlisted"	"不公開"
"DOTA_TeamUnsetHeader"	"隊伍尚未設定"
"DOTA_TeamUnsetMessage"	"至少還有一支隊伍尚未設定好隊伍名稱／標誌。確定要開始比賽嗎？"
"DOTA_LeagueUnsetHeader"	"聯賽未設定"
"DOTA_LeagueUnsetMessage"	"系統發現您具有為大廳設定聯賽的權限但此大廳並未偵測到設定有任何聯賽。您確定要讓比賽直接開打？"
"DOTA_LobbyAllowSpectatingHeader"	"大廳遊戲無法開始"
"DOTA_LobbyAllowSpectatingMessage"	"當有觀眾在大廳內時，大廳必須設定為允許旁觀；在控制面板內將「觀眾」選項設為開啟。"
"dota_radiant"	"聖輝"
"dota_dire"	"魔魘"
"dota_lobby_team_name_radiant"	"{s:team_name_good_guys}"
"dota_lobby_team_name_dire"	"{s:team_name_bad_guys}"
"dota_lobby_no_team"	"沒有隊伍"
"dota_lobby_broadcast_default_channel_name"	"頻道名稱"
"dota_lobby_broadcast_join"	"加入"
"dota_lobby_broadcast_leave"	"離開"
"dota_lobby_broadcast_create"	"建立新的頻道"
"dota_lobby_broadcast_no_channels"	"尚未有導播頻道被建立"
"dota_popup_broadcast_channel_edit_title"	"自訂導播頻道"
"dota_lobby_broadcast_default_channel_name_custom"	"{s:custom_title}"
"dota_popup_broadcast_channel_edit_channel_name"	"頻道標題"
"dota_popup_broadcast_channel_edit_country"	"國家"
"dota_popup_broadcast_channel_edit_language"	"語言"
"dota_popup_broadcast_channel_edit_save"	"設為預設並在往後於加入時自動加入空頻"
"DOTA_Lobby_Broadcaster_Channel_Other_Language"	"其它語言"
"lobby_slot_error_header"	"無法切換空位"
"generic_gc_timeout"	"訊息逾時。"
"lobby_slot_success_header"	"成功"
"lobby_slot_denied"	"您沒有加入此空位的權限。"
"lobby_slot_cameramanalready"	"各個轉播頻道都僅限一位掌鏡者"
"lobby_slot_cameramanon"	"您現在成為了掌鏡者"
"lobby_slot_cameramanoff"	"您已不再是位掌鏡者"
"lobby_slot_error"	"變更大廳空位失敗。"
"lobby_create_timeout"	"建立大廳失敗。"
"DOTA_DialogVariableTest5"	"帳戶 ID 名稱：{g:dota_persona:account_id}, Pro Name: {g:dota_persona:pro:account_id}"
"LobbySetting_GameMode"	"遊戲模式"
"LobbySetting_GameMode_Value"	"{s:lobbysetting_gamemode}"
"LobbySetting_Bots"	"電腦玩家"
"LobbySetting_Bots_Value"	"{s:lobbysetting_bots}"
"LobbySetting_Password"	"密碼"
"LobbySetting_Password_Value"	"{s:lobbysetting_password}"
"LobbySetting_Server"	"伺服器"
"LobbySetting_Server_Value"	"{s:lobbysetting_server}"
"LobbySetting_Cheats_Value"	"{s:lobbysetting_cheats}"
"LobbySetting_Spectators"	"允許旁觀"
"LobbySetting_Spectators_Value"	"{s:lobbysetting_spectators}"
"LobbySetting_Visibility_Value"	"{s:lobbysetting_visibility}"
"dota_lobby_lan_title"	"區域網路大廳"
"dota_lobby_coaches_none"	"教練：無"
"dota_lobby_coaches"	"教練："
"DOTA_Custom_Game"	"自訂遊戲"
"DOTA_Custom_Game_Info"	"資訊"
"DOTA_Custom_Game_View_Details"	"查看遊戲細節"
"DOTA_Custom_Game_Lobby_Count"	"{d:lobby_count} 大廳"
"DOTA_Custom_Game_Lobby_Count_Plural"	"{d:lobby_count} 大廳"
"DOTA_Custom_Game_View_Lobbies"	"檢視大廳"
"DOTA_Custom_Game_Find_Lobby"	"尋找大廳"
"DOTA_Custom_Game_Create_Lobby"	"建立大廳"
"DOTA_Custom_Game_Workshop_Page"	"工作坊頁面"
"DOTA_Custom_Game_Downloading"	"下載中..."
"DOTA_Custom_Game_Downloading_Percent"	"下載中 - {d:lobby_download_percent}%"
"DOTA_Custom_Game_Needs_Update"	"需要更新"
"DOTA_Custom_Game_Uninstall"	"解除安裝"
"DOTA_Custom_Game_Install"	"安裝"
"DOTA_Custom_Game_Installed"	"已安裝"
"DOTA_Custom_Game_Not_Installed"	"尚未安裝"
"DOTA_Custom_Game_Connect"	"加入大廳"
"DOTA_Custom_Game_FileSize"	"{d:file_size} MB"
"DOTA_Custom_Game_Name"	"{s:game_mode_name}"
"DOTA_Custom_Game_Rating"	"評價"
"DOTA_Custom_Game_Ratings_Count"	"（{d:ratings_count}）"
"DOTA_Custom_Game_Description"	"{s:game_description}"
"DOTA_Custom_Game_Last_Updated"	"上次更新 {t:r:t:last_updated}"
"DOTA_Custom_Game_Update_Note_Title"	"{s:timestamp}"
"DOTA_Custom_Game_Screenshots"	"螢幕擷圖"
"DOTA_Custom_Game_Map_Label"	"地圖"
"DOTA_Custom_Game_Map_Any"	"任何"
"DOTA_Custom_Game_Update"	"更新"
"DOTA_Custom_Game_Invite_Friend"	"邀請好友"
"DOTA_Custom_Game_Most_Popular"	"最熱門"
"DOTA_Custom_Game_Installed_Games"	"已安裝遊戲"
"DOTA_Custom_Game_DetailsPrompt"	"前往此自訂遊戲的細節頁面來獲得更多訊息，安裝，和進行。"
"Video_Support_Coming_Soon"	"即將支援影片功能"
"DOTA_Custom_Game_Leave_Lobby"	"離開此大廳"
"DOTA_Custom_Lobby_Settings_Title"	"建立大廳"
"DOTA_Custom_Lobby_Settings_Mode"	"遊戲模式"
"DOTA_Custom_Lobby_Settings_Map"	"地圖"
"DOTA_Custom_Lobby_LobbyName"	"額外說明"
"DOTA_Custom_Lobby_List_Desc"	"一個內含私人大廳（受密碼保護）以及未經篩選的自訂遊戲大廳的列表。"
"DOTA_Custom_Lobby_Public"	"公開"
"DOTA_Custom_Lobby_Passworded"	"玩家僅能藉由邀請或以密碼過濾來加入此大廳。"
"DOTA_Custom_Lobby_Join_Failed_Title"	"加入失敗"
"DOTA_Custom_Lobby_Join_Failed_Reason"	"{s:join_error}"
"DOTA_Custom_Lobby_Join_Failed_Prompt"	"現在想尋找開放的 {s:game_name} 比賽嗎?"
"DOTA_Custom_Lobby_Create_Private_Button"	"建立私人大廳"
"DOTA_Custom_Lobby_Find_Private_Button"	"尋找私人大廳"
"DOTA_Custom_Lobby_Find_Private_Title"	"尋找私人大廳"
"DOTA_Custom_Lobby_Find_Private_Desc"	"輸入密碼來尋找私人大廳："
"DOTA_Custom_Lobby_List_Game_Header"	"遊戲"
"DOTA_Custom_Lobby_List_Name_Header"	"說明"
"DOTA_Custom_Lobby_List_Players_Header"	"玩家"
"DOTA_Custom_Lobby_List_Map_Header"	"地圖"
"DOTA_Custom_Lobby_List_Region_Header"	"地區"
"DOTA_Custom_Lobby_List_Connection_Header"	"連線"
"DOTA_Custom_Lobby_List_Status_Header"	"本機狀態"
"DOTA_Custom_Lobby_List_Game"	"{s:lobby_game}"
"DOTA_Custom_Lobby_List_Lobby_Name"	"{s:lobby_name}"
"DOTA_Custom_Lobby_List_Players"	"{s:lobby_players} / {s:lobby_max_players}"
"DOTA_Custom_Lobby_List_Map"	"{s:lobby_map}"
"DOTA_Custom_Lobby_List_Region"	"{s:lobby_region}"
"DOTA_Custom_Lobby_List_Connection"	"…"
"DOTA_Custom_Lobby_List_Status"	"{s:lobby_status}"
"DOTA_Custom_Lobby_List_Connect"	"{s:connect_button_text}"
"DOTA_Custom_Lobby_Game_Name"	"{s:game_name}"
"DOTA_Custom_Lobby_Map_Name"	"地圖： {s:map_name}"
"DOTA_Custom_Lobby_Player_Count"	"玩家： {d:player_count} / {d:max_player_count}"
"DOTA_Custom_Lobby_Player_Count_Short"	"{d:player_count} / {d:max_player_count}"
"DOTA_Custom_Lobby_Visibility"	"大廳可見度"
"DOTA_Custom_Join_Chat"	"加入聊天"
"DOTA_Custom_Join_Chat_Member_Count"	"（{d:ChatMemberCount}）"
"DOTA_Custom_Leave_Chat"	"離開聊天"
"DOTA_TabName_ModsOverview"	"概覽"
"DOTA_TabName_ModsSubscribed"	"遊戲庫"
"DOTA_TabName_ModsWorkshop"	"工作坊"
"DOTA_TabName_ModsBrowse"	"瀏覽"
"DOTA_WatchTabName_Featured"	"推薦賽事"
"DOTA_WatchTabName_Replays"	"賽事重播"
"DOTA_WatchTabName_Tournaments"	"錦標賽"
"DOTA_WatchTabName_Downloads"	"下載"
"DOTA_WatchLive_Search"	"搜尋您想看的英雄"
"DOTA_WatchLive_DataPending"	"尋找尚在進行的賽局…"
"DOTA_WatchLive_Connecting"	"等待戰局資料..."
"DOTA_WatchLive_CountSpec"	"{i:num_spectating}人正在觀戰"
"DOTA_WatchLive_CountSpecFriend"	"{i:num_friends_spectating}名好友和{i:num_spectating}人正在觀戰"
"DOTA_WatchLive_CountSpecFriends"	"{i:num_friends_spectating}名好友和{i:num_spectating}人正在觀戰"
"DOTA_WatchLive_ParticipantsVs"	"<font color='#ffffff'>{s:team_1}</font> <font color='#888888'>vs.</font> <font color='#ffffff'>{s:team_2}</font>"
"DOTA_WatchLive_ParticipantsMMR"	"<font color='#888888'>平均積分：</font><font color='#ffffff'>{i:mmr}</font>"
"DOTA_WatchLive_ParticipantsUnranked"	"非排名"
"DOTA_WatchLive_Participants1"	"{s:friend_1}"
"DOTA_WatchLive_MatchType_MM_Kills"	"{s:game_mode}"
"DOTA_WatchLive_MatchType_MM"	"{s:game_mode}"
"DOTA_WatchLiveSpectatorFriends1"	"{g:dota_persona:spectator_friend_1}正在觀戰"
"DOTA_WatchLiveSpectatorFriends2"	"{g:dota_persona:spectator_friend_1}、{g:dota_persona:spectator_friend_2}正在觀戰"
"DOTA_WatchLiveSpectatorFriends3"	"{g:dota_persona:spectator_friend_1}、{g:dota_persona:spectator_friend_2}、{g:dota_persona:spectator_friend_3}正在觀戰"
"DOTA_WatchLiveSpectatorFriends4Plus"	"{g:dota_persona:spectator_friend_1}、{g:dota_persona:spectator_friend_2}、{g:dota_persona:spectator_friend_3}以及{i:spectator_friend_count_over_3}等好友正在觀戰"
"DOTA_WatchLiveSpectatorCount"	"觀戰人數：{i:spectator_count}"
"DOTA_WatchLive_Spectating"	"觀戰人數："
"DOTA_WatchReplays_TournamentsHeader"	"熱門的賽事場次"
"DOTA_WatchReplays_FriendsHeader"	"好友的場次"
"DOTA_WatchReplays_Popular"	"熱門場次"
"DOTA_WatchReplays_SavedForLater"	"稍後再看名單"
"DOTA_WatchReplays_ParticipantsVs"	"{s:team_1} vs {s:team_2}"
"DOTA_WatchReplays_MatchType_League"	"{s:league_name}"
"DOTA_WatchReplays_MatchType_Public"	"場次 {s:match_id} - {s:game_mode}"
"DOTA_WatchReplays_Recommendations"	"{i:recommendations}"
"DOTA_WatchReplays_Views"	"{i:views} 觀看次數"
"DOTA_WatchReplays_Price"	"{g:dota_item_price:ticket_itemdef}"
"DOTA_WatchReplays_Duration"	"{s:minutes}：{s:seconds}"
"DOTA_WatchTournaments_FeaturedTitle"	"{s:tournament_featured_title}"
"DOTA_WatchTournaments_FeaturedDates"	"{s:tournament_featured_start} - {s:tournament_featured_end}"
"DOTA_WatchTournaments_FeaturedDescription"	"{s:tournament_featured_description}"
"DOTA_WatchTournaments_FeaturedTeams"	"隊伍"
"DOTA_WatchTournaments_PrizePool"	"總獎金："
"DOTA_WatchTournaments_PrizePoolAmt"	"{s:tournament_featured_prize_pool}"
"DOTA_WatchTournaments_Purchase"	"錦標賽通行證 - {s:tournament_featured_price}"
"DOTA_WatchTournament_TournamentName"	"{s:tournament_name}"
"DOTA_WatchTournament_Price"	"{s:price}"
"DOTA_Replays_Search"	"尋找 MatchID"
"DOTA_Watch_Pending"	"等待觀看遊戲..."
"DOTA_Watch_GameServerNotFound"	"找不到主持此遊戲的伺服器。"
"DOTA_Watch_Unavailable"	"此時無法觀看此遊戲。"
"DOTA_Watch_LobbyNotFound"	"找不到大廳。"
"DOTA_Watch_MissingLeagueSubscription"	"此為需經過訂閱才能觀看的聯賽場次。"
"vs"	"VS"
"dota_matchmaking_language_title"	"選擇配對語言"
"dota_matchmaking_language_primary_label"	"您的主要配對語言為："
"dota_matchmaking_language_primary"	"{s:environment_language}"
"dota_matchmaking_language_primary_invalid"	"您的語言「{s:environment_language}」無法作為 Dota 2 的配對語言。"
"dota_matchmaking_language_english"	"英文"
"dota_matchmaking_language_russian"	"俄文"
"dota_matchmaking_language_spanish"	"西班牙文"
"dota_matchmaking_language_portuguese"	"葡萄牙文"
"GameUI_Language_English"	"英文"
"GameUI_Language_German"	"德文"
"GameUI_Language_French"	"法文"
"GameUI_Language_Italian"	"義大利文"
"GameUI_Language_Korean"	"韓文"
"GameUI_Language_Spanish"	"西班牙文"
"GameUI_Language_Simplified_Chinese"	"簡體中文"
"GameUI_Language_Traditional_Chinese"	"繁體中文"
"GameUI_Language_Russian"	"俄文"
"GameUI_Language_Thai"	"泰文"
"GameUI_Language_Japanese"	"日文"
"GameUI_Language_Portuguese"	"葡萄牙文"
"GameUI_Language_Polish"	"波蘭文"
"GameUI_Language_Danish"	"丹麥文"
"GameUI_Language_Dutch"	"荷蘭文"
"GameUI_Language_Finnish"	"芬蘭文"
"GameUI_Language_Norwegian"	"挪威文"
"GameUI_Language_Swedish"	"瑞典文"
"GameUI_Language_Hungarian"	"匈牙利文"
"GameUI_Language_Czech"	"捷克文"
"GameUI_Language_Romanian"	"羅馬尼亞文"
"GameUI_Language_Turkish"	"土耳其文"
"GameUI_Language_Brazilian"	"葡萄牙文 - 巴西"
"GameUI_Language_Bulgarian"	"保加利亞文"
"GameUI_Language_Greek"	"希臘文"
"GameUI_Language_Ukrainian"	"烏克蘭文"
"client_version_out_of_date_title"	"需要更新"
"client_version_out_of_date"	"遊戲用戶端版本已過時。請關閉並重新啟動《Dota 2》以取得最新版本。"
"dota_matchmaking_region_title"	"選擇配對地區"
"dota_matchmaking_region_auto"	"依我的位置自動選擇最佳的地區。"
"dota_matchmaking_region_select"	"選擇配對地區（最多三個），請選擇離您最近的地區以獲得最佳的遊戲體驗。"
"limited_heroes_abandon_header"	"限定英雄模式"
"limited_heroes_abandon_explanation"	"離開限定英雄模式比賽並沒有懲罰，而您的英雄將被替代為電腦玩家。離開任何其它模式比賽時可能會導致進入低優先度佇列。"
"dota_abandon_dialog_title"	"中途退出遊戲"
"dota_abandon_dialog_confirm"	"您確定要中途退出遊戲嗎？"
"dota_abandon_dialog_yes"	"是的，放棄遊戲。"
"dota_leave_dialog_title"	"離開遊戲"
"dota_leave_dialog_confirm"	"您確定您想要離開本場遊戲？"
"dota_leave_dialog_yes"	"是的，離開遊戲。"
"dota_accept_match_title"	"您的遊戲已就緒"
"dota_accept_match_readyup_title"	"等待玩家中"
"dota_accept_match_accept"	"接受"
"dota_accept_match_accept_button"	"{s:accept}"
"dota_accept_match_subtitle"	"{s:subtitle}"
"dota_finding_match_players"	"（%s1 搜尋中）"
"dota_finding_match_time"	"比賽配對尋找時間： {s:find_match_time}"
"dota_finding_match_accept_count"	"已接受比賽：{s:match_num_accepted} / {s:match_num_total}"
"dota_finding_match_generic"	"一般配對"
"dota_finding_match_ranked"	"積分配對"
"dota_finding_match_bot"	"電腦對戰"
"dota_finding_match_bot_passive"	"電腦對戰（消極）"
"dota_finding_match_bot_easy"	"電腦對戰（簡單）"
"dota_finding_match_bot_medium"	"電腦對戰（中等）"
"dota_finding_match_bot_hard"	"電腦對戰（困難）"
"dota_finding_match_bot_unfair"	"電腦對戰（變態）"
"dota_finding_match_team"	"尋找隊伍積分配對"
"dota_finding_1v1_match_casual"	"尋找 1v1 遊戲"
"dota_finding_match_practice_lobby"	"大廳遊戲"
"dota_safe_to_abandon_inline"	"遊戲已可安全離開"
"dota_match_connected"	"連線至遊戲"
"dota_match_local_game"	"連線至本機遊戲"
"dota_match_connecting"	"連線至遊戲..."
"dota_match_in_progress"	"遊戲進行中"
"dota_match_finished"	"遊戲已結束"
"matchmaking_waiting_for_players"	"等待其他玩家"
"matchmaking_player_declined"	"一位玩家取消配對"
"dota_match_wait_for_host"	"正在等待主機"
"dota_match_find_server"	"尋找伺服器"
"ranked_mmr"	"您的配對積分"
"ranked_mmr_solo_label"	"單排"
"ranked_mmr_solo_value"	"{i:solo_mmr}"
"ranked_mmr_solo_calibrating"	"待定 - 尚需進行 {i:solo_calibrating_games} 場遊戲"
"ranked_mmr_solo_no_data"	"尚需進行 {i:solo_calibrating_required_games} 場遊戲來完成積分校準"
"ranked_mmr_party_label"	"多排"
"ranked_mmr_party_value"	"{i:party_mmr}"
"ranked_mmr_party_calibrating"	"待定 - 尚需進行 {i:party_calibrating_games} 場遊戲"
"ranked_mmr_party_no_data"	"需進行 {i:party_calibrating_required_games} 場遊戲來測定積分水平"
"ranked_mmr_locked_explain"	"積分配對：\n於歷練獎盃達 50 級時解鎖。\n這是一個會為玩家計算生涯積分（MMR）的競技模式。"
"matchmaking_account_disabled"	"由於您有太多不當行為，所以您將在 %s1 內無法聊天或是加入配對佇列。"
"matchmaking_match_disabled_party"	"由於 %s1 在上一場配對拒絕就緒，所以她（他）在 %s2 內無法進行配對。"
"matchmaking_match_disabled_local"	"您在接下來的 %s1 內無法進行配對。原因是您離棄了上一場遊戲，或者是您於配對完成時未能就緒。"
"dota_play_normal_match"	"一般配對"
"dota_play_ranked_match"	"積分配對"
"dota_play_practice_1v1"	"1v1 練習"
"dota_play_practice_with_bots"	"和電腦玩家進行練習"
"dota_play_practice_1v1_playtab"	"1v1 練習"
"dota_play_1v1_desc"	"與其他玩家對抗去鍛鍊您的單中表現。遊戲隨即會在其中一方死亡兩次或者失去一座防禦塔時結束。"
"dota_play_practice_1v1_party_warning"	"進行 1v1 配對時無法使用團隊"
"dota_play_button_label"	"{s:play_button_label}"
"dota_play"	"進行遊戲"
"dota_play_searching"	"比賽配對尋找中"
"dota_play_lobby_find_server"	"尋找伺服器"
"dota_play_find_match_label"	"{s:find_match_label}"
"dota_abandon_game"	"離開遊戲"
"dota_safe_leave_game"	"離開遊戲"
"dota_disconnect"	"斷線"
"dota_play_unavailable"	"不可用"
"dota_leaver_consequence_tooltip_header"	"後果"
"dota_leaver_consequences"	"{s:leaver_consequences}"
"dota_leaver_consequences_details"	"{s:leaver_consequences_details}"
"dota_leaver_view_tooltip"	"檢視細節"
"dota_leaver_consequence_header_failure_to_reconnect"	"無法重新進行連結將會導致以下結果："
"dota_leaver_consequence_header_leave_match"	"離開比賽將會導致以下結果："
"dota_leaver_consequence_LetDownTeammates"	"您的隊友將處於劣勢。"
"dota_leaver_consequence_SmallMatchmakingCooldown"	"使您將有一段時間無法進行遊戲配對。"
"dota_leaver_consequence_CreditWithAbandon"	"將在您的生涯紀錄上計為一次中離。"
"dota_leaver_consequence_ForcedLossForLeaver"	"您的紀錄將添加一敗。"
"dota_leaver_consequence_ForcedLossForLeaversParty"	"<b>您團隊中的所有成員</b>將添加一敗。"
"dota_leaver_consequence_ForcedLossForLeaversTeam"	"<b>您的隊伍</b>「 %s1 」將獲得一敗。"
"dota_leaver_consequence_MMRLossForLeaver"	"您的配對積分（MMR）將會下降。"
"dota_leaver_consequence_MMRLossForLeaversParty"	"您團隊中<b>所有成員</b>的配對積分（MMR）將會下降。"
"dota_leaver_consequence_MMRLossForLeaversTeam"	"<b>您隊伍目前的積分</b>「%s1」將會下降。"
"dota_leaver_consequence_MatchDiscardedForOtherPlayers"	"其他玩家在本局中的成績將一併不會被列入計算。"
"dota_leaver_consequence_NotDecrementLowPriGamesRemaining"	"您在本局中的戰績將作廢。"
"dota_reconnect_popup_title"	"重新連線？"
"dota_matchmaking_regions_refresh"	"刷新延遲狀態"
"dota_matchmaking_region_ping"	"{s:region_ping}"
"dota_matchmaking_region_offline"	"離線維護中"
"dota_matchmaking_region_unknown_ping"	"延遲：未知"
"dota_matchmaking_region_ping_time"	"Ping: {i:ping_ms}ms"
"DOTA_VAC_Verification_Header"	"VALVE 反作弊系統（VAC）"
"DOTA_VAC_Verification_Header_Solo"	"您的電腦阻擋了 VALVE 反作弊系統（VAC），故遊戲無法進行配對搜場。請確保您的電腦上沒有任何程式會干擾 VAC 系統的運作以及確認 Steam 平台有正確安裝。"
"DOTA_VAC_Verification_Header_Party"	"有人的電腦阻擋了 VALVE 反作弊系統（VAC），故遊戲無法進行配對搜場。請確保您的團隊成員之中沒有人的電腦正在執行會干擾到 VAC 系統運作的程式，並且確認所有團員的 Steam 平台均有正確安裝。"
"DOTA_VAC_Verification_Button1"	"更多資訊"
"DOTA_VAC_Verification_Button2"	"關閉"
"dota_matchmaking_regions_button"	"{s:regions_selected}"
"dota_region_automatic"	"自動"
"dota_regions_selected"	"地區："
"dota_lobby_region_invalid"	"無"
"dota_play_no_language_selected"	"選擇語言"
"dota_play_language"	"{s:match_language}"
"dota_play_language_many"	"語言： {i:match_language_count}"
"dota_ready_fail"	"準備失敗"
"dota_ready_fail_desc"	"您的配對剛剛已經就緒，但您沒有做出回應因此從配對佇列中被踢出。"
"dota_all_chat_label"	"[所有人]"
"dota_chatwheel_label_Ok"	"確定"
"dota_chatwheel_label_Care"	"小心"
"dota_chatwheel_label_GetBack"	"回來"
"dota_chatwheel_label_NeedWards"	"需要守衛"
"dota_chatwheel_label_Stun"	"擊昏"
"dota_chatwheel_label_Help"	"幫我"
"dota_chatwheel_label_Push"	"推進"
"dota_chatwheel_label_GoodJob"	"幹得好"
"dota_chatwheel_label_Missing"	"失蹤"
"dota_chatwheel_label_Missing_Top"	"上路失蹤"
"dota_chatwheel_label_Missing_Mid"	"中路失蹤"
"dota_chatwheel_label_Missing_Bottom"	"下路失蹤"
"dota_chatwheel_label_Go"	"走！"
"dota_chatwheel_label_Initiate"	"發動先手！"
"dota_chatwheel_label_Follow"	"跟隨我"
"dota_chatwheel_label_Group_Up"	"快組隊"
"dota_chatwheel_label_Spread_Out"	"分散站位"
"dota_chatwheel_label_Split_Farm"	"分頭農兵去"
"dota_chatwheel_label_Attack"	"現在攻擊！"
"dota_chatwheel_label_BRB"	"我很快回來"
"dota_chatwheel_label_Dive"	"快衝！"
"dota_chatwheel_label_OMW"	"正在前往"
"dota_chatwheel_label_Get_Ready"	"準備好"
"dota_chatwheel_label_Bait"	"誘餌"
"dota_chatwheel_label_Heal"	"需要治療"
"dota_chatwheel_label_Mana"	"需要魔力"
"dota_chatwheel_label_OOM"	"魔力用罄"
"dota_chatwheel_label_Skill_Cooldown"	"冷卻中"
"dota_chatwheel_label_Ulti_Ready"	"大招準備好了"
"dota_chatwheel_label_Enemy_Returned"	"敵人回來了"
"dota_chatwheel_label_All_Missing"	"全部失蹤"
"dota_chatwheel_label_Enemy_Incoming"	"敵人來襲"
"dota_chatwheel_label_Invis_Enemy"	"隱形敵人"
"dota_chatwheel_label_Enemy_Had_Rune"	"敵人拿取了神符"
"dota_chatwheel_label_Split_Push"	"分開推進"
"dota_chatwheel_label_Coming_To_Gank"	"我要來偷襲"
"dota_chatwheel_label_Request_Gank"	"需要偷襲"
"dota_chatwheel_label_Fight_Under_Tower"	"回到塔下"
"dota_chatwheel_label_Deny_Tower"	"反補防禦塔"
"dota_chatwheel_label_Buy_Courier"	"購買信使"
"dota_chatwheel_label_Upgrade_Courier"	"升級信使"
"dota_chatwheel_label_Need_Detection"	"我們需要反隱"
"dota_chatwheel_label_They_Have_Detection"	"他們能夠反隱"
"dota_chatwheel_label_Buy_TP"	"購買傳送卷軸"
"dota_chatwheel_label_Reuse_Courier"	"請重新使用信使"
"dota_chatwheel_label_Deward"	"來反眼"
"dota_chatwheel_label_Building_Mek"	"我來出梅肯"
"dota_chatwheel_label_Building_Pipe"	"我來做菸斗"
"dota_chatwheel_label_Stack_And_Pull"	"堆野拉野"
"dota_chatwheel_label_Pull"	"請拉野"
"dota_chatwheel_label_Pulling"	"我在拉野"
"dota_chatwheel_label_Stack"	"請堆野"
"dota_chatwheel_label_Jungling"	"我在打野"
"dota_chatwheel_label_Roshan"	"羅煞"
"dota_chatwheel_label_Affirmative"	"了解"
"dota_chatwheel_label_Wait"	"等一下"
"dota_chatwheel_label_Pause"	"暫停"
"dota_chatwheel_label_Current_Time"	"目前時間"
"dota_chatwheel_label_Check_Runes"	"檢查神符"
"dota_chatwheel_label_Smoke_Gank"	"開霧gank!"
"dota_chatwheel_label_GLHF"	"祝您好運"
"dota_chatwheel_label_Nice"	"幹得漂亮"
"dota_chatwheel_label_Thanks"	"謝謝"
"dota_chatwheel_label_Sorry"	"抱歉"
"dota_chatwheel_label_No_Give_Up"	"不要放棄"
"dota_chatwheel_label_Just_Happened"	"你沒看錯"
"dota_chatwheel_label_Game_Is_Hard"	"這遊戲真難玩"
"dota_chatwheel_label_New_Meta"	"變更戰術"
"dota_chatwheel_label_My_Bad"	"我的錯"
"dota_chatwheel_label_Regret"	"後悔"
"dota_chatwheel_label_Relax"	"放輕鬆"
"dota_chatwheel_label_GG"	"GG"
"dota_chatwheel_label_GGWP"	"GGWP"
"dota_chatwheel_label_All_GG"	"(所有人) GG"
"dota_chatwheel_label_All_GGWP"	"(所有人) GGWP"
"dota_chatwheel_label_What_To_Buy"	"我該買什麼？"
"dota_chatwheel_label_Im_Retreating"	"我正在撤退"
"dota_chatwheel_label_Space_Created"	"已製造出空間"
"dota_chatwheel_label_Whoops"	"哎呀"
"dota_chatwheel_label_Tower_then_Back"	"拆完防禦塔後就撤退"
"dota_chatwheel_label_Barracks_then_Back"	"推一下兵營然後撤退"
"dota_chatwheel_label_Ward_Bottom_Rune"	"下路神符插眼"
"dota_chatwheel_label_Ward_Top_Rune"	"上路神符插眼"
"dota_chatwheel_label_Zeus_Ult"	"宙斯大招"
"dota_chatwheel_header_positioning"	"正在路上"
"dota_chatwheel_header_status"	"狀態"
"dota_chatwheel_header_enemy"	"敵人"
"dota_chatwheel_header_lane"	"對線"
"dota_chatwheel_header_items"	"物品"
"dota_chatwheel_header_neutrals"	"中立生物"
"dota_chatwheel_header_misc"	"其它"
"dota_chatwheel_header_flavor"	"情感"
"dota_chatwheel_message_Ok"	"好吧。"
"dota_chatwheel_message_Care"	"小心!"
"dota_chatwheel_message_GetBack"	"後退！"
"dota_chatwheel_message_NeedWards"	"我們需要守衛。"
"dota_chatwheel_message_Stun"	"現在擊昏!"
"dota_chatwheel_message_Help"	"幫我！"
"dota_chatwheel_message_Push"	"現在推進"
"dota_chatwheel_message_GoodJob"	"幹得好!"
"dota_chatwheel_message_Missing"	"失蹤!"
"dota_chatwheel_message_Missing_Top"	"上路失蹤!"
"dota_chatwheel_message_Missing_Mid"	"中路失蹤!"
"dota_chatwheel_message_Missing_Bottom"	"下路失蹤!"
"dota_chatwheel_message_Go"	"上！"
"dota_chatwheel_message_Initiate"	"開戰！"
"dota_chatwheel_message_Follow"	"跟隨我"
"dota_chatwheel_message_Group_Up"	"抱團集合"
"dota_chatwheel_message_Spread_Out"	"散開"
"dota_chatwheel_message_Split_Farm"	"分頭農兵"
"dota_chatwheel_message_Attack"	"現在攻擊！"
"dota_chatwheel_message_BRB"	"我馬上回來"
"dota_chatwheel_message_Dive"	"塔殺！"
"dota_chatwheel_message_OMW"	"我正趕來"
"dota_chatwheel_message_Get_Ready"	"準備好"
"dota_chatwheel_message_Bait"	"誘餌"
"dota_chatwheel_message_Heal"	"需要治療"
"dota_chatwheel_message_Mana"	"需要魔力"
"dota_chatwheel_message_OOM"	"我的魔力用完了"
"dota_chatwheel_message_Skill_Cooldown"	"技能冷卻中"
"dota_chatwheel_message_Ulti_Ready"	"大招準備好了"
"dota_chatwheel_message_Enemy_Returned"	"敵人回來了"
"dota_chatwheel_message_All_Missing"	"所有敵方英雄失蹤！"
"dota_chatwheel_message_Enemy_Incoming"	"敵人來襲！"
"dota_chatwheel_message_Invis_Enemy"	"附近有隱身英雄！"
"dota_chatwheel_message_Enemy_Had_Rune"	"敵方有神符"
"dota_chatwheel_message_Split_Push"	"分頭推進"
"dota_chatwheel_message_Coming_To_Gank"	"來抓人"
"dota_chatwheel_message_Request_Gank"	"需要抓人"
"dota_chatwheel_message_Fight_Under_Tower"	"塔下開戰"
"dota_chatwheel_message_Deny_Tower"	"反補防禦塔！"
"dota_chatwheel_message_Buy_Courier"	"請購買信使"
"dota_chatwheel_message_Upgrade_Courier"	"有人可以幫忙升級一下信使嗎？"
"dota_chatwheel_message_Need_Detection"	"我們需要偵查"
"dota_chatwheel_message_They_Have_Detection"	"他們有視野"
"dota_chatwheel_message_Buy_TP"	"去買張傳送卷軸吧"
"dota_chatwheel_message_Reuse_Courier"	"請繼續使用信使"
"dota_chatwheel_message_Deward"	"請拆眼"
"dota_chatwheel_message_Building_Mek"	"正在做梅肯斯姆"
"dota_chatwheel_message_Building_Pipe"	"正在做洞察菸斗"
"dota_chatwheel_message_Stack_And_Pull"	"請堆野拉野"
"dota_chatwheel_message_Pull"	"請拉野怪，謝謝"
"dota_chatwheel_message_Pulling"	"拉野怪中"
"dota_chatwheel_message_Stack"	"請堆疊野怪營地"
"dota_chatwheel_message_Jungling"	"打野中"
"dota_chatwheel_message_Roshan"	"羅煞"
"dota_chatwheel_message_Affirmative"	"了解"
"dota_chatwheel_message_Wait"	"等等"
"dota_chatwheel_message_Pause"	"暫停一下！"
"dota_chatwheel_message_Current_Time"	"目前遊戲時間"
"dota_chatwheel_message_Check_Runes"	"請去檢查一下河道神符"
"dota_chatwheel_message_Smoke_Gank"	"一起來開霧gank！"
"dota_chatwheel_message_GLHF"	"祝大家玩得愉快"
"dota_chatwheel_message_Nice"	"不錯"
"dota_chatwheel_message_Thanks"	"謝謝！"
"dota_chatwheel_message_Sorry"	"抱歉"
"dota_chatwheel_message_No_Give_Up"	"不要放棄！"
"dota_chatwheel_message_Just_Happened"	"你沒看錯，剛那件事情的確發生了"
"dota_chatwheel_message_Game_Is_Hard"	"這場是個硬仗"
"dota_chatwheel_message_New_Meta"	"變更戰術"
"dota_chatwheel_message_My_Bad"	"我的錯"
"dota_chatwheel_message_Regret"	"我才下手就立刻後悔了"
"dota_chatwheel_message_Relax"	"放心，你做得很好"
"dota_chatwheel_message_MissingHero"	"%s1 失蹤！"
"dota_chatwheel_message_ReturnedHero"	"%s1 已經迴歸！"
"dota_chatwheel_message_GG"	"Good game"
"dota_chatwheel_message_GGWP"	"這場打得過癮，大家都表現不錯"
"dota_chatwheel_message_All_GG"	"Good game"
"dota_chatwheel_message_All_GGWP"	"這場打得過癮，大家都表現不錯"
"dota_chatwheel_message_What_To_Buy"	"我該買什麼？"
"dota_chatwheel_message_Im_Retreating"	"我正在撤退"
"dota_chatwheel_message_Space_Created"	"已製造出空間"
"dota_chatwheel_message_Whoops"	"哎呀"
"dota_chatwheel_message_Tower_then_Back"	"摧毀防禦塔然後撤退"
"dota_chatwheel_message_Barracks_then_Back"	"摧毀兵營然後撤退"
"dota_chatwheel_message_Ward_Bottom_Rune"	"請在下路神符插眼"
"dota_chatwheel_message_Ward_Top_Rune"	"請在上路神符插眼"
"dota_chatwheel_message_Zeus_Ult"	"宙斯快放大招！"
"dota_settings_hotkeys"	"快捷鍵"
"dota_settings_options"	"選項"
"dota_settings_audio"	"音訊"
"dota_settings_voice"	"語音"
"dota_settings_volume"	"音量"
"dota_settings_video"	"視訊"
"dota_settings_resetkeys"	"重設快捷鍵..."
"dota_settings_legacykeys"	"使用舊版按鍵"
"dota_settings_abilities"	"技能"
"dota_settings_abilities_hero"	"英雄"
"dota_settings_abilities_neutrals"	"中立生物"
"dota_settings_abilities_courier"	"信使"
"dota_settings_abilities_primary1"	"1"
"dota_settings_abilities_primary2"	"2"
"dota_settings_abilities_primary3"	"3"
"dota_settings_abilities_secondary1"	"4"
"dota_settings_abilities_secondary2"	"5"
"dota_settings_abilities_neutral1"	"1"
"dota_settings_abilities_neutral2"	"2"
"dota_settings_abilities_neutral3"	"3"
"dota_settings_abilities_neutral4"	"4"
"dota_settings_abilities_courier1"	"1"
"dota_settings_abilities_courier2"	"2"
"dota_settings_abilities_courier3"	"3"
"dota_settings_abilities_courier4"	"4"
"dota_settings_abilities_courier5"	"5"
"dota_settings_abilities_courier6"	"6"
"dota_settings_abilities_ultimate"	"U"
"dota_settings_cast"	"施放"
"dota_settings_autocast"	"自動施放"
"dota_settings_quickcast"	"快速施放"
"dota_settings_mirror"	"複製英雄頁面的快捷鍵設定"
"dota_settings_abilitylearn"	"學習技能"
"dota_settings_upgradestats"	"升級狀態"
"dota_settings_unitactions"	"單位動作"
"dota_settings_attack"	"移動攻擊/強制攻擊"
"dota_settings_move"	"移動"
"dota_settings_stop"	"停止"
"dota_settings_holdposition"	"堅守原位"
"dota_settings_selecthero"	"選擇英雄"
"dota_settings_selectall"	"選擇所有單位"
"dota_settings_selectallothers"	"選擇所有其它單位"
"dota_settings_selectcourier"	"選擇信使"
"dota_settings_courierdeliver"	"信使遞送物品"
"dota_settings_courierhaste"	"信使爆衝"
"dota_settings_useactionitem"	"動作物品"
"dota_settings_herotaunt"	"嘲諷物品"
"dota_settings_items"	"物品"
"dota_settings_openshop"	"開啟商店"
"dota_settings_purchasequickbuy"	"快速購買"
"dota_settings_purchasesticky"	"固定購買"
"dota_settings_grabstashitems"	"取回貯藏庫物品"
"dota_settings_camera"	"鏡頭"
"dota_settings_cameraactions"	"鏡頭動作"
"dota_settings_cameraup"	"鏡頭前移"
"dota_settings_cameradown"	"鏡頭後移"
"dota_settings_cameraleft"	"鏡頭左移"
"dota_settings_cameraright"	"鏡頭右移"
"dota_settings_cameragrip"	"鏡頭控制"
"dota_settings_recentevent"	"顯示最近活動"
"dota_settings_inspectheroinworld"	"展示視角"
"dota_settings_chat"	"聊天"
"dota_settings_phrases"	"常用語"
"dota_settings_chatwheel_page"	"聊天輪盤"
"dota_settings_chatteam"	"聊天（團隊）"
"dota_settings_chatglobal"	"聊天（所有人）"
"dota_settings_chatvoice_party"	"語音（隊伍）"
"dota_settings_chatvoice_team"	"語音（團隊）"
"dota_settings_chatwheel_show"	"聊天輪盤"
"dota_settings_playeractions"	"玩家動作"
"dota_settings_activateglyph"	"啟動浮雕"
"dota_settings_scoreboardtoggle"	"記分板"
"dota_settings_pause"	"暫停"
"dota_settings_screenshot"	"螢幕擷圖"
"dota_settings_console"	"命令列"
"dota_settings_controlgroups"	"控制群組"
"dota_settings_controlgroupsadditional"	"更多控制群組"
"dota_settings_controlgroupcycle"	"切換控制群組"
"dota_settings_group1"	"控制組 1"
"dota_settings_group2"	"控制組 2"
"dota_settings_group3"	"控制組 3"
"dota_settings_group4"	"控制組 4"
"dota_settings_group5"	"控制組 5"
"dota_settings_group6"	"控制組 6"
"dota_settings_group7"	"控制組 7"
"dota_settings_group8"	"控制組 8"
"dota_settings_group9"	"控制組 9"
"dota_settings_group10"	"控制組 10"
"dota_settings_advancedpanel_goto"	"進階"
"dota_settings_standardpanel_goto"	"標準"
"dota_settings_spectatorandreplay"	"觀眾/重播控制"
"dota_settings_spectatorcameraup"	"觀眾鏡頭前移"
"dota_settings_spectatorcameradown"	"觀眾鏡頭後移"
"dota_settings_spectatorcameraleft"	"觀眾鏡頭左移"
"dota_settings_spectatorcameraright"	"觀眾鏡頭右移"
"dota_settings_spectatorcameragrip"	"觀眾鏡頭控制"
"dota_settings_spectatorpause"	"觀眾暫停"
"dota_settings_spectatorchat"	"觀眾聊天"
"dota_settings_spectatorscoreboard"	"觀眾記分板"
"dota_settings_spectatorbroadcastermenu"	"開啟導播選單"
"dota_settings_spectatorincreasereplayspeed"	"加快重播速度"
"dota_settings_spectatordecreasereplayspeed"	"減緩重播速度"
"dota_settings_spectatorstatsharvest"	"觀眾結果統計資料"
"dota_settings_spectatorstatsitem"	"觀眾物品統計資料"
"dota_settings_spectatorstatsgold"	"觀眾金錢圖表"
"dota_settings_spectatorstatsxp"	"觀眾經驗值圖表"
"dota_settings_spectatorstatsfantasy"	"觀眾夢幻統計資料"
"dota_settings_spectatorfowboth"	"觀眾雙方戰場迷霧"
"dota_settings_spectatorfowradient"	"觀眾聖輝戰場迷霧"
"dota_settings_spectatorfowdire"	"觀眾魔魘戰場迷霧"
"dota_settings_statsdropdown"	"統計資料列表"
"dota_settings_spectatordropdown_sort"	"變更分類"
"dota_settings_spectatordropdown_close"	"清除分類"
"dota_settings_spectatordropdown_kda"	"擊殺/死亡/助攻"
"dota_settings_spectatordropdown_lasthits_denies"	"正補/反補"
"dota_settings_spectatordropdown_level"	"英雄等級"
"dota_settings_spectatordropdown_gold"	"目前金錢"
"dota_settings_spectatordropdown_totalgold"	"資產淨值"
"dota_settings_spectatordropdown_gold_per_min"	"每分鐘賺取金錢"
"dota_settings_spectatordropdown_buyback"	"買活狀態"
"dota_settings_spectatordropdown_fantasy"	"夢幻點數得分"
"dota_settings_coaching"	"教練"
"dota_settings_or"	"或"
"dota_settings_cancel"	"取消"
"dota_settings_apply"	"套用"
"dota_settings_game"	"遊戲"
"dota_settings_autoattack"	"自動攻擊"
"dota_settings_attackafterspell"	"施法後自動攻擊"
"dota_settings_autopurchase"	"自動購買物品"
"dota_settings_autoselect"	"自動選擇召喚單位"
"dota_settings_doubletapself"	"雙擊對自身施法"
"dota_settings_unifiedorders"	"統一單位命令"
"dota_settings_teleportrequireshalt"	"僅有停止鍵能中斷傳送"
"dota_settings_herofinder"	"按住 Alt 顯示英雄標識"
"dota_settings_alwaysshownames"	"生命值條上顯示玩家名稱"
"dota_settings_showhitpoints"	"顯示生命值條上方顯示生命值"
"dota_settings_forceshophotkeys"	"永遠使用快捷鍵購物"
"dota_settings_usebroadcastermenu"	"使用播報員狀態列"
"dota_settings_colorblind"	"色盲模式"
"dota_settings_reducedflash"	"降低發光特效的程度"
"dota_settings_minimap"	"小地圖"
"dota_settings_minimapsimplecolors"	"小地圖色彩簡化"
"dota_settings_minimaphidebackground"	"隱藏小地圖背景"
"dota_settings_cameradecel"	"鏡頭減速"
"dota_settings_cameraspeed"	"鏡頭速度"
"dota_settings_camerareversegrip"	"鏡頭反轉控制"
"dota_settings_cameraedgepan"	"邊緣搖攝"
"dota_settings_camerascreenshake"	"啟用螢幕晃動"
"dota_settings_cameraresetonspawn"	"重生時移動鏡頭"
"dota_settings_cameradeadcolorshift"	"畫面會於英雄死亡期間呈現黑白色"
"dota_settings_profile"	"個人檔案"
"dota_settings_hideprofile"	"隱藏 Dota 和 Steam 個人檔案"
"dota_settings_allowtradeinvitesheader"	"交易邀請來自："
"dota_settings_trade_friends"	"僅限好友"
"dota_settings_trade_anyone"	"任何人"
"dota_settings_network"	"網路"
"dota_settings_networkquality"	"網路品質"
"dota_settings_networkquality_low"	"低"
"dota_settings_networkquality_high"	"高"
"dota_settings_usenativeresolution"	"使用我的螢幕目前的解析度"
"dota_settings_customresolution"	"使用進階設定"
"dota_settings_resolution"	"解析度"
"dota_settings_rendering"	"渲染"
"dota_settings_aspectratio"	"解析度比例"
"dota_settings_aspectratio43"	"4:3"
"dota_settings_aspectratio169"	"16:9"
"dota_settings_aspectratio1610"	"16:10"
"dota_settings_resolution_size"	"大小"
"dota_settings_resolution_display_mode"	"顯示模式"
"dota_settings_fullscreen"	"全螢幕"
"dota_settings_window"	"視窗化"
"dota_settings_borderless"	"無邊視窗"
"dota_settings_videodefaults"	"視訊預設值"
"dota_settings_basicvideosettings"	"使用基本設定"
"dota_settings_fastestvideo"	"效能需求最低"
"dota_settings_appearancevideo"	"畫面最好（效能需求最高）"
"dota_settings_advancedvideosettings"	"使用進階設定"
"dota_settings_antialiasing"	"反鋸齒"
"dota_settings_specular"	"鏡面"
"dota_settings_bloom"	"鏡面光暈"
"dota_settings_waterquality"	"高品質水面"
"dota_settings_fog"	"環境煙霧"
"dota_settings_animateportrait"	"動態肖像"
"dota_settings_additivelight"	"累加式光傳遞"
"dota_settings_worldlight"	"地圖光效"
"dota_settings_ambientocclusion"	"環境遮蔽"
"dota_settings_ambientcreatures"	"環境生物"
"dota_settings_normal_maps"	"法線貼圖"
"dota_settings_vsync"	"垂直同步"
"dota_settings_shadowquality"	"陰影品質"
"dota_settings_shadowquality_low"	"低"
"dota_settings_shadowquality_med"	"中"
"dota_settings_shadowquality_high"	"高"
"dota_settings_texturequality"	"材質品質"
"dota_settings_texturequality_low"	"低"
"dota_settings_texturequality_med"	"中"
"dota_settings_texturequality_high"	"高"
"dota_settings_mastervolume"	"主音量"
"dota_settings_gamevolume"	"遊戲音效"
"dota_settings_musicvolume"	"音樂"
"dota_settings_voicevolume"	"語音"
"dota_settings_gamevoicevolume"	"單位語音"
"dota_settings_openmic"	"啟用麥克風自動收音和團隊成員溝通"
"dota_settings_openmicthreshold"	"自動收音音量門檻"
"dota_settings_audiodefaults"	"音訊預設值"
"dota_settings_defaultaudio"	"預設"
"dota_settings_sounddevice"	"播放裝置："
"dota_settings_speakerconfig"	"喇叭設定："
"dota_settings_headphones"	"耳機"
"dota_settings_2speakers"	"2 聲道"
"dota_settings_4speakers"	"4 聲道"
"dota_settings_5speakers"	"5.1 聲道"
"dota_settings_7speakers"	"7.1 聲道"
"dota_settings_captions"	"使用字幕"
"dota_settings_playsoundinbackground"	"切換桌面後仍播放音效"
"dota_settings_chatsounds"	"聊天訊息音效"
"dota_settings_mutecobroadcasters"	"將聯合導播員靜音"
"dota_settings_highqualityaudio"	"高品質音訊"
"dota_settings_unitspeeh"	"單位語音"
"dota_settings_unitspeech_off"	"關"
"dota_settings_unitspeech_events"	"活動"
"dota_settings_unitspeech_all"	"全時間"
"OS_Default_Device"	"預設裝置"
"DOTA_Keybind_ARROW"	"方向鍵（預設）"
"DOTA_Keybind_WASD"	"WASD"
"DOTA_Keybind_MMO"	"MMO"
"DOTA_Keybind_LEGACY"	"舊版按鍵"
"DOTA_Keybind_LOL"	"League of Legends"
"DOTA_Keybind_HON"	"Heroes of Newerth"
"DOTA_Keybind_SMITE"	"Smite"
"DOTA_Hotkeys_Tooltip_LearnAbility"	"這個是當您有技能點數可花費時讓您進入技能升級模式的快捷鍵。在升級模式之下技能的升級動作會覆蓋掉施放動作。"
"DOTA_Hotkeys_Tooltip_LearnStats"	"用於投資技能點數到角色屬性的快捷鍵。（每點技能點數可使角色的力敏智三大屬性各提升兩點）"
"DOTA_Hotkeys_Tooltip_HeroAttack"	"移動到指定地點並嘗試攻擊沿途上遇見的敵方目標 / 若目標可以反補的話就予其攻擊。"
"DOTA_Hotkeys_Tooltip_HeroMove"	"往指定地點進行移動，或者跟隨指定的友方單位。"
"DOTA_Hotkeys_Tooltip_HeroStop"	"用於中止角色的當下動作。"
"DOTA_Hotkeys_Tooltip_HeroHold"	"用於中止角色的當下動作並令其堅守原位。"
"DOTA_Hotkeys_Tooltip_HeroSelect"	"選擇您的英雄。"
"DOTA_Hotkeys_Tooltip_SelectAll"	"選取所有可控制單位。"
"DOTA_Hotkeys_Tooltip_SelectAllOthers"	"選取所有可控制單位，英雄除外。"
"DOTA_Hotkeys_Tooltip_CourierSelect"	"選擇信使。"
"DOTA_Hotkeys_Tooltip_CourierDeliver"	"命令信使將您貯藏庫內的物品送來給您。"
"DOTA_Hotkeys_Tooltip_CourierHaste"	"在技能就緒時啟動信使的加速技能。"
"DOTA_Hotkeys_Tooltip_UseActionItem"	"使用動作物品。"
"DOTA_Hotkeys_Tooltip_HeroTaunt"	"使用您英雄的嘲諷動作。嘲諷動作是種可裝備的物品。"
"DOTA_Hotkeys_Tooltip_ShopToggle"	"開啟商店選單。"
"DOTA_Hotkeys_Tooltip_PurchaseQuickbuy"	"此快捷鍵讓您能單鍵購買在快速購買區塊中呈第一順位的裝備。"
"DOTA_Hotkeys_Tooltip_PurchaseSticky"	"此快捷鍵是用於單鍵購買釘選在固定區塊中的物品。"
"DOTA_Hotkeys_Tooltip_GrabStashItems"	"將您貯藏庫內的所有物品轉移到您的英雄身上。"
"DOTA_Hotkeys_Tooltip_RecentEvent"	"迅速將鏡頭移動到最近活動的發生位置。"
"DOTA_Hotkeys_Tooltip_InspectHeroInWorld"	"切換成供您詳細檢視單位的近距離視角。"
"DOTA_Hotkeys_Tooltip_ChatTeam"	"向全部隊友發送訊息。"
"DOTA_Hotkeys_Tooltip_ChatGlobal"	"用於發送訊息給當下遊戲中的所有人。（此快捷鍵的使用將須要配合按住左 Shift 鍵）"
"DOTA_Hotkeys_Tooltip_ChatWheel"	"展開聊天輪盤並選擇輪盤上所提供的泛用語去傳遞簡便訊息。"
"DOTA_Hotkeys_Tooltip_CameraGrip"	"按住此鍵並拖拽畫面方可移動鏡頭。此功能同時也綁定於滑鼠中鍵。"
"DOTA_Hotkeys_Tooltip_ActivateGlyph"	"啟動防禦浮雕來讓我方建築物進入為期 5 秒的無敵狀態。"
"DOTA_Hotkeys_Tooltip_ScoreboardToggle"	"開啟遊戲中的記分板。"
"DOTA_Hotkeys_Tooltip_Pause"	"此快捷鍵將會用來暫停，以及恢復遊戲的進行。"
"DOTA_Hotkeys_Tooltip_ScreenshotSettings"	"將遊戲的當下畫面擷取成圖片。"
"DOTA_Hotkeys_Tooltip_Console"	"開啟命令列。（僅建議進階使用者使用）"
"DOTA_Hotkeys_Tooltip_ControlGroupCycle"	"用於在各個控制組間進行選取切換。"
"DOTA_Hotkeys_Tooltip_Group"	"用於迅速選擇一組單位。編組方法為：選擇若干單位，按住「Ctrl」鍵和其中一個控制組的快捷鍵。"
"DOTA_Hotkeys_Tooltip_Legacy"	"使用 Dota 傳統快捷鍵設定；各英雄快捷鍵不盡相同。"
"DOTA_Hotkeys_Tooltip_Quickcast"	"快速施放技能鍵會隨即在您按下該快捷鍵之後，朝您滑鼠所在位置施放該技能。"
"DOTA_Hotkeys_Tooltip_Autocast"	"開啟/關閉技能是否要在備妥時自動施放。此設定僅對一部份的技能有效。"
"DOTA_Hotkeys_Tooltip_Cast"	"用於施放英雄技能的快捷鍵。"
"DOTA_Hotkeys_Tooltip_ItemCast"	"對應著各個裝備欄的快捷鍵。"
"DOTA_Hotkeys_Tooltip_ItemQuickcast"	"快速施放物品鍵會隨即在您按下該快捷鍵之後，朝您游標的所在位置施放與該快捷鍵對應的裝備。"
"DOTA_Settings_Tooltip_Autoattack"	"自動靠近並攻擊附近敵人。"
"DOTA_Settings_Tooltip_AutoattackAfterSpell"	"若不勾選，英雄在施放完法術及技能後會停在原地待命。"
"DOTA_Settings_Tooltip_AutoPurchase"	"當建議出裝表的下一個物品可負擔時就自動購買。"
"DOTA_Settings_Tooltip_AutoSelectSummons"	"當新單位被英雄召喚出來時會自動被加入您的選取組。"
"DOTA_Settings_Tooltip_DoubleTap"	"對圖示以滑鼠游標迅速進行雙擊，或迅速雙擊熱鍵即可將所對應的技能或物品朝自己施放。"
"DOTA_Settings_Tooltip_UnifiedOrders"	"按住 Ctrl 不放並下達指令可同時下令給所有您可操控的單位。"
"DOTA_Settings_Tooltip_TeleportStop"	"下達移動命令或嘗試施放技能皆不會中斷尚在施放中的傳送卷軸。此設定僅對傳送卷軸或者遠行靴有效。"
"DOTA_Settings_Tooltip_BroadcasterStats"	"當旁觀遊戲時，顯示轉播員使用的戰況資訊欄。"
"DOTA_Settings_Tooltip_Deceleration"	"這是視角在停止推移後需要多久才會完全煞停的速度。此設定數值越高視角就會越快停下。"
"DOTA_Settings_Tooltip_Screenshake"	"使某些技能或暈眩效果搖動你的視角。"
"DOTA_Settings_Tooltip_CameraRespawn"	"讓視角會隨即在英雄重生時自動回歸到英雄身上。"
"DOTA_Settings_Tooltip_HideProfile"	"您的 Dota 2 個人檔案將不會被任何人看見。且您的 Steam 個人檔案頁面也不會被任何人從 Dota 2 中進入。"
"DOTA_Settings_Tooltip_ShareMatchData"	"將您的對戰資料公開給第三方網站存取。"
"DOTA_Settings_Tooltip_NetworkQuality"	"如果您的網路品質不是那麼好，選擇此設定中的「低」將有助改善您在遊戲中的連線品質。"
"DOTA_Settings_Tooltip_MinimapSimple"	"小地圖的標記顏色以陣營區分，而非以個別玩家顏色區分。"
"DOTA_Settings_Tooltip_MinimapNamesIcon"	"在小地圖中保持顯示英雄圖示或者英雄名稱，且會讓它們在按住左「 Alt 」鍵時暫時改為顯示 X 或 O 記號。"
"DOTA_Settings_Tooltip_ShopHotkeys"	"商店的熱鍵，在商店選單展開期間將會覆蓋掉任何其它綁定的熱鍵功能。"
"DOTA_create_bot_practice_desc"	"與電腦玩家進行對抗。您可以通過配對系統尋找其他玩家並肩作戰，或以電腦玩家填滿己方隊伍的空缺。"
"DOTA_Lobby_BotDifficulty"	"電腦玩家難度"
"DOTA_Lobby_BotDifficulty_no_bot"	"無電腦玩家"
"DOTA_Lobby_BotDifficulty_passive"	"消極"
"DOTA_Lobby_BotDifficulty_easy"	"簡單"
"DOTA_Lobby_BotDifficulty_medium"	"中等"
"DOTA_Lobby_BotDifficulty_hard"	"困難"
"DOTA_Lobby_BotDifficulty_unfair"	"變態"
"DOTA_Lobby_BotTeam"	"選擇陣營"
"DOTA_create_bot_practice_solo"	"單人"
"DOTA_create_bot_practice_solo_desc"	"直接進行一場與電腦對抗的練習遊戲。不使用配對功能，而您也可隨時離開。"
"DOTA_create_bot_practice_coop"	"多人合作"
"DOTA_create_bot_practice_coop_desc"	"以配對功能和其他玩家一起對抗電腦。<font color='#dd6666'>注意：</font>中途退場會招致懲罰。"
"DOTA_Lobby_BotDifficulty_bot_passive"	"消極電腦"
"DOTA_Lobby_BotDifficulty_bot_easy"	"簡單電腦"
"DOTA_Lobby_BotDifficulty_bot_medium"	"中等電腦"
"DOTA_Lobby_BotDifficulty_bot_hard"	"困難電腦"
"DOTA_Lobby_BotDifficulty_bot_unfair"	"變態電腦"
"dota_lobby_title"	"- 遊戲大廳"
"dota_lobby_title_default"	"大廳"
"lobby_row_player_name"	"{s:player_name}"
"dota_lobby_row_game_name"	"{s:game_name}"
"dota_lobby_row_slots"	"{s:slots}"
"dota_lobby_row_game_mode"	"{s:game_mode}"
"dota_lobby_row_join"	"加入"
"dota_lobby_row_leave"	"離開"
"dota_lobby_coaches_title"	"教練"
"dota_lobby_browser_all_game_modes"	"所有遊戲模式"
"dota_lobby_browser_title"	"瀏覽 Dota 大廳"
"dota_lobby_browser_no_lobbies"	"找不到大廳"
"dota_lobby_browser_no_matching_lobbies"	"找不到符合您搜尋條件的大廳"
"dota_lobby_browser_updating"	"更新大廳列表..."
"dota_lobby_browser_search_placeholder"	"搜尋大廳"
"dota_lobby_browser_game_mode"	"遊戲模式"
"dota_lobby_browser_refresh"	"重新整理"
"dota_lobby_browser_filter_title"	"篩選大廳"
"dota_lobby_submit_filter"	"提交"
"dota_popup_lobby_password_title"	"輸入大廳密碼"
"DOTA_AttackCapability_Melee"	"近程"
"DOTA_AttackCapability_Ranged"	"遠程"
"DOTA_Item_OnMarket"	"市集"
"DOTA_Items_DefaultSet"	"預設套裝"
"DOTA_Items_SetEquipped_Label"	"裝備中"
"DOTA_EquippedItem_Label"	"裝備中"
"DOTA_PreviewingItem_Label"	"預覽中"
"DOTA_EquippedItem_Rarity"	"{s:equipped_econ_set_rarity}"
"DOTA_EquippedItem_SetName"	"{s:equipped_econ_set_name}"
"DOTA_EquippedItem_DefaultSet"	"預設套裝"
"DOTA_EquippedItem_PartialSet"	"部份套裝"
"DOTA_EquippedItem_Style"	"{i:equipped_econ_set_style_count} 風格"
"DOTA_EquippedItem_Button_Details"	"{s:equipped_details_button_text}"
"DOTA_EquippedItem_Customize"	"自訂"
"DOTA_EquippedItem_CustomSet"	"自訂套裝"
"DOTA_EquippedItem_Equip"	"裝備"
"DOTA_EquippedItem_Purchase_Button"	"購買"
"DOTA_EquippedItem_Marketplace_Button"	"市集"
"DOTA_EquippedItem_BundleName"	"包含在同捆包「{s:equipped_econ_set_bundle}」內"
"DOTA_EquippedItem_FilterText"	"預覽中"
"DOTA_EquippedItem_SaleAmount"	"-{i:equipped_econ_set_sale_amount}%"
"DOTA_EquippedItem_RegularSetPrice"	"{s:equipped_econ_regular_set_price}"
"DOTA_EquippedItem_SetPrice"	"{s:equipped_econ_set_price}"
"DOTA_EquippedItem_TreasurePrice"	"{s:equipped_econ_treasure_price}"
"DOTA_EquippedItem_Bundle"	"同捆包"
"DOTA_EquippedItem_ItemSet"	"套裝"
"DOTA_EquippedItem_Item"	"物品"
"DOTA_EconItemSet_Name"	"{s:econ_set_name}"
"DOTA_EconItemSet_Rarity"	"{s:econ_set_rarity}"
"DOTA_EconItemSet_Status"	"{s:econ_set_status}"
"DOTA_EconItemSet_Price"	"{s:econ_set_price}"
"DOTA_EconItemSet_SaleAmount"	"-{i:econ_sale_amount}%"
"DOTA_EconItemSet_Tooltip_InBundle"	"此套裝含在同捆包內"
"DOTA_EconItemSet_Tooltip_MultipleStyles"	"有多種樣式"
"DOTA_HeroRole_Carry"	"核心"
"DOTA_HeroRole_Support"	"輔助"
"DOTA_HeroRole_Nuker"	"爆發"
"DOTA_HeroRole_Disabler"	"控場"
"DOTA_HeroRole_Jungler"	"打野"
"DOTA_HeroRole_Durable"	"坦克"
"DOTA_HeroRole_Escape"	"脫逃"
"DOTA_HeroRole_LaneSupport"	"對線輔助"
"DOTA_HeroRole_Pusher"	"推進"
"DOTA_HeroRole_Initiator"	"開戰"
"DOTA_HeroGrid_OptionCategory_Role"	"角色："
"DOTA_HeroGrid_OptionCategory_Attributes"	"屬性："
"DOTA_HeroGrid_OptionCategory_AttackType"	"攻擊類型："
"DOTA_HeroLoadout_PreviousHeroName"	"{s:previous_hero_name}"
"DOTA_HeroLoadout_NextHeroName"	"{s:next_hero_name}"
"DOTA_HeroLoadout_CurrentHeroName"	"{s:hero_name}"
"DOTA_HeroLoadout_AttackType"	"{s:hero_attack_type}"
"DOTA_HeroLoadout_HeroFilterName"	"英雄"
"DOTA_HeroLoadout_Search"	"搜尋 {s:hero_name} 的相關物品"
"DOTA_HeroCustomize_OwnedItems"	"已擁有的物品"
"DOTA_HeroCustomize_Slot"	"欄位"
"DOTA_HeroCustomize_SlotName"	"{s:slot_name}"
"DOTA_HeroCustomize_SlotEquippedItemName"	"{s:equipped_item_name}"
"DOTA_HeroCustomize_DefaultItemName"	"預設物品"
"DOTA_HeroCustomize_PreviewItemName"	"{s:preview_item_name}"
"DOTA_HeroCustomize_PreviewStyle"	"{s:preview_style_name}"
"DOTA_HeroCustomize_PreviewItemSlot"	"{s:preview_item_slot}"
"DOTA_HeroCustomize_Rarity"	"{s:preview_item_rarity}"
"DOTA_HeroCustomize_StyleLocked"	"裝備所需前提要件"
"DOTA_UIEconItem_StyleIndex"	"{i:style_index}"
"dota_ready_up_num_accepted"	"{i:num_accepted} / {i:total_players} 已接受"
"returning_top_of_queue"	"回到優先配對佇列"
"GC_reconnecting"	"正在恢復連接 Dota 2 網路..."
"GC_nosteam"	"無法與 Steam 連線"
"GC_searching"	"正在搜尋 Dota 2 網路..."
"GC_noconnection"	"未連線至 Dota 2 網路。"
"GC_connecting"	"正在連線至 Dota 2 網路..."
"GC_connected"	"已連接至 Dota 2 網路。"
"GC_down"	"Dota 2 網路目前為離線狀態。"
"GC_Network_Full"	"Dota 2 網路目前滿載。"
"GC_Queue_Position"	"佇列位置：%s1"
"GC_Wait_Time"	"預估等待時間：%s1"
"GC_Wait_Time_Unknown"	"未知"
"GC_suspended"	"帳戶已在 VAC 偵測到 Dota 2 外掛後遭到凍結。"
"dota_practice_vs_bots"	"開始電腦對抗練習賽"
"dota_practice_vs_bots_desc"	"進行一場對抗電腦的練習遊戲。不使用配對功能，而您也可隨時離開。"
"dota_practice_vs_bots_difficulty"	"電腦玩家難度"
"dota_practice_vs_bots_team"	"選擇陣營"
"DOTA_practice_vs_bots_team_radiant"	"聖輝"
"DOTA_practice_vs_bots_team_dire"	"魔魘"
"DOTA_practice_vs_bots_team_random"	"隨機"
"DOTA_EmoticonUpsell"	"表情符號可藉由購買指定的英雄物品或聯賽門票來解鎖。"
"DOTA_CurrentTime"	"{t:t:current_time}"
"DOTA_MonthlyPlayers"	"{s:users_last_month}"
"DOTA_MonthlyPlayersLabel"	"上個月的獨特玩家數"
"DOTA_CurrentPlayers"	"{s:current_users}"
"DOTA_CurrentPlayersLabel"	"玩家於遊戲中"
"DOTA_Search_NoResults"	"沒有結果"
"DOTA_Search_ItemShortDescription"	"<span class=\"ItemRarityColor\">{s:item_rarity}</span> {s:item_slot}"
"join_error_already_in_game"	"無法加入練習大廳。因為您已經在其它遊戲中。"
"join_error_invalid_lobby"	"無法加入練習大廳。您指定的大廳已不存在。"
"join_error_incorrect_password"	"無法加入練習大廳。密碼錯誤。"
"join_error_access_denied"	"進入被拒。"
"join_error_generic"	"無法加入練習大廳。"
"join_error_in_team_party"	"無法進入練習大廳。加入練習遊戲之前，您必須先解散隊伍團隊。"
"join_error_lobby_full"	"大廳已滿。"
"join_error_timed_out"	"逾時的要求。"
"DOTA_Friend_Finding_Match"	"比賽配對尋找中…"
"DOTA_Friend_Solo_Open_Party"	"{s:player_name} 想找人一起玩"
"DOTA_Friend_Solo_Open_Party_Self"	"您正在尋找組團伙伴"
"DOTA_Friend_Lobby_Mode_Small"	"{s:game_mode} 大廳"
"DOTA_Friend_Lobby_Players"	"{d:player_count} / {d:max_player_count}"
"DOTA_Friend_Lobby_Join_Button"	"{s:join_button_text}"
"DOTA_Friend_Lobby_Friend_Count"	"+{d:extra_friend_count}"
"DOTA_Friend_Invite_To_Party"	"邀請至團隊"
"DOTA_Friend_SuggestInviteToParty"	"建議邀請加入團隊"
"DOTA_Request_Join_Party"	"申請加入團隊"
"DOTA_Friend_JoinParty"	"加入團隊"
"DOTA_Friend_Watch"	"觀看"
"DOTA_PartyVisTooltip_SoloTitleOpen"	"正表態想要找團"
"DOTA_PartyMerge_Error_Title"	"團隊加入/合併失敗"
"DOTA_PartyMerge_Error_NOT_LEADER"	"團隊操作僅能由團長執行"
"DOTA_PartyMerge_Error_TOO_MANY_PLAYERS"	"團隊無法合併，因為玩家人數太多了。"
"DOTA_PartyMerge_Error_TOO_MANY_COACHES"	"團隊無法合併，因為教練人數太多了。"
"DOTA_PartyMerge_Error_ENGINE_MISMATCH"	"團隊無法合併，因為他們的 Dota 版本不一致"
"DOTA_PartyMerge_Error_NO_SUCH_GROUP"	"團隊已不存在。"
"DOTA_Feed_Timestamp_MinutesAgo"	"{i:value} 分前"
"DOTA_Feed_Timestamp_HourAgo"	"{i:value} 小時前"
"DOTA_Feed_Timestamp_HoursAgo"	"{i:value} 小時前"
"DOTA_Feed_Timestamp_Yesterday"	"昨天"
"DOTA_Feed_Timestamp_Date"	"{s:month} {s:day}"
"dota_lobby_type_general"	"非排名"
"dota_lobby_type_practice"	"練習遊戲"
"dota_lobby_type_practice_game_mode_custom"	"自訂遊戲"
"dota_lobby_type_tournament"	"職業聯賽"
"dota_lobby_type_coop_bot"	"合作對抗電腦玩家"
"dota_lobby_type_competitive"	"積分配對"
"dota_lobby_type_casual_1v1"	"1v1 遊戲"
"dota_lobby_unknown"	"未知"
"DOTA_Lobby_No_Players_Title"	"無玩家加入任何隊伍"
"DOTA_Lobby_No_Players_Desc"	"聖輝或魔魘雙方至少要有一名玩家加入。"
"dota_match_result_won"	"勝"
"dota_match_result_lost"	"敗"
"dota_match_result_none"	"???"
"dota_social_feed_loading"	"讀取中..."
"DOTA_LoadingPlayerUnknown"	"-"
"DOTA_LoadingPlayerLoading"	"讀取中..."
"DOTA_LoadingPlayerFullyConnected"	"就緒"
"LoadingScreenTimer"	"{t:d:countdown_timer_seconds}"
"HeroSelectionTimer"	"{i:timer_seconds}"
"LoadingScreenMapInfo"	"地圖：{s:map_name}"
"LoadingScreenPlayersInfo"	"玩家：{i:players_loaded}/{i:players_total}"
"LoadingScreenSpectatorsInfo"	"觀眾：{i:spectators_loaded}/{i:spectators_total}"
"custom_end_screen_victory_message"	"{s:winning_team_name} 勝利！"
"custom_end_screen_legend_player"	"玩家"
"custom_end_screen_legend_level"	"等級"
"custom_end_screen_legend_hero"	"英雄"
"custom_end_screen_legend_kills"	"K"
"custom_end_screen_legend_deaths"	"D"
"custom_end_screen_legend_assists"	"A"
"custom_end_screen_legend_items"	"物品"
"custom_end_screen_legend_gold"	"金錢"
"custom_end_screen_legend_team_score"	"分數"
"custom_scoreboard_hero_name_and_desc"	"等級 {i:hero_level} {s:hero_name}"
"CustomEndScreenClose"	"關閉"
"DOTA_Armory_Category_Heroes"	"英雄"
"DOTA_Armory_Category_Companions"	"伙伴"
"DOTA_Armory_Category_Couriers"	"信使"
"DOTA_Armory_Category_Pets"	"寵物"
"DOTA_Armory_Category_World"	"地圖"
"DOTA_Armory_Category_Wards"	"守衛"
"DOTA_Armory_Category_Weather"	"天氣效果"
"DOTA_Armory_Category_Effigies"	"英雄雕像"
"DOTA_Armory_Category_Interface"	"介面"
"DOTA_Armory_Category_Emoticons"	"表情符號"
"DOTA_Armory_Category_LoadingScreens"	"載入畫面"
"DOTA_Armory_Category_HUDs"	"HUD 介面"
"DOTA_Armory_Category_CursorPacks"	"滑鼠游標包"
"DOTA_Armory_Category_Audio"	"音訊"
"DOTA_Armory_Category_VoicePacks"	"語音包"
"DOTA_Armory_Category_AnnouncerPacks"	"廣播語音包"
"DOTA_Armory_Category_Music"	"音樂"
"DOTA_Armory_Category_All"	"全部"
"DOTA_Armory_Category_Other"	"其它"
"DOTA_Armory_Category_View"	"分類查看"
"DOTA_Armory_Filter"	"設定過濾"
"DOTA_Armory_SortBy"	"分類依據："
"DOTA_Armory_SortBy_Rarity"	"稀有度"
"DOTA_Armory_SortBy_Quality"	"屬性"
"DOTA_Armory_SortBy_Name"	"名稱"
"DOTA_Armory_SortBy_Recent"	"取得日期"
"DOTA_Armory_SortBy_Sockets"	"鑲孔數量"
"DOTA_Armory_Search"	"搜尋軍械庫物品"
"DOTA_Armory_ContextMenu_PreviewSet"	"預覽完整套裝"
"DOTA_Armory_ContextMenu_Socketing"	"鑲孔"
"DOTA_Armory_ContextMenu_Delete"	"刪除"
"dota_page_match_details_legend_player"	"玩家"
"dota_page_match_details_legend_level"	"等級"
"dota_page_match_details_legend_hero"	"英雄"
"dota_page_match_details_legend_kills"	"K"
"dota_page_match_details_legend_deaths"	"D"
"dota_page_match_details_legend_assists"	"A"
"dota_page_match_details_legend_items"	"物品"
"dota_page_match_details_legend_gold"	"金錢"
"dota_page_match_details_legend_winner_tooltip"	"獲勝隊伍"
"dota_page_match_details_legend_kills_tooltip"	"擊殺"
"dota_page_match_details_legend_deaths_tooltip"	"死亡"
"dota_page_match_details_legend_assists_tooltip"	"助攻"
"dota_page_match_details_legend_gold_per_min_tooltip"	"每分鐘賺取金錢"
"dota_page_match_details_header_league_name"	"聯賽名稱"
"dota_page_match_details_header_custom_game_map_name"	"地圖名稱"
"dota_page_match_details_header_match_id"	"場次編號"
"dota_page_match_details_header_game_mode"	"遊戲模式"
"dota_page_match_details_header_duration"	"長度"
"dota_page_match_details_header_timestamp"	"場次日期 / 時間"
"dota_page_match_details_voting_votes"	"{i:num_votes} 投票"
"dota_page_match_details_match_discussion"	"比賽討論"
"dota_page_match_details_replay_existence_cdn_found"	"下載重播"
"dota_page_match_details_replay_existence_downloading"	"正在下載..."
"dota_page_match_details_replay_existence_disk_found_replay"	"觀賞重播"
"dota_page_match_details_replay_existence_disk_found_highlights"	"觀看精彩回顧"
"dota_page_match_details_replay_existence_wrong_engine"	"Source 1 引擎的重播無法用於 Source 2 引擎中"
"dota_profile_content_tab_recent_games"	"最近遊戲"
"dota_profile_recent_games_option_show_practice_matches"	"顯示練習場次"
"dota_profile_recent_game_header_timestamp"	"日期 / 時間"
"dota_profile_recent_game_header_hero_name"	"使用英雄"
"dota_profile_recent_game_header_result"	"結果"
"dota_profile_recent_game_header_duration"	"長度"
"dota_profile_recent_game_header_type"	"類型"
"dota_profile_recent_game_result_win"	"勝"
"dota_profile_recent_game_result_loss"	"敗"
"dota_profile_recent_game_result_abandon"	"中途退場"
"dota_profile_recent_game_icon_source1"	"S1"
"dota_profile_hero_with_index"	"{d:hero_index} {s:hero_name}"
"dota_profile_hero"	"{s:hero_name}"
"dota_replay_manager_error_not_found"	"無法在 CDN 上找到重播。"
"dota_replay_manager_error_chunk_failed"	"下載重播檔案失敗。"
"dota_replay_manager_error_partial_compressed_open_failure"	"無法開啟壓縮過的重播檔案。"
"dota_replay_manager_error_partial_decompressed_open_failure"	"無法開啟解壓縮過後的重播檔案。"
"dota_page_match_details_replay_error_not_found"	"在磁碟上找不到重播。"
"DOTA_tooltip_econ_item_name"	"{s:item_name}"
"DOTA_tooltip_econ_item_description"	"{s:item_description}"
"DOTA_tooltip_econ_item_rarity_label"	"稀有度："
"DOTA_tooltip_econ_item_rarity"	"{s:item_rarity}"
"DOTA_tooltip_econ_item_slot"	"欄位：{s:item_slot}"
"DOTA_tooltip_econ_item_gifter"	"{g:dota_persona:gifter_name}"
"DOTA_tooltip_econ_item_trade_restriction_permanent"	"不可用於交易或販售"
"DOTA_tooltip_econ_item_trade_restriction_date"	"{t:T:tradable_after_date_time} {t:s:tradable_after_date_time} 前不可交易"
"DOTA_tooltip_econ_item_gem_type"	"{s:gem_type}"
"DOTA_tooltip_econ_item_gem_strange_count"	"{d:strange_count}"
"DOTA_tooltip_econ_item_gem_description"	"{s:gem_description}"
"DOTA_tooltip_econ_item_partner"	"{s:partner}"
"DOTA_econ_item_details_item_name"	"{s:item_name}"
"DOTA_econ_item_details_rarity_label"	"稀有度："
"DOTA_econ_item_details_item_rarity"	"{s:item_rarity}"
"DOTA_econ_item_details_item_description"	"{s:item_description}"
"DOTA_econ_item_details_gem_type"	"{s:gem_type}"
"DOTA_econ_item_details_gem_strange_count"	"{d:strange_count}"
"DOTA_econ_item_details_gem_description"	"{s:gem_description}"
"DOTA_Treasure_Name"	"{s:treasure_name}"
"DOTA_Treasure_Rarity"	"<span class=\"ItemRarityColor\">{s:treasure_rarity}</span> 寶藏"
"custom_game_mismatch_title"	"自訂遊戲數據不相符"
"custom_game_team_select"	"選擇隊伍"
"custom_game_team_select_timer"	"{i:countdown_timer_seconds}"
"custom_game_team_select_shuffle"	"隨機選隊"
"custom_game_team_select_join"	"加入"
"custom_game_team_select_empty_slot"	"空的欄位"
"custom_game_team_select_auto_assign"	"自動分配"
"custom_game_default_gameinfo_text"	"這裡還沒有東西，請靜待此自訂遊戲添加更多資訊！"
"CouldntFindCompendium"	"無法載入手冊測試文件：%s1"
"CompendiumPageError_Pages"	"無法在數據文檔中找到「頁面」框。"
"CompendiumPageError_Template"	"無法找到「模板」入口的「%s1」手冊頁面（頁面編號 %s2）"
"CompendiumPageError_Template2"	"無法在手冊頁面「%s2」中找到名為「%s1」的模板"
"CompendiumPageError_Image"	"無法在手冊頁面「%s2」中找到名為「%s1」的圖檔"
"CompendiumPageError_Text"	"無法在手冊頁面「%s2」中找到名為「%s1」的文本框"
"CompendiumPageError_Video"	"在手冊頁面「%s2」中無法找到名稱「%s1」的影像"
"CompendiumPageError_Scrollbar"	"無法在互動手冊的第 \\'%s2\\' 中找到名為「 \\'%s1\\' 」的滾動條"
"CompendiumPageError_Selection"	"無法在手冊頁面「%s2」中找到名為「%s1」的選項"
"CompendiumPageError_PageNames"	"第 %s1 號內頁使用了與其它頁數相同的名稱。每一頁的名稱皆不得重複。"
"CompendiumPageError_CustomText"	"在手冊頁面「%s2」的自訂文字區塊「%s1」發生了錯誤"
"CompendiumPageError_CustomImg"	"自訂影像區塊發生了錯誤「%s1」"
"CompendiumPageError_CustomBar"	"聯賽手冊頁面 「%s2」的自訂進度條「%s1」錯誤"
"CompendiumPageError_CustomEle"	"在手冊頁面「%s2」中的自訂元件「%s1」實例化失敗"
"CompendiumPageError_CTFont"	"在手冊頁面「%s2」中有無效指定字體屬性「%s1」。有效字體屬性：\\\ntext, textbold, title"
"CompendiumPageError_CTAlign"	"在手冊頁面「%s2」中有無效指定對齊方式「%s1」。有效對齊屬性：\\\n left, right, center"
"CompendiumPageError_CTDepth"	"無效深度「%s1」。有效深度屬性：\\\n front, back"
"CompendiumPageError_LinePos"	"第 %s1 行沒有開始和結束位置方格。"
"CompendiumPageError_CTPoints"	"自訂內容「%s2」點數部份的的選擇索引「%s1」無效。"
"CompendiumPageError_CTPoints2"	"自訂內容「%s2」點數部份的的選擇索引「%s1」無效。無法在索引中找到選項。"
"CompendiumPageError_SelDesc"	"無法在手冊頁面「%s2」中找到選項「%s1」的描述關鍵詞"
"CompendiumPageError_Points"	"手冊頁面「%s2」的選項「%s1」「分數（points）」遺失（或為零）"
"CompendiumPageError_SelType"	"手冊頁面「%s2」的選項「%s1」的「選擇類型」丟失"
"CompendiumPageError_BarType"	"遺失聯賽手冊頁面「%s2」的進度條「%s1」資料"
"CompendiumPageError_NoTime"	"「%s2」中的選項「%s1」中指定的「time」找不到或無效"
"CompendiumPageError_ElementType"	"互動手冊第 \\'%s2\\' 頁中 \\'%s1\\' 的 \\'elementtype\\' 遺失或無效。"
"CompendiumPageError_SelTimer"	"在手冊頁面「%s2」上有名為「%s1」的未知計時器"
"CompendiumPageError_BadElement"	"手冊頁面「%s2」中含有名叫「%s1」的未知 SF 元件"
"CompendiumPageError_SelNoTimer"	"在手冊頁面「%s1」中無法找到計時器（根據選項此處需要計時器）"
"CompendiumPageError_SelUnknown"	"選項「%s2」的「%s1」「choice_type」無效"
"CompendiumPageError_BarUnknown"	"選項「%s2」中的「%s1」資料無效"
"CompendiumPageError_SelChoices"	"手冊頁面「%s2」中選項「%s1」的選擇框丟失"
"CompendiumPageError_NoHero"	"無法在選項「%s2」中找到英雄編號為「%s1」的英雄"
"CompendiumPageError_Unknown"	"手冊內部邏輯錯誤。請聯絡 Valve 以解決此問題。"
"CompendiumPageError_ImageDL"	"無法開始下載手冊頁面的圖檔「%s1」（%s2）"
"CompendiumPageError_ImageDLErr"	"下載手冊頁面「%s1」圖檔失敗（%s2）"
"CompendiumPageError_BtnNoElem"	"找不到「selection_elements」區塊可供在手冊頁面「%s2」內的按鈕「%s1」使用"
"CompendiumPageError_BtnBadVal"	"按鈕「%s2」中的選擇數值「%s1」未在該選擇索引的選擇列表當中"
"CompendiumPageError_BtnBadSel"	"元素「%s1」中的「selection_force_to」設置未在選擇列表「%s2」中"
"CompendiumPageError_BtnSelIdx"	"在手冊頁面「%2」中的按鈕「%1」找不到或無效的「selection_index」"
"CompendiumPageError_CmdSelIdx"	"手冊頁面「%s2」中的元件「%s1」找不到或有著無效的「selection_index」或「force_selection_index」指令"
"CompendiumPageError_ImgSelIdx"	"圖片「%s2」中「%s1」的「selection_index」無效。"
"CompendiumPageError_ImgShowSelIdx"	"圖片「%s2」中「%s1」的「show_selection_index」無效。"
"CompendiumPageError_ImgSelVal"	"在「show_selection_images」部分中的影像「%s2」的選擇「%s1」無效。"
"CompendiumPageError_ImgBadStyle"	"圖片 \\'%s2\\' 的圖片樣式 \\'%s1\\' 有誤。"
"CompendiumPageError_DynTxtSel"	"手冊頁面「%s2」中的文字「%s1」包含無效的 % selection_X %。該索引不能有著預先登記的選項。"
"CompendiumPageError_NoTxtList"	"無法找到在頁面「%s2」中找到名為「%s1」的文字列表"
"CompendiumPageError_TOCPage"	"table_of_contents_page 的頁面「%s1」不存在。"
"CompendiumPageError_SelIndex"	"在手冊頁面「%s2」中選項「%s1」的「selection_index」丟失或無效"
"CompendiumPageError_SelUsed"	"在手冊頁面「%s2」的選擇「%s1」沒有唯一「selection_index」"
"CompendiumPageError_SelVal"	"在手冊頁面「%s2」中選項「%s1」有相同數值的選擇。"
"CompendiumPageError_SelValInv"	"在手冊頁面「%s2」中選項「%s1」有帶有數值（<= 0）的選擇。選擇值必須大於 0。"
"CompendiumPageError_SelTTVal"	"在互動手冊頁面「%s2」內的「%s1」選項中有著數值不在列表中的 tooltip_data 項目。"
"CompendiumPageError_NoAnswer"	"互動手冊頁面「%s2」中的選項「%s1」在「result」部分中沒有「answer」或「answers」鍵值"
"CompendiumPageError_MissAnswer"	"互動手冊頁面「%s2」中的選項「%s1」有著不符合任何對應選擇的「answer」或「answers」鍵值"
"CompendiumPageError_Timer"	"計時器「%s1」的時間無效"
"CompendiumPageError_UnknownAction"	"物件「%s1」參照了未知動作「%s2」"
"CompendiumPageError_SameElement"	"系統在第 \\'%s2\\' 頁中發現了數個名為「 \\'%s1\\' 」 的元素。"
"CompendiumPageError_DupeKey"	"Keyvalues 區塊「%s1」含有多個同樣名為「%s2」的按鍵。"
"CompendiumError_Template"	"無法找到名為「%s1」的模板"
"CompendiumError_DupeTemplate"	"找到多個名為「%s1」的範本。"
"CompendiumError_NoDefines"	"範本「%s1」需要定義，但它的實例「%s2」沒有定義區塊。"
"CompendiumError_MissingDef"	"實例「%s1」所衍自的模板需要需要它包含一個名為「%s2」的定義。"
"CompendiumError_BadDef"	"衍生出的實例「%s1」得要包含著一個需要不以「%def」開頭的定義名稱「%s2」。"
"DOTA_GlobalItems_Companions"	"伙伴"
"DOTA_GlobalItems_Couriers"	"信使"
"DOTA_GlobalItems_Pets"	"寵物"
"DOTA_GlobalItems_World"	"地圖"
"DOTA_GlobalItems_Wards"	"守衛"
"DOTA_GlobalItems_Effigies"	"英雄雕像"
"DOTA_GlobalItems_Weather"	"天氣效果"
"DOTA_GlobalItems_Interface"	"介面"
"DOTA_GlobalItems_Emoticons"	"表情符號"
"DOTA_GlobalItems_LoadingScreens"	"載入畫面"
"DOTA_GlobalItems_HUDs"	"HUD 介面"
"DOTA_GlobalItems_Audio"	"音訊"
"DOTA_GlobalItems_Announcers"	"廣播語音包"
"DOTA_GlobalItems_Music"	"音樂"
"DOTA_Search"	"搜尋"
"DOTA_Start"	"開始"
"DOTA_PleaseWait"	"請稍候..."
"DOTA_ChallengeGroup_2_Desc"	"在無壓力的環境練習和由<br>電腦玩家操控的敵手和<br>隊友進行遊戲。"
"DOTA_ChatTab_ToggleSounds"	"在此頻道收到訊息時播放音效。"
"dota_lobby_balanced_shuffle"	"平衡換隊"
"dota_lobby_swap_teams"	"交換隊伍"
"dota_lobby_unassigned_players"	"未分配玩家"
"dota_lobby_broadcast_channels"	"開關導播頻道"
"dota_lobby_settings"	"大廳設定"
"dota_lobby_settings_edit"	"編輯"
"dota_lobby_leave"	"離開此大廳"
"DOTA_Custom_Game_View_Lobby_List"	"檢視大廳列表"
"DOTA_Custom_Game_Lobby_List_Title"	"大廳列表"
"DOTA_Custom_Game_Browse_All"	"瀏覽所有遊戲"
"DOTA_Custom_Game_Friends_Who_Play"	"有玩過的好友"
"DOTA_Custom_Game_Browse_Sort"	"分類："
"DOTA_Custom_Game_Sort_Popular_Today"	"最高評價（本日）"
"DOTA_Custom_Game_Sort_Popular_Week"	"最高評價（本週）"
"DOTA_Custom_Game_Sort_Top_Rated"	"最高評價（有史以來）"
"DOTA_Custom_Game_Sort_Date"	"發佈日期"
"DOTA_WatchLive_Steam"	"STEAM"
"DOTA_WatchLive_InGame"	"遊戲中"
"DOTA_WatchLive_Broadcaster0"	"觀看 {g:dota_persona:b:broadcaster_account_id_0}"
"DOTA_WatchLive_Broadcaster1"	"觀看 {g:dota_persona:b:broadcaster_account_id_1}"
"DOTA_WatchLive_Broadcaster2"	"觀看 {g:dota_persona:b:broadcaster_account_id_2}"
"DOTA_WatchLive_Broadcaster3"	"觀看 {g:dota_persona:b:broadcaster_account_id_3}"
"DOTA_WatchLive_Broadcaster4"	"觀看 {g:dota_persona:b:broadcaster_account_id_4}"
"DOTA_WatchLive_Broadcaster5"	"觀看 {g:dota_persona:b:broadcaster_account_id_5}"
"DOTA_WatchLive_Broadcaster6"	"觀看 {g:dota_persona:b:broadcaster_account_id_6}"
"DOTA_WatchLive_Broadcaster7"	"觀看 {g:dota_persona:b:broadcaster_account_id_7}"
"DOTA_WatchLive_Broadcaster8"	"觀看 {g:dota_persona:b:broadcaster_account_id_8}"
"DOTA_WatchLive_Broadcaster9"	"觀看 {g:dota_persona:b:broadcaster_account_id_9}"
"dota_matchmaking_region_title_confirm"	"確認配對地區"
"dota_play_lobby_games"	"檢視大廳"
"dota_play_connecting_to_server"	"正在連線..."
"dota_reconnecting"	"正在重新連線..."
"dota_matchmaking_regions_retry"	"重試"
"dota_matchmaking_region_ping_calculating"	"延遲：計算中..."
"dota_matchmaking_region_ping_failed"	"延遲：失敗"
"dota_matchmaking_region_or"	"或"
"dota_matchmaking_region_selected_offline"	"所選的伺服器中有一個或數個暫時離線。"
"dota_matchmaking_region_selected_unreachable"	"無法與所選的地區伺服器確認建立連線。"
"dota_matchmaking_region_all_unavailable"	"無法與任何伺服器連線。請確認您的網路連線狀態。"
"dota_matchmaking_region_check_internet"	"檢查您的網路連線"
"dota_matchmaking_region_poor_choices"	"目前選中的伺服器可能會出現連線較為緩慢的情況。"
"dota_settings_networkhud"	"顯示網路資訊"
"dota_settings_fullscreenbrightness"	"亮度"
"dota_settings_dashboard_renderquality"	"高解析度主介面"
"dota_settings_lowlatency_audio"	"自動偵測音訊延遲"
"dota_settings_quicktargetattack"	"快速攻擊"
"dota_settings_chat_whispers"	"以密語方式顯示 Steam 訊息"
"dota_settings_no_mode_resolutions"	"無支援的解析度"
"dota_lobby_browser_header_name"	"大廳名稱"
"dota_lobby_browser_header_slots"	"位置"
"dota_lobby_browser_header_game_mode"	"遊戲模式"
"dota_lobby_browser_region"	"地區"
"dota_lobby_browser_lobby_name"	"大廳名稱"
"DOTA_Friend_Game_Mode_1_Friend"	"{s:player_name} 正在玩 {s:game_mode}"
"DOTA_Friend_Game_Mode_N_Friends"	"{d:num_friends} 好友正在玩 {s:game_mode}"
"CompendiumError_XMLLoadFail"	"讀取名為「{s:s2}」的 XML 文件中的「{s:s1}」頁面時發生了錯誤。"
"CompendiumError_XMLParseFail"	"解析名為「{s:s2}」的 XML 文件中的「{s:s1}」頁面時發生了錯誤。"
"Compendium_DefaultText_TimerTitle_Active"	"距離選擇關閉還剩"
"Compendium_DefaultText_TimerTitle_Expired"	"選擇已關閉"
"Compendium_DefaultText_CD_Days"	"天"
"Compendium_DefaultText_CD_Hours"	"小時"
"Compendium_DefaultText_CD_Minutes"	"分"
"Compendium_DefaultText_CD_Seconds"	"秒"
"NetGraph_FPS"	"fps： {d:fps}"
"NetGraph_Ping"	"ping: {d:ping}ms"
"NetGraph_Loss"	"loss: {d:loss}%	"
"DOTA_Credits"	"致謝名單"
"DOTA_ActorCredits_1_Name"	"Dee Bradley Baker"
"DOTA_ActorCredits_2_Name"	"Dennis Bateman"
"DOTA_ActorCredits_3_Name"	"Tom Chantler"
"DOTA_ActorCredits_4_Name"	"Merle Dandridge"
"DOTA_ActorCredits_5_Name"	"Barry Dennen"
"DOTA_ActorCredits_6_Name"	"Dave Fennoy"
"DOTA_ActorCredits_7_Name"	"Jim French"
"DOTA_ActorCredits_8_Name"	"Michael Gregory"
"DOTA_ActorCredits_9_Name"	"Gin Hammond"
"DOTA_ActorCredits_10_Name"	"John Patrick Lowrie"
"DOTA_ActorCredits_11_Name"	"Ellen McLain"
"DOTA_ActorCredits_12_Name"	"Bruce Miles"
"DOTA_ActorCredits_13_Name"	"Linda K. Morris"
"DOTA_ActorCredits_13_Extra"	"預設廣播語音"
"DOTA_ActorCredits_14_Name"	"Sam A. Mowry"
"DOTA_ActorCredits_15_Name"	"Eric Newsome"
"DOTA_ActorCredits_16_Name"	"Nolan North"
"DOTA_ActorCredits_17_Name"	"Dempsey Pappion"
"DOTA_ActorCredits_18_Name"	"TJ Ramini"
"DOTA_ActorCredits_19_Name"	"Harry S. Robins"
"DOTA_ActorCredits_20_Name"	"Gary Schwartz"
"DOTA_ActorCredits_21_Name"	"David Scully"
"DOTA_ActorCredits_22_Name"	"Mike Shapiro"
"DOTA_ActorCredits_23_Name"	"David Sobolov"
"DOTA_ActorCredits_24_Name"	"Jon St. John"
"DOTA_ActorCredits_25_Name"	"Fred Tatasciore"
"DOTA_ActorCredits_25_Heroes"	"disruptor、spirit_breaker、treant、undying、ursa"
"DOTA_ActorCredits_25_Extra"	"術士的地獄火巨人"
"DOTA_ActorCredits_26_Name"	"Jen Taylor"
"DOTA_ActorCredits_26_Heroes"	"lina、medusa、puck、windrunner"
"DOTA_ActorCredits_27_Name"	"Tony Todd"
"DOTA_ActorCredits_27_Heroes"	"dragon_knight、night_stalker、viper"
"DOTA_PlayerContextMenu_Trade"	"邀請至交易"
"DOTA_Custom_Game_Finished_Vote_Title"	"自訂遊戲評價投票"
"DOTA_Custom_Game_Finished_Vote_Question"	"您覺得這個自訂遊戲怎樣？"
"DOTA_Custom_Game_Finished_Vote_Skip"	"略過"
"DOTA_TabName_ModsLobbyList"	"大廳列表"
"DOTA_WatchLive_Fullscreen"	"全螢幕"
"DOTA_JoinChatChannel_ChannelName"	"頻道名稱"
"DOTA_JoinChatChannel_ChannelMemberCount"	"頻道人數"
"DOTA_Chat_ChannelMemberCount"	"{d:channel_member_count}"
"dota_settings_coop_fullscreen"	"桌面友善全螢幕"
"DOTA_Trading_UI_Body_Outgoing"	"正在等待 {s:player_name} 回覆您的要求..."
"DOTA_GiftWrap_Item"	"正在將 {g:dota_item_name:gift_item_def} 包成禮物。"
"DOTA_GiftWrap_ConfirmDedication_Title"	"確認贈言"
"DOTA_GiftWrap_ConfirmDedication_Message"	"您確定要將這件禮物附上贈言「 {s:gift_dedication} 」嗎？"
"DOTA_GiftWrap_Success_Header"	"成功"
"DOTA_GiftWrap_Success"	"您發送的禮物已送達。"
"DOTA_GiftWrap_Error_RateLimitedNormal"	"您在 {d:gift_limit_hours} 小時內只能傳送 {d:gift_limit_count} 件物品。您目前做出的送禮次數已超過容許上限，請稍後再試。"
"DOTA_GiftWrap_Error_RateLimitedChargeNone"	"目前無法傳送此禮物。您目前的戰鬥等級不足以讓您進行送禮。"
"DOTA_Custom_Game_Sort_Most_Played"	"最受歡迎（本週）"
"dota_settings_about"	"關於"
"DOTA_EquippedItem_AddToShuffle"	"加入隨機"
"DOTA_EquippedItem_RemoveFromShuffle"	"從隨機移除"
"DOTA_EquippedItem_Unpack_And_AddToShuffle"	"拆開並加入隨機"
"DOTA_ClientVersion"	"版本：<span class=\"VersionNumber\">{d:client_version_number}</span>"
"DOTA_GameplayVersion"	"遊戲版本：<span class=\"VersionNumber\">{s:gameplay_version_number}</span>"
"DOTA_Recycling"	"物品輪迴"
"DOTA_Recycling_Action"	"物品輪迴"
"DOTA_Recycling_DragItems"	"將不要的物品移至此處"
"DOTA_Recycling_Outputs"	"獲得"
"DOTA_Recycling_Confirm"	"您確定要將這些物品至入輪迴嗎？"
"DOTA_RecyclingCharm_Name"	"坩珠護符 II"
"DOTA_RecyclingCharm_Bonus"	"+25 枚互動手冊金幣"
"DOTA_Previous"	"上一頁"
"DOTA_PreviousShort"	"上一頁"
"DOTA_Next"	"下一頁"
"DOTA_Friends_Add_Friend_Tooltip"	"新增好友"
"DOTA_Friends_Add_Friend_Entry_Placeholder"	"輸入好友 ID 以進行搜尋"
"DOTA_Friends_Add_Friend_Your_ID"	"您的好友 ID 是:"
"DOTA_EconItemSet_Tooltip_MultipleTeams"	"聖輝與魔魘有不同的樣式"
"DOTA_HeroLoadout_Shuffle_Count"	"自動隨選欄內有 {i:loadout_items_in_shuffle} 個項目"
"DOTA_HeroLoadout_Add_All_To_Shuffle"	"將全部新增到自動隨選"
"DOTA_HeroLoadout_Clear_Shuffle"	"清除隨機"
"DOTA_Treasure_Purchase"	"	購買寶藏"
"DOTA_Treasure_CharmPurchase"	"購買護符"
"DOTA_Treasure_SearchPlaceholder"	"搜尋寶藏"
"DOTA_Treasure_ViewAll"	"檢視全部寶藏"
"DOTA_Treasure_QuantityOption"	"數量：{d:quantity}"
"DOTA_Treasure_Gift"	"禮物"
"DOTA_Treasure_Open"	"開啟"
"DOTA_Treasure_OpenQuantity"	"{d:owned_quantity}"
"DOTA_Treasure_Owned"	"已擁有"
"DOTA_Treasure_Received"	"已收到"
"DOTA_Treasure_Autographed"	"簽名："
"dota_profile_content_tab_official_info"	"職業選手資訊"
"dota_profile_oi_player_name"	"顯示名稱"
"dota_profile_oi_player_name_sub"	"此名稱應當為全世界玩家所能辨識，且不應包含隊伍及贊助商名稱。"
"dota_profile_oi_team"	"隊伍"
"dota_profile_oi_sponsor"	"贊助者"
"dota_profile_oi_country"	"國家"
"dota_profile_oi_role"	"定位"
"dota_profile_oi_preview"	"您的名稱將在排行榜與競賽場合中以下列格式顯示："
"dota_profile_oi_submit_pending"	"提交中…"
"dota_profile_oi_submit_success"	"成功！"
"dota_profile_oi_submit_failure"	"錯誤 - 請再試一次。"
"dota_role_core"	"核心"
"dota_role_support"	"輔助"
"Compendium_GenerateFail"	"無法產生資源檔案 '{s:s1}'。"
"Compendium_PreparePublish"	"準備發佈"
"Compendium_PublishFinishedTitle"	"發佈成功"
"DOTA_Treasure"	"	寶藏"
"DOTA_Blog"	"Dota 2 最新動態"
"DOTA_SortBy"	"分類依據"
"DOTA_SortOption_Newest"	"最新"
"DOTA_SortOption_Owned"	"擁有"
"DOTA_SortOption_Price"	"價格"
"DOTA_SortOption_Alphabetical"	"字母"
"Action_Use"	"使用"
"DOTA_BadgeLevel"	"{d:badge_level}"
"DOTA_AHC_CurrentHero"	"目前英雄"
"DOTA_AHC_InProgress"	"進行中"
"DOTA_AHC_CurrentHeroAverage"	"全球平均"
"DOTA_AHC_NextHero"	"下一名英雄"
"DOTA_AHC_NextHeroName"	"{s:next_hero_name}"
"DOTA_AHC_ChallengeProgress"	"挑戰進度 ({d:challenge_progress_percent}%)"
"DOTA_AHC_HeroesCompleted"	"已完成英雄"
"DOTA_AHC_TotalAttemptsValue"	"{d:challenge_total_attempts} 場"
"DOTA_AHC_EquivalentWorldAverageValue"	"{d:challenge_average_total_attempts} 場"
"DOTA_AHC_LifetimeStats"	"生涯挑戰統計數據"
"DOTA_AHC_FullChallengesCompleted"	"全挑戰完成次數："
"DOTA_AHC_FullChallengesCompletedValue"	"{d:full_challenges_completed}"
"DOTA_AHC_BestFullChallenge"	"完成全部挑戰的最佳紀錄"
"DOTA_AHC_BestFullChallengeValueNone"	"暫無"
"DOTA_AHC_BestFullChallengeValue"	"{d:best_full_challenge} 場"
"DOTA_AHC_ChallengeReward"	"挑戰獎勵"
"DOTA_AHC_ChallengeTrophyName"	"{s:challenge_trophy_name}"
"DOTA_AHC_ChallengeTrophyLevel"	"{d:challenge_trophy_level} 級"
"DOTA_ItemSet_Count_text"	"{d:item_current_group} / {d:item_group_count}"
"dota_settings_allow_gui_key_to_bind"	"允許在【Windows / Command 鍵】進行綁定"
"DOTA_HeroLoadout_Loadout"	"飾品裝備"
"DOTA_HeroLoadout_About"	"介紹"
"DOTA_HeroLoadout_Guides"	"攻略"
"DOTA_HeroLoadout_Roles"	"角色"
"DOTA_HeroLoadout_Biography"	"背景故事"
"DOTA_Feed_Say_Something"	"說點什麼來表達您的最新動態吧 ~"
"DOTA_Armory_ClearFilter"	"清除篩選條件"
"DOTA_Armory_ContextMenu_Tags"	"標籤…"
"DOTA_Armory_ContextMenu_EffigyPose"	"調整姿勢…"
"DOTA_EffigyEditor_PoseEffigy"	"設定雕像姿勢"
"DOTA_EffigyEditor_Model"	"英雄"
"DOTA_EffigyEditor_Inscription"	"題詞："
"DOTA_EffigyEditor_Animation"	"動畫："
"dota_profile_content_tab_all_hero_challenge"	"全英雄挑戰"
"DOTA_tooltip_econ_item_delete_restriction"	"不可刪除"
"DOTA_tooltip_econ_item_modifiers"	"修改器"
"DOTA_tooltip_econ_item_modifier_animation"	"動作"
"DOTA_tooltip_econ_item_modifier_announcer"	"廣播語音"
"DOTA_tooltip_econ_item_modifier_HUD"	"HUD"
"DOTA_tooltip_econ_item_modifier_health_bar"	"血條"
"DOTA_tooltip_econ_item_modifier_ability_name"	"技能名稱"
"DOTA_tooltip_econ_item_modifier_loading_screen"	"載入畫面"
"DOTA_tooltip_econ_item_modifier_cursor_pack"	"滑鼠游標包"
"DOTA_tooltip_econ_item_modifier_portrait"	"肖像"
"DOTA_tooltip_econ_item_modifier_ambient_effects"	"氛圍特效"
"DOTA_tooltip_econ_item_modifier_spell_effects"	"法術效果"
"DOTA_tooltip_econ_item_modifier_model"	"模型"
"DOTA_tooltip_econ_item_modifier_scale"	"規模"
"DOTA_tooltip_econ_item_modifier_wearable"	"可裝備"
"DOTA_tooltip_econ_item_modifier_courier"	"	信使"
"DOTA_tooltip_econ_item_modifier_flying_courier"	"飛行信使"
"DOTA_tooltip_econ_item_modifier_pet"	"寵物"
"DOTA_tooltip_econ_item_modifier_weather"	"天氣"
"DOTA_tooltip_econ_item_modifier_sound"	"音效"
"DOTA_tooltip_econ_item_modifier_voice"	"配音"
"DOTA_tooltip_econ_item_modifier_icon"	"圖示"
"DOTA_econ_item_details_style_label"	"樣式："
"DOTA_econ_item_details_gift_label"	"贈與者："
"Compendium_DLFailed"	"下載失敗"
"Compendium_Error"	"互動手冊錯誤"
"Compendium_Retry"	"重試"
"Compendium_preview_mode"	"僅限預覽"
"Compendium_level"	"等級"
"Compendium_to_next_level"	"來升級"
"Compendium_LevelupPts_Singular"	"1 分"
"DOTA_GlobalItems_MegaKill"	"連殺語音包"
"DOTA_Treasure_BonusReward"	"額外獎勵"
"DOTA_AntiAddiction_Blocked_Time_Exceeded"	"已超出防沉迷系統的允許遊戲時間。系統將逕行關閉遊戲。"
"DOTA_AntiAddiction_CompleteInfoNow"	"輸入資訊"
"DOTA_AntiAddiction_CompleteInfoNotNow"	"尚未就緒"
"DOTA_Workshop_TextureName_color"	"颜色"
"DOTA_Workshop_MaterialName_NormalTexture"	"普通地圖"
"DOTA_Workshop_Model"	"模型"
"DOTA_Workshop_Animations"	"動作"
"DOTA_Workshop_Misc"	"其它"
"DOTA_Workshop_SubmissionType_Ward"	"守衛"
"DOTA_Workshop_ImportP4"	"匯入（P4）"
"DOTA_Workshop_ImportNoP4"	"匯入（無 P4）"
"DOTA_Workshop_SaveSettings"	"儲存設定"
"DOTA_Workshop_LoadSettings"	"載入設定"
"DOTA_Workshop_Ready"	"就緒"
"DOTA_Workshop_Optional"	"選用"
"DOTA_Workshop_Required"	"必要"
"DOTA_Workshop_ItemName"	"物品名稱"
"DOTA_Workshop_LOD0Title"	"選擇性肖像幾何結構"
"DOTA_Workshop_LOD1Title"	"遊戲內幾何結構"
"DOTA_Workshop_Texture_Title"	"貼圖材質檔案"
"DOTA_Workshop_Texturing"	"貼圖材質說明"
"DOTA_Workshop_Modelling"	"模型說明"
"DOTA_Workshop_Animation"	"動作協助"
"DOTA_Workshop_AbilityIconsHelp"	"技能圖示說明"
"DOTA_Workshop_Reimport"	"更新"
"DOTA_Workshop_Models_Title"	"模型"
"DOTA_Workshop_Materials_Title"	"材質"
"DOTA_Workshop_Attachments_Title"	"附著點"
"DOTA_Workshop_Marketing_Title"	"行銷"
"DOTA_Workshop_Marketing_Help"	"行銷說明"
"DOTA_Workshop_Particles_Title"	"粒子效果"
"DOTA_Workshop_Images_Title"	"圖片"
"DOTA_Workshop_AbilityIcons_Title"	"		技能圖示"
"DOTA_Workshop_HudSkin_Help"	"HUD 介面說明"
"DOTA_Workshop_CursorPack_Help"	"滑鼠游標包說明"
"DOTA_UI_LoadScreen_16_9"	"16:9 解析度比例"
"DOTA_UI_LoadScreen_16_10"	"16:10 解析度比例"
"DOTA_UI_LoadScreen_4_3"	"4:3 解析度比例"
"DOTA_Workshop_ChatEmoticon_Help"	"聊天表情符號協助"
"DOTA_Workshop_ChatEmoticon_Title"	"來源影像檔"
"DOTA_Workshop_ChatEmoticon_ItemName"	"表情符號關鍵字"
"DOTA_Workshop_ChatEmoticon_AnimationSpeed"	"單禎時間"
"DOTA_Workshop_ChatEmoticon_DefaultFrame"	"預設畫格"
"DOTA_Workshop_ImportChatEmoticon_Preview"	"預覽"
"DOTA_Workshop_Attachments_UIBlock"	"附著點 %s1"
"DOTA_Workshop_Attachment_LeftEye"	"左眼骨架名稱"
"DOTA_Workshop_Attachment_RightEye"	"右眼骨架名稱"
"DOTA_Workshop_Attachment_Mouth"	"嘴部骨骼名稱"
"DOTA_Workshop_Animation_Title"	"動作"
"DOTA_Workshop_Animation_Desc"	"動畫檔案的格式有 .DMX、.SMD 和 .FBX 檔，每個檔案均含有一個您的模型的動畫。"
"DOTA_Workshop_Animation_UIBlock"	"動作 %s1"
"DOTA_Workshop_Preview_Anim"	"動作："
"DOTA_Workshop_Preview_Gesture"	"動作疊加："
"DOTA_Workshop_Preview_Skin"	"材質："
"DOTA_Workshop_Preview_Model"	"模型："
"DOTA_Workshop_Preview_NoAttachment"	"無"
"DOTA_Workshop_Preview_ShowReference"	"顯示參考模型"
"DOTA_Workshop_Preview_ToggleLOD"	"顯示低解析度模型"
"DOTA_Workshop_Preview_TogglePedestal"	"開/關臺座"
"DOTA_Workshop_Preview_ToggleUI"	"開/關使用者介面"
"DOTA_Workshop_ImportError_Validation"	"驗證失敗"
"DOTA_Workshop_Error_TooManyBones"	"%s1 所含的骨架超出允許範圍。\n模型不得超出 52 根骨架數量。"
"DOTA_Workshop_ImportError"	"匯入錯誤"
"DOTA_Workshop_Error_VMTCount"	"%s1 模型所使用的貼圖材質不止一種。但其中也僅有一項允許在該模型的所有細節等級中顯示。\n找到的材質：\n\n%s2"
"DOTA_Workshop_ZipError"	"		檔案錯誤！"
"DOTA_Workshop_Error"	"匯入錯誤"
"DOTA_Workshop_Error_Unskinned"	"找不到飾品與英雄模型之間對應的骨骼。可穿戴的飾品必須能覆在英雄骨骼上才能提交。"
"DOTA_Workshop_Quicksave_Fail"	"儲存失敗"
"DOTA_Workshop_Quickload_Fail"	"讀取失敗"
"DOTA_Workshop_Import"	"匯入"
"DOTA_Workshop_Importing"	"匯入中"
"DOTA_Workshop_Import_Success"	"匯入成功"
"DOTA_Workshop_Import_Failed"	"匯入失敗"
"DOTA_Workshop_OutOfBudget"	"%s1 所含的三角形數超出允許範圍：\n %s2 含有 %s3 個三角形，允許數量僅限 %s4。"
"DOTA_Workshop_LOD0Title_Ward"	"肖像幾何模型"
"DOTA_Workshop_LOD1Title_Ward"	"遊戲內幾何結構"
"DOTA_Workshop_Animation_IdleAlt"	"替代閒置"
"DOTA_Workshop_Animation_IdleRare"	"稀有閒置"
"DOTA_Workshop_Animation_RunRare"	"稀有奔跑"
"DOTA_Workshop_Animation_AttackB"	"次要攻擊"
"DOTA_Workshop_Animation_Attack2"	"副手攻擊"
"DOTA_Workshop_Animation_Flail"	"掙扎"
"DOTA_Workshop_Animation_Disabled"	"遭控制 / 遭暈眩"
"DOTA_Workshop_Animation_TurnPoseCenter"	"轉向中心姿勢（選擇性）"
"DOTA_Workshop_Animation_TurnPoseLeft"	"轉向左側姿勢"
"DOTA_Workshop_Animation_TurnPoseRight"	"轉向右側姿勢"
"DOTA_Workshop_Animation_PortraitIdle"	"閒置肖像"
"DOTA_Workshop_Animation_PortraitRare"	"稀有閒置肖像"
"DOTA_Workshop_Animation_BackLeftIdle"	"左後側閒置"
"DOTA_Workshop_Animation_LeftIdle"	"左側閒置"
"DOTA_Workshop_Animation_RightIdle"	"右側閒置"
"DOTA_Workshop_Animation_BackRightIdle"	"右後側閒置"
"DOTA_Workshop_Animation_BackLeftAttack"	"左後側攻擊"
"DOTA_Workshop_Animation_LeftAttack"	"左側攻擊"
"DOTA_Workshop_Animation_RightAttack"	"右側攻擊"
"DOTA_Workshop_Animation_BackRightAttack"	"右後側攻擊"
"DOTA_Workshop_EditAngles"	"編輯角度"
"DOTA_Workshop_EditGeneric"	"編輯通用訊息"
"DOTA_Workshop_EditOrigin"	"編輯原點"
"DOTA_Workshop_Preview"	"預覽"
"DOTA_Workshop_PreviewInGame"	"在遊戲內預覽"
"DOTA_Workshop_BrowseForZipFilter"	"工作坊投稿項目"
"DOTA_Workshop_LoadSession"	"讀取對話"
"DOTA_Workshop_SaveSession"	"儲存對話"
"DOTA_Filter_Field_Category"	"標籤"
"DOTA_Skip"	"跳過"
"DOTA_Done"	"完成"
"DOTA_TryAgain"	"再試一次"
"DOTA_Treasure_OpenAnother"	"再開啟一個"
"DOTA_Treasure_OpenTreasure"	"開啟寶藏"
"DOTA_Treasure_OpenNoDupe"	"您打開的每個寶藏都含有 {d:items_per_treasure} 件示出的一般物品。您在拿完一輪前將不會重複獲得同樣物品。運氣好的話您或許還會額外獲得其中一件稀有物品。"
"DOTA_Treasure_OpenSuccess"	"恭喜！您獲得了："
"DOTA_View_Details"	"檢視細節"
"DOTA_TabName_Featured"	"精選項目"
"DOTA_TabName_Heroes"	"英雄"
"DOTA_Profile_Edit"	"編輯個人檔案"
"DOTA_Profile_SendMessage"	"傳送訊息"
"DOTA_Trophies_ViewAvailable"	"可選寶藏"
"DOTA_TrophyXPProgress"	"{d:trophy_xp} / {d:total_trophy_xp}<span class=\"TrophyPointTextSmall\">TP</span>"
"DOTA_TrophyDetails_XP"	"{d:trophy_details_xp}<span class=\"TrophyPointTitleSmall\">TP</span>"
"DOTA_TrophyDetails_PointsPerLevel"	"此獎盃每次升級時將獎勵您 {d:trophy_points_per_level} 獎盃積分。"
"DOTA_Trophy_Upgraded"	"獎盃已升級"
"DOTA_Trophy_Achieved"	"獲得的獎盃"
"DOTA_TrophyPlusProfileXP"	"+{d:trophy_xp} 獎盃積分（TP）"
"DOTA_Lobby_Settings_Tournament_None"	"無"
"DOTA_WatchReplaysConextMenu_Watch"	"觀看"
"DOTA_WatchReplaysConextMenu_DownloadWatch"	"現在下載觀看"
"DOTA_WatchReplaysConextMenu_DownloadWatchLater"	"下載並稍後再看"
"DOTA_WatchReplaysConextMenu_WatchLater"	"稍後再看"
"DOTA_WatchReplaysConextMenu_WatchLaterClear"	"從稍後再看名單中移除"
"DOTA_WatchReplays_Game1"	"第 1 場"
"DOTA_WatchReplays_Game2"	"第 2 場"
"DOTA_WatchReplays_Game3"	"第 3 場"
"DOTA_WatchReplays_Game4"	"第 4 場"
"DOTA_WatchReplays_Game5"	"第 5 場"
"DOTA_WatchTournaments_PrizePoolLabel"	"總獎金"
"DOTA_WatchTournaments_PrizePoolTicketPrice"	"門票 {g:dota_item_price:ticket_itemdef}"
"DOTA_WatchTournaments_PrizePoolActivate"	"使用門票"
"DOTA_WatchTournaments_LiveGames"	"- 比賽直播中"
"DOTA_WatchTournaments_View"	"檢視"
"DOTA_WatchTournaments_Region_NA"	"北美"
"DOTA_WatchTournaments_Region_SA"	"南美"
"DOTA_WatchTournaments_Region_EU"	"歐洲"
"DOTA_WatchTournaments_Region_RU"	"俄羅斯"
"DOTA_WatchTournaments_Region_CN"	"中國"
"DOTA_WatchTournaments_Region_SEA"	"東南亞"
"DOTA_WatchTournament_BestOf3"	"三戰兩勝制"
"DOTA_WatchTournament_BestOf5"	"五戰三勝制"
"DOTA_ShuffledItem_Label"	"已加入自動隨選欄"
"DOTA_EquippedItem_Button_SingleItemShuffle"	"裝備"
"DOTA_Armory_Category_Leagues"	"聯賽物品"
"DOTA_Armory_Category_Charms"	"護符"
"DOTA_Armory_Category_MegaKills"	"連殺語音"
"DOTA_Armory_Category_Treasures"	"寶藏"
"DOTA_Armory_Category_Bundles"	"同捆包"
"DOTA_Armory_Category_Tools"	"工具"
"DOTA_Armory_ActiveFilterLabel"	"篩選條件："
"DOTA_Armory_EditFilter"	"編輯過濾器"
"DOTA_Armory_Filter_Tradeable"	"可交易"
"DOTA_Armory_Filter_Equipped"	"裝備中"
"DOTA_Armory_Filter_Duplicate"	"有多的"
"DOTA_Armory_Filter_HasSockets"	"鑿有鑲孔"
"DOTA_Armory_Filter_WillExpire"	"有期限"
"DOTA_Armory_Filter_IsBundle"	"同捆包"
"DOTA_Armory_Filter_Rarity"	"稀有度"
"DOTA_Armory_Filter_Quality"	"品質"
"DOTA_Armory_Filter_Tags"	"標籤"
"DOTA_Armory_Filter_FilterName"	"篩選器名稱"
"DOTA_GlobalItems_CursorPacks"	"滑鼠游標包"
"DOTA_Workshop_EditTarget"	"編輯目標"
"DOTA_Popup_Item_Received_Header_CollectionReward"	"您兌換了一個典藏品！"
"DOTA_Popup_Item_Received_Header_Recycling"	"您成功地鑄成一件物品！"
"DOTA_Popup_Item_Received_Button_Accept"	"接受"
"DOTA_Popup_Item_Received_Button_AcceptAll"	"接收全部 (共 {d:item_n} 件)"
"DOTA_TrophyDetails_PointsPerInterval"	"獎盃每 {d:trophy_points_interval_size} 級將獎勵您 {d:trophy_points_per_level} 獎盃積分。"
"LobbySetting_League_Value"	"{s:lobbysetting_league}"
"DOTA_WatchReplays_Pending"	"處理中…"
"DOTA_WatchReplays_Downloading"	"正在下載...{i:download_pct}%"
"DOTA_Armory_ContextMenu_EquipSet"	"裝備套裝"
"DOTA_Workshop_Ward_Model"	"守衛模型"
"DOTA_Tournament_Premium"	"超級聯賽"
"DOTA_Tournament_Professional"	"職業聯賽"
"DOTA_Tournament_Amateur"	"業餘聯賽"
"DOTA_Treasure_HelpHeader"	"每款寶藏均包含 {d:items_per_treasure} 件這些物品"
"DOTA_Treausre_HelpNoDupe"	"您在購買且開啟前都不會知道會拿到哪件。若多次購買，您在所有非稀有物品都拿完一輪前將不會重複獲得同樣的物品。"
"DOTA_Treasure_FilterAvailable"	"可選寶藏"
"DOTA_Treasure_FilterAll"	"全部"
"DOTA_Workshop_Tags_SingleItem"	"單品"
"DOTA_Trophies_ViewMyCollection"	"我的收藏"
"DOTA_Trophies_ViewActive"	"尚有升級空間"
"DOTA_Trophies_Info"	"獲得獎盃來提升您的 DOTA 等級。<br><br>每座獎盃所含的「獎盃積分（Trophy Points）」都不盡相同。您會在獲得獎盃，或獎盃的階級提升時獲得獎盃積分。<br><br>玩家的 DOTA 等級將隨著每獲得 100 分獎盃積分而提升 1 等級。"
"DOTA_Custom_Game_About"	"介紹"
"DOTA_EventName_FallMajor2015"	"2015 秋季"
"DOTA_Combine"	"合成"
"DOTA_Profile_SaveChanges"	"儲存變更"
"dota_lobby_broadcast_channel_title"	"導播頻道"
"dota_settings_shadowquality_off"	"關閉"
"dota_lobby_row_region"	"{s:region}"
"dota_lobby_browser_header_region"	"地區"
"dota_lobby_browser_all_regions"	"所有地區"
"DOTA_Armory_Category_CompendiumLevels"	"等級"
"DOTA_Armory_Category_CompendiumCoins"	"金幣"
"dota_profile_recent_games_option_show_ranked_mmr_change"	"顯示配對積分變化"
"dota_profile_recent_game_result_uncalibrated_ranked"	"校準中"
"dota_profile_recent_game_result_win_ranked"	"{i:ranked_mmr} (+{i:ranked_mmr_delta})"
"dota_profile_recent_game_result_loss_ranked"	"{i:ranked_mmr} ({i:ranked_mmr_delta})"
"DOTA_tooltip_econ_item_gift_dedication"	"{s:gift_dedication}"
"DOTA_econ_item_details_original_name_label"	"原始名稱："
"DOTA_econ_item_details_add_socket"	"新增鑲孔"
"DOTA_econ_item_details_extract_gem"	"取出寶石"
"DOTA_econ_item_details_extract_gem_short"	"取出"
"DOTA_econ_item_details_reset_gem"	"重置"
"DOTA_econ_item_details_gift_header"	"禮物"
"DOTA_econ_item_details_gift_clear_gifter"	"消除贈與人名稱"
"DOTA_econ_item_details_gift_clear_dedication"	"消除贈言"
"DOTA_econ_item_details_sockets_header"	"普通鑲孔"
"DOTA_econ_item_details_styles_header"	"樣式"
"DOTA_econ_item_details_style_name"	"{s:style_name}"
"DOTA_econ_item_details_style_selected"	"選擇"
"DOTA_econ_item_details_style_available"	"選擇"
"DOTA_econ_item_details_style_locked"	"已鎖定"
"DOTA_econ_item_details_tooltip_lock_reason"	"{s:style_lock_reason}"
"DOTA_econ_item_details_description_header"	"說明"
"DOTA_econ_item_details_description_reset"	"重置"
"DOTA_econ_item_details_description_edit"	"編輯"
"DOTA_Crafting"	"鑄造"
"DOTA_Workshop_Animation_Spawn_Desc"	"將單位臉部角度稍微往上抬，讓角色在遊戲中鳥瞰時有著更好的辨識性。"
"DOTA_Workshop_Animation_Idle_Desc"	"將單位臉部角度稍微往上抬，讓角色在遊戲中鳥瞰時有著更好的辨識性。至於角色肖像和裝備畫面則可另外提交臉部角度正常的動畫。"
"DOTA_Workshop_Animation_IdleAlt_Desc"	"將單位臉部角度稍微往上抬，讓角色在遊戲中鳥瞰時有著更好的辨識性。至於角色肖像和裝備畫面則可另外提交臉部角度正常的動畫。"
"DOTA_Workshop_Animation_IdleRare_Desc"	"將單位臉部角度稍微往上抬，讓角色在遊戲中鳥瞰時有著更好的辨識性。至於角色肖像和裝備畫面則可另外提交臉部角度正常的動畫。"
"DOTA_Workshop_Animation_Run_Desc"	"將單位臉部角度稍微往上抬，讓角色在遊戲中鳥瞰時有著更好的辨識性。"
"DOTA_Workshop_Animation_RunAlt_Desc"	"將單位臉部角度稍微往上抬，讓角色在遊戲中鳥瞰時有著更好的辨識性。"
"DOTA_Workshop_Animation_RunRare_Desc"	"將單位臉部角度稍微往上抬，讓角色在遊戲中鳥瞰時有著更好的辨識性。"
"DOTA_Workshop_Animation_RunInjured_Desc"	"將單位臉部角度稍微往上抬，讓角色在遊戲中鳥瞰時有著更好的辨識性。"
"DOTA_Workshop_Animation_PortraitRare_Desc"	"若您已將遊戲內的閒置姿勢將頭向上抬起，那麼請將單位的臉部移正已供肖像使用。同時不妨考慮別讓單位的肢體動作過於誇張，以避免在肖像中過於偏離畫面。"
"DOTA_Workshop_Animation_LoadoutIdle"	"著裝畫面閒置"
"DOTA_Workshop_Animation_LoadoutRare"	"稀有裝備畫面閒置"
"DOTA_Workshop_Animation_LoadoutRare_Desc"	"若您已將遊戲內的閒置姿勢將頭向上抬起，那麼請將裝備介面內的單位臉部移正，並讓動作的起始與結束姿勢和裝備介面閒置動作的起始與結束姿勢吻合，使其能順暢銜接。"
"DOTA_Workshop_SubmitNew"	"提交"
"DOTA_Workshop_SubmitUpdate"	"提交更新"
"DOTA_Workshop_SelectHero"	"選擇英雄"
"DOTA_Workshop_SelectSlot"	"選擇欄位"
"DOTA_Workshop_NoSlots"	"向無可用欄位"
"DOTA_Workshop_SelectHeroWearable"	"可裝備飾品"
"DOTA_Workshop_SelectAbility"	"選擇技能"
"DOTA_Workshop_SelectHeroAbilityModel"	"技能模組"
"DOTA_Workshop_SubmissionType_Courier"	"信使"
"DOTA_Workshop_SubmissionType_HudSkin"	"HUD 介面"
"DOTA_Workshop_SubmissionType_LoadingScreen"	"載入畫面"
"DOTA_Workshop_SubmissionType_Animation"	"動作"
"DOTA_Workshop_SubmissionType_ChatEmoticon"	"聊天表情符號"
"DOTA_Workshop_SubmissionType_ChatEmoticon_Desc"	"一個動態的表情符號。"
"DOTA_Workshop_SubmissionType_CursorPack"	"滑鼠游標包"
"DOTA_Workshop_BrowseForGeoFilter"	"模型"
"DOTA_Workshop_BrowseForImageFilter"	"圖片"
"DOTA_Workshop_BrowseForAnimFilter"	"動作"
"DOTA_Workshop_BrowseForPsdFilter"	"PSD"
"DOTA_Workshop_ImportS1Mask1"	"匯入Source1-樣式 面具 #1"
"DOTA_Workshop_Imported_S1MaskOverwrite_Title"	"覆寫檔案？"
"DOTA_Workshop_Imported_S1MaskOverwrite_Text"	"警告\n您確定要覆寫以下的檔案嗎？\n%1"
"DOTA_Sale_24"	"24小時特賣"
"DOTA_Teams_WindowTitle"	"隊伍"
"DOTA_TeamManagement_Country"	"國家"
"DOTA_TeamKickLabel"	"踢出"
"DOTA_TeamKickMember"	"踢出隊伍成員"
"DOTA_TeamConfirmKickMember"	"要踢出這位成員嗎？"
"DOTA_TeamsMyTeams"	"我的隊伍"
"DOTA_TeamsManageTeams"	"管理隊伍"
"DOTA_TeamImagesBrowse"	"瀏覽"
"DOTA_TeamJoinTeam"	"加入隊伍"
"DOTA_TeamDisbandTeam"	"解散隊伍"
"DOTA_ProfileCard_CompendiumPanel_ComingSoon"	"2015 秋季互動手冊尚未釋出"
"DOTA_GameMode_1"	"自由選取"
"DOTA_GameMode_3"	"隨機徵召"
"DOTA_GameMode_4"	"徵召模式"
"DOTA_GameMode_5"	"隨機模式"
"DOTA_GameMode_12"	"生疏模式"
"DOTA_GameMode_20"	"全隨機死鬥模式"
"DOTA_JoinChatChannel_Locked"	"本地目前無法使用地區頻道。"
"DOTA_Chat_CustomGameChannelName"	"{g:dota_custom_game_name:channel_name}"
"DOTA_ChatCommand_ShareProfile"	"shareprofile"
"DOTA_ChatCommand_FlipCoin"	"flip"
"DOTA_ChatCommand_FlipCoin_Name"	"擲幣"
"DOTA_Chat_ShareProfileMessage"	"我的 Dota 檔案是：<span class=\"ShareChatPersona\">[{s:share_persona}]</span>"
"DOTA_Frontpage_LastMatch_Title"	"上場比賽回顧"
"DOTA_Frontpage_LastMatch_Mode"	"模式"
"DOTA_Frontpage_LastMatch_KDA"	"K / D / A"
"DOTA_Frontpage_LastMatch_Duration"	"長度"
"DOTA_Frontpage_LastMatch_Result"	"結果"
"DOTA_Frontpage_LastMatch_Items"	"物品"
"DOTA_Frontpage_WatchLive_Title"	"目前最多人觀賞"
"DOTA_Frontpage_FriendCustom_Title"	"自訂遊戲"
"DOTA_Frontpage_FriendCustom_IsPlaying"	"正在玩"
"DOTA_Armory_Category_ScratchPad"	"收藏"
"dota_profile_oi_cancel"	"取消"
"DOTA_tooltip_econ_item_leaguename"	"{s:league_name}"
"DOTA_tooltip_econ_item_matchevent"	"{s:tournament_event}"
"DOTA_tooltip_econ_item_team1_name"	"{s:team1_name}"
"DOTA_tooltip_econ_item_team2_name"	"{s:team2_name}"
"DOTA_tooltip_econ_item_VS"	"VS"
"DOTA_tooltip_econ_item_event_description"	"{s:event_description}"
"DOTA_Compendium_Coin_Bank"	"{d:coin_bank}"
"DOTA_Compendium_Coin_Plus"	"+"
"DOTA_Compendium_Coins_Gained"	"{d:coins_gained}"
"DOTA_Workshop_ItemImport_HeroName_Label"	"英雄："
"DOTA_Workshop_ItemImport_CreateItem_Description"	"說明："
"DOTA_ItemPicker_Action"	"選擇"
"DOTA_ItemRedemption_Action"	"兌換"
"DOTA_ItemRedemption_ConfirmTitle"	"兌換物品"
"DOTA_GameMode_AllDraft"	"自由選取"
"DOTA_GameMode_22"	"自由選取"
"DOTA_WatchTournaments_Search"	"搜尋錦標賽..."
"DOTA_ProfileCard_Event_BuyLevels"	"購買等級"
"DOTA_ProfileCard_Event_SpendCoins"	"使用金幣"
"DOTA_ProfileCard_CompendiumLevel"	"互動手冊等級"
"DOTA_ProfileCard_CoinsBalance"	"金幣餘額"
"DOTA_ProfileCard_WageredCoinsWon"	"預測正確所得金幣"
"DOTA_Frontpage_ProPlaying_Title"	"職業選手比賽實況"
"LoadingScreenGameMode"	"{s:game_mode}"
"DOTA_econ_item_details_available_gem_count"	"可用的普通寶石：{d:available_gem_count}"
"DOTA_econ_item_details_rare_sockets_header"	"稀有鑲孔"
"DOTA_Crafting_Fall_2015"	"2015 秋季"
"DOTA_Crafting_Compendium"	"互動手冊"
"DOTA_Crafting_Title"	"2015 秋季互動手冊鑄造"
"DOTA_Crafting_Chart_Link"	"查看 2015 秋季互動手冊<br>物品級別表"
"DOTA_Crafting_Treasure_Link"	"檢視金幣寶藏"
"DOTA_Compendium_Level_Number"	"{d:compendium_level}"
"DOTA_Compendium_Level_Points"	"{d:compendium_points}"
"DOTA_Workshop_Attachment_Reset"	"重設"
"DOTA_Workshop_PreviewAspectRatio"	"外觀比例"
"DOTA_ReforgeItem_Title"	"{g:dota_item_name:header_item_def}"
"DOTA_AddSocket_ConfirmTitle"	"新增鑲孔"
"DOTA_SelectGem_Action"	"選擇"
"DOTA_RemoveGemFromSocket_RequiresMasterHammer"	"您需要一個「巧匠大師之錘」才能取出這顆寶石。"
"DOTA_Armory_Coin_Treasure_Tier1"	"黃金級"
"DOTA_Armory_Coin_Treasure_Tier2"	"白銀級"
"DOTA_Armory_Coin_Treasure_Tier3"	"青銅級"
"DOTA_Armory_DeleteItem_Header"	"刪除物品"
"DOTA_Workshop_LoadingScreen"	"載入畫面"
"DOTA_Workshop_Select"	"選取"
"DOTA_Workshop_SelectSubGroup"	"選取 %1 個群組"
"DOTA_Workshop_SelectTemplate"	"選取 %1 個模板"
"DOTA_Workshop_NoTemplates"	"尚無模板"
"DOTA_StyleUnlock_UnpackBundle"	"本同捆包含有可解鎖樣式的物品。您想要現在打開嗎？"
"DOTA_StyleUnlock_UnpackBundleError"	"本同捆包含有可解鎖樣式的物品。但在解鎖樣式前，你必須先打開同捆包。"
"DOTA_Settings_Tooltip_TargetedAttackMove"	"當下達移動攻擊命令時，所選擇的單位將選擇當下距離滑鼠游標最近的單位作為攻擊目標。"
"DOTA_ChatCommand_ShareParty_Name"	"分享團隊"
"DOTA_ChatCommand_ShareLobby"	"sharelobby"
"DOTA_ChatCommand_ShareLobby_Name"	"分享大廳"
"DOTA_ChatCommand_ShareLobby_Description"	"在此頻道分享出一個供他人加入您目前大廳的連結。"
"DOTA_ShareParty_Sent"	"我的團隊"
"DOTA_ShareParty_Joined"	"已加入"
"DOTA_ShareParty_Requested"	"已要求"
"DOTA_ShareParty_Requested_Tooltip"	"您已送出加入此團隊的請求。團隊隊長將可決定是否要接受您的請求。"
"DOTA_ShareParty_Available"	"加入團隊"
"DOTA_ShareLobby_Sent"	"我的大廳"
"DOTA_ShareLobby_Sent_Tooltip"	"其他玩家將可用滑鼠游標點擊這個連結來加入您的大廳。"
"DOTA_ShareLobby_Joined"	"已加入"
"DOTA_ShareLobby_Available"	"加入大廳"
"dota_settings_application"	"應用程式"
"DOTA_EconItemSet_Tooltip_HasRareGem"	"含有一顆或多顆寶石"
"DOTA_HeroLoadout_GlobalFilterName"	"通用物品"
"DOTA_Armory_Category_AllNew"	"全部 ({d:armory_new_items})"
"DOTA_Armory_Category_ScratchPad_Remove"	"清除"
"DOTA_Armory_Collection_Info"	"收藏是一個能供您盡情決定要擺什麼和自訂怎麼擺的軍械庫空間。<br><br>將物品拖曳進「收藏」按鈕來把該物品擺到裡頭的第一個空格。若要將物品從內清除，則直接將物品從收藏空間中拖曳出來即可。<br><br>擺進收藏內的物品依然會於軍械庫中顯示。"
"DOTA_Armory_Filter_InScratchpad"	"在收藏內"
"DOTA_Workshop_Animation_HeroSummons_Idle_Desc"	"將單位臉部角度稍微往上抬，讓角色在遊戲中鳥瞰時有著更好的辨識性。至於角色肖像和裝備畫面則可另外提交臉部角度正常的動畫。"
"DOTA_Workshop_Animation_FlyingCourier_IdleRare"	"稀有閒置（飛行）"
"DOTA_Workshop_Animation_HeroSummons_Run_Desc"	"將單位臉部角度稍微往上抬，讓角色在遊戲中鳥瞰時有著更好的辨識性。"
"DOTA_Workshop_Animation_FlyingCourier_RunRare"	"稀有奔跑（飛行）"
"DOTA_Socketing_Tooltip"	"鑲孔是種藉由在物品上開鑿插槽並將寶石嵌進去強化被鑲嵌物的方式。使用「巧匠鑿刀」來在物品上新增普通插槽，以及「巧匠之錘」來將普通寶石從鑲孔中取出。"
"DOTA_Profile_LeaguePassesPage"	"門票"
"DOTA_TournamentBracket_MatchList_Timestamp"	"{T:l:timestamp}"
"DOTA_WatchLive_Game_AverageMMR"	"平均積分 {i:avg_mmr}"
"ranked_mmr_team_label"	"團隊"
"ranked_mmr_team_value"	"{d:team_identity_rank}"
"DOTA_NotEquippedItem_Label"	"未裝備"
"DOTA_tooltip_econ_item_gift_allowed"	"可以贈送"
"DOTA_econ_item_details_equip_header"	"裝備狀態：{s:item_equip_state}"
"DOTA_econ_item_details_toggle_equip_state"	"{s:item_toggle_equip_state}"
"DOTA_Workshop_Imported_S1ColorOverwrite_Title"	"要覆寫檔案嗎？"
"DOTA_AddSocket_NeedChisels_Title"	"要購買巧匠鑿刀嗎？"
"DOTA_AddSocket_Fail_Title"	"無法新增鑲孔"
"DOTA_CoinTreasure_Title"	"2015 秋季互動手冊鑄造"
"DOTA_CoinTreasure_CraftingButton"	"前往鑄造"
"DOTA_SoaringCacheTreasure_BonusButton"	"查看額外貯藏"
"DOTA_CacheTreasure_MissingCompendiumOK"	"更多細節"
"DOTA_SplashAd_FallMajorSoaringCache_Title"	"秋季互動手冊翱翔貯藏"
"DOTA_SplashAd_FallMajorSoaringCache_Description"	"專屬於互動手冊持有者。開啟一個翱翔貯藏來取得由社群所創的新套裝。同時每開啟 5 個您都還將獲得一個額外貯藏。"
"DOTA_Custom_Game_Games_With_Lobbies"	"公開大廳"
"DOTAWatchDownloads_Count"	"本機中的重播：{i:replay_count}"
"DOTA_EquippedItem_Unequip"	"解除裝備"
"Customization_Description"	"說明"
"Customization_Description_Tool"	"說明標籤"
"DOTA_Leaf_Halloween2015_Title"	"靈園鬼域"
"DOTA_Leaf_Halloween2015_SubTitle"	"Valve 新推出的自訂遊戲"
"FrontPage_Halloween2015_Haunted_Colosseum_Header"	"新推出的自訂遊戲"
"FrontPage_Halloween2015_Haunted_Colosseum_Title"	"靈園鬼域"
"FrontPage_Halloween2015_Haunted_Colosseum_Desc"	"Valve 新推出的自訂遊戲"
"DOTA_ItemRemoveDescription_Title"	"移除說明？"
"DOTA_OwnedItemDetails_BundleName"	"包含在同捆包「{s:item_bundle}」內"
"DOTA_TournamentBracket_Match1"	"第 1 場"
"DOTA_TournamentBracket_Match2"	"第 2 場"
"DOTA_TournamentBracket_Match3"	"第 3 場"
"DOTA_TournamentBracket_Match4"	"第 4 場"
"DOTA_TournamentBracket_Match5"	"第 5 場"
"DOTA_TournamentBracket_Match6"	"第 6 場"
"DOTA_TournamentBracket_Match7"	"第 7 場"
"DOTA_TournamentBracket_Match8"	"第 8 場"
"DOTA_TournamentBracket_Match9"	"第 9 場"
"DOTA_TournamentBracket_Match10"	"第 10 場"
"DOTA_TournamentBracket_MatchList_Game"	"第 {i:game} 場"
"DOTATournamentBracketFormat"	"賽制"
"DOTA_TournamentDetails_Spoiler"	"劇透防護"
"DOTA_TournamentDetails_SpoilerOff"	"劇透防護"
"DOTA_TournamentMatchList_All"	"每日"
"DOTATournamentDetailsGrid"	"場次格框"
"FrontPage_VideoStream_Watch"	"在遊戲內觀看"
"FrontPage_VideoStream_BroadcastUpcomingSoon"	"即將開始"
"DOTA_TournamentBracket_Sidebar_Soon"	"即將開始"
"DOTATournamentMatchReveal"	"顯示結果"
"DOTATournamentGameWinner"	"獲勝方"
"DOTATournamentMatch_BestOf3"	"三戰兩勝制"
"DOTATournamentMatch_BestOf5"	"五戰三勝制"
"UI_month_0"	"1月"
"UI_month_1"	"2月"
"UI_month_2"	"3月"
"UI_month_3"	"4月"
"UI_month_4"	"5月"
"UI_month_5"	"6月"
"UI_month_6"	"7月"
"UI_month_7"	"8月"
"UI_month_8"	"9月"
"UI_month_9"	"10月"
"UI_month_10"	"11月"
"UI_month_11"	"12月"
"UI_month_short_0"	"1月"
"UI_month_short_1"	"2月"
"UI_month_short_2"	"3月"
"UI_month_short_3"	"4月"
"UI_month_short_4"	"5月"
"UI_month_short_5"	"6月"
"UI_month_short_6"	"7月"
"UI_month_short_7"	"8月"
"UI_month_short_8"	"9月"
"UI_month_short_9"	"10月"
"UI_month_short_10"	"11月"
"UI_month_short_11"	"12月"
"UI_day_1"	"週日"
"UI_day_2"	"週一"
"UI_day_3"	"週二"
"UI_day_4"	"週三"
"UI_day_5"	"週四"
"UI_day_6"	"週五"
"UI_day_7"	"週六"
"UI_day_short_1"	"日"
"UI_day_short_2"	"一"
"UI_day_short_3"	"二"
"UI_day_short_4"	"三"
"UI_day_short_5"	"四"
"UI_day_short_6"	"五"
"UI_day_short_7"	"六"
"UI_day_shorter_1"	"日"
"UI_day_shorter_2"	"一"
"UI_day_shorter_3"	"二"
"UI_day_shorter_4"	"三"
"UI_day_shorter_5"	"四"
"UI_day_shorter_6"	"五"
"UI_day_shorter_7"	"六"
"DOTA_MainMenu_Store"	"商城"
"dota_settings_patrol"	"巡邏"
"dota_settings_shadowquality_ultra"	"超高"
"DOTA_Store_TopSellers"	"暢銷商品"
"DOTA_Store_NewReleases"	"新品上架"
}
