"dota"
{
"DOTA_Accept"	"Hyväksy"
"DOTA_Cancel"	"Peruuta"
"DOTA_Console"	"Konsoli"
"DOTA_Create"	"Luo"
"DOTA_Decline"	"Hylkää"
"DOTA_Error"	"Virhe"
"DOTA_Join"	"Liity"
"DOTA_Leave"	"Poistu"
"DOTA_New"	"Uutta"
"DOTA_Ok"	"OK"
"DOTA_Sale"	"Ale"
"DOTA_Close"	"Sulje"
"DOTA_Continue"	"Jatka"
"DOTA_Add"	"Lisää"
"DOTA_Edit"	"Muokkaa"
"DOTA_Enable"	"Ota käyttöön"
"DOTA_Disable"	"Poista käytöstä"
"DOTA_Refresh"	"Päivitä"
"DOTA_Loading"	"Ladataan"
"DOTA_None"	"Ei mitään"
"DOTA_Customize"	"Mukauta"
"DOTA_AcceptChanges"	"Hyväksy muutokset"
"dota_team_radiant"	"Radiant"
"dota_team_dire"	"Dire"
"Unknown"	"Tuntematon"
"UI_Yes"	"Kyllä"
"UI_No"	"Ei"
"UI_File_Filter_Any"	"Kaikki tiedostotyypit (*.*)"
"DOTA_MainMenu_Heroes"	"Sankarit"
"DOTA_MainMenu_Watch"	"Katso"
"DOTA_MainMenu_Learn"	"Opi"
"DOTA_TabName_GlobalItems"	"Yleisesineet"
"DOTA_ConfirmQuit"	"Varmista poistuminen"
"DOTA_ConfirmQuitDesc"	"Haluatko varmasti poistua Dota 2:sta?"
"DOTA_ConfirmQuitDescUnsafe"	"Pelistä poistuminen ennen sen loppumista voi pilata muiden pelaajien pelin. Haluatko varmasti poistua Dota 2:sta?"
"DOTA_InvalidPersonaName"	"[tuntematon]"
"DOTA_Friends_WindowTitle"	"KAVERIT"
"DOTA_FriendsCategory_PlayingDota"	"Dotassa <font color='#ACEBA9'>({d:friend_count})</font>"
"DOTA_FriendsCategory_Online"	"Paikalla <font color='#6a9dcc'>({d:friend_count})</font>"
"DOTA_FriendsCategory_Offline"	"Kirjautuneena ulos <font color='#676666'>({d:friend_count})</font>"
"DOTA_Friends_Empty"	"Kaveriluettelosi on tällä hetkellä tyhjä"
"DOTA_FriendsMenu_Tooltip_NoneReady"	"Kaverit"
"DOTA_UserName"	"{g:dota_persona:user_account_id}"
"DOTA_UserNamePro"	"{g:dota_persona_pro:user_account_id}"
"DOTA_UserNickname"	"{g:dota_persona_nickname:user_account_id}"
"DOTA_UserRichPresence"	"{s:user_rich_presence}"
"DOTA_ProfileCard_StatTitle_SoloRank"	"Yksilöranking"
"DOTA_ProfileCard_StatTitle_PartyRank"	"Ryhmäranking"
"DOTA_ProfileCard_StatTitle_Wins"	"Voitot"
"DOTA_ProfileCard_StatTitle_Commends"	"Kehut"
"DOTA_ProfileCard_StatTitle_GamesPlayed"	"Ottelut"
"DOTA_ProfileCard_StatTitle_FirstMatchDate"	"Ensimmäinen peli"
"DOTA_ProfileCard_StatValue_Int"	"{d:stat_value}"
"DOTA_ProfileCard_StatValue_Date"	"{t:s:stat_value}"
"DOTA_ProfileCard_StatValue_String"	"{s:stat_value}"
"DOTA_ProfileCard_SlotTab_Trophies"	"Pokaalit"
"DOTA_ProfileCard_SlotTab_Items"	"Esineet"
"DOTA_ProfileCard_SlotTab_Heroes"	"Sankarit"
"DOTA_ProfileCard_SlotTab_Emoticons"	"Hymiöt"
"DOTA_ProfileCard_NoTrophies"	"Ei pokaaleja saatavilla."
"DOTA_ProfileCard_NoItems"	"Ei esineitä saatavilla."
"DOTA_ProfileCard_HeroOnly"	"Vain sankari"
"DOTA_ProfileCard_HeroShowWins"	"Näytä voitot"
"DOTA_ProfileCard_HeroShowWinsAndLosses"	"Näytä voitot-häviöt"
"DOTA_ProfileCard_ItemSearchPrefix"	"Hae:"
"DOTA_ProfileCard_ItemSearchPlaceholder"	"Esineitä nimeltä"
"DOTA_HeroTooltip_HeroName"	"{s:hero_name}"
"DOTA_HeroTooltip_HeroRecord"	"{s:hero_wins_string}, {s:hero_losses_string}"
"DOTA_ProfileCard_HeroSearchPlaceholder"	"Etsi sankarin nimellä"
"DOTA_Wins_Singular"	"1 voitto"
"DOTA_Wins_Plural"	"{d:hero_wins} voittoa"
"DOTA_Losses_Singular"	"1 häviö"
"DOTA_Losses_Plural"	"{d:hero_losses} häviötä"
"DOTA_Profile_TotalGames"	"Pelejä yhteensä"
"DOTA_Profile_Solo_MMR"	"Yksilöranking"
"DOTA_Profile_Team_MMR"	"Joukkueranking"
"DOTA_Profile_Party_MMR"	"Ryhmäranking"
"DOTA_Profile_VictoryCount"	"Voitot"
"DOTA_Profile_ProfilePage"	"Profiili"
"DOTA_Profile_RecentGamesPage"	"Viimeaikaiset pelit"
"DOTA_Profile_HeroPage"	"Sankarit"
"DOTA_Profile_PlayStyle"	"Pelityyli"
"DOTA_Profile_MostRecent"	"Edelliset {s:num_style_games} peliä"
"DOTA_Profile_Fighting"	"Taisteleminen"
"DOTA_Profile_Fighting_TooltipTitle"	"Taisteleminen"
"DOTA_Profile_Fighting_Tooltip"	"Pelaaja kahinoi usein vihollisten kanssa."
"DOTA_Profile_Pushing"	"Puskeminen"
"DOTA_Profile_Pushing_TooltipTitle"	"Puskeminen"
"DOTA_Profile_Pushing_Tooltip"	"Pelaaja puskee torneja, luoden kartalle elintilaa."
"DOTA_Profile_Versatility"	"Monipuolisuus"
"DOTA_Profile_Versatility_TooltipTitle"	"Monipuolisuus"
"DOTA_Profile_Versatility_Tooltip"	"Pelaaja pelaa monia erilaisia sankareita."
"DOTA_Profile_Tooltip_Value"	"{s:CurrentStatValue}"
"DOTA_Profile_Tooltip_Comparison"	"{s:CurrentComparisonValue}"
"DOTA_Profile_StatsCompare"	"Vertaa omiin tilastoihini"
"DOTA_Profile_Self"	"Minä"
"DOTA_Profile_Rampages"	"Täystuhot"
"DOTA_Profile_TripleKills"	"Triplatapot"
"DOTA_Profile_FirstBlood"	"Ensimmäiset tapot"
"DOTA_Profile_FirstBled"	"Ensimmäiset kuolemat"
"DOTA_Profile_CourierKills"	"Kuriireja tapettu"
"DOTA_Profile_Aegises"	"Aegista siepattu"
"DOTA_Profile_CheeseEaten"	"Syödyt Cheeset"
"DOTA_Profile_GPMValue"	"{s:GPM}"
"DOTA_Profile_XPMValue"	"{s:XPM}"
"DOTA_Profile_LHValue"	"{s:LH}"
"DOTA_Profile_RampagesValue"	"{d:Rampages}"
"DOTA_Profile_TripleKillsValue"	"{d:TripleKills}"
"DOTA_Profile_FirstBloodValue"	"{d:FirstBlood}"
"DOTA_Profile_FirstBledValue"	"{d:FirstBled}"
"DOTA_Profile_CourierKillsValue"	"{d:CourierKills}"
"DOTA_Profile_AegisesValue"	"{d:Aegises}"
"DOTA_Profile_CheeseEatenValue"	"{d:CheeseEaten}"
"DOTA_Profile_CreepStackValue"	"{d:CreepStack}"
"DOTA_Profile_GPMLocalValue"	"{s:GPMLocal}"
"DOTA_Profile_XPMLocalValue"	"{s:XPMLocal}"
"DOTA_Profile_LHLocalValue"	"{s:LHLocal}"
"DOTA_Profile_RampagesLocalValue"	"{d:RampagesLocal}"
"DOTA_Profile_TripleKillsLocalValue"	"{d:TripleKillsLocal}"
"DOTA_Profile_FirstBloodLocalValue"	"{d:FirstBloodLocal}"
"DOTA_Profile_FirstBledLocalValue"	"{d:FirstBledLocal}"
"DOTA_Profile_CourierKillsLocalValue"	"{d:CourierKillsLocal}"
"DOTA_Profile_AegisesLocalValue"	"{d:AegisesLocal}"
"DOTA_Profile_CheeseEatenLocalValue"	"{d:CheeseEatenLocal}"
"DOTA_Profile_CreepStackLocalValue"	"{d:CreepStackLocal}"
"DOTA_RecentGames_Title"	"Viimeaikaiset pelit"
"DOTA_RecentGames_TimeStamp"	"PVM/KLO"
"DOTA_RecentGames_HeroSelection"	"Sankari"
"DOTA_RecentGames_GameResult"	"Lopputulos"
"DOTA_RecentGames_GameLength"	"Kesto"
"DOTA_RecentGames_Team"	"Joukkue"
"DOTA_RecentGames_GameType"	"Pelityyppi"
"DOTA_RecentGames_Items"	"Esineet"
"DOTA_RecentGame_Timestamp_Entry"	"{t:s:timestamp} {t:t:timestamp}"
"DOTA_RecentGame_Duration"	"{t:d:duration}"
"DOTA_RecentGame_Downloading"	"{s:DownloadPercent} ladattu"
"DOTA_RecentGame_Watch"	"Katso uusinta"
"DOTA_RecentGame_NoReplay"	"Ei uusintaa"
"DOTA_RecentGame_Expired"	"Uusinta vanhentunut"
"DOTA_RecentGame_Finding"	"Etsitään..."
"DOTA_RecentGame_Download"	"Lataa ottelu"
"DOTA_RecentGame_Pending"	"Uusinta odottaa"
"DOTA_RecentGame_Unavailable"	"Uusinta ei saatavilla"
"DOTA_RecentGame_MatchID"	"Ottelun tunnus: #{s:match_id}"
"DOTA_No_Team_Name"	"--"
"DOTA_TrophyCount"	"{d:trophy_count} pokaali"
"DOTA_TrophiesCount"	"{d:trophy_count} pokaalia"
"DOTA_TrophyCount_Number"	"{d:trophy_count}"
"DOTA_Trophies_ViewAll"	"Näytä kaikki"
"DOTA_TrophyName"	"{s:trophy_name}"
"DOTA_TrophyCategory"	"{s:trophy_category}"
"DOTA_TrophyDescription"	"{s:trophy_description}"
"DOTA_NextTrophy"	"Seuraava palkinto"
"DOTA_NewPlayerQuestion_Title"	"DOTA 2 TOIVOTTAA SINUT TERVETULLEEKSI"
"DOTA_PlayerOriginQuestion_Question"	"Pelikokemuksesi parantamiseksi ole hyvä ja kerro, kuinka tuttuja Dota 2 ja vastaavat pelit ovat sinulle:"
"DOTA_PlayerOriginQuestion_BeginnerButton"	"Olen aloittelija."
"DOTA_PlayerOriginQuestion_RTSButton"	"Olen pelannut RTS-pelejä aiemminkin."
"DOTA_PlayerOriginQuestion_MOBAButton"	"Olen pelannut samankaltaisia pelejä kuin Dota 2."
"DOTA_PlayerOriginQuestion_Dota2Button"	"Olen pelannut Dota 2:ta."
"DOTA_PlayerOriginQuestion_MOBAExplanation"	"Valitse peli, joka on sinulle tutuin:"
"DOTA_OtherGames_LOL"	"League of Legends"
"DOTA_OtherGames_DOTA"	"DotA 1"
"DOTA_OtherGames_HON"	"Heroes of Newerth"
"DOTA_OtherGames_Smite"	"Smite"
"DOTA_OtherGames_Other"	"Muu peli"
"DOTA_PlayerOriginQuestion_ConfirmationButton"	"PELATAAN"
"DOTA_PlayerOriginQuestion_ConfirmationTutorial"	"Uutena Dota-pelaajana sinua saattaa kiinnostaa opetuspelit, jotka löytyvät Pelaa-osion kohdasta Harjoittelu. Opetuspelit ovat tärkeä ensimmäinen askel muiden pelaajien murskaamisessa."
"DOTA_PlayerOriginQuestion_ConfirmationSettings"	"Pikanäppäimet ja asetukset on nyt asetettu niin kuin useimmat yhtä kokeneet pelaajat niitä käyttävät. Voit vaihtaa niitä milloin tahansa painamalla asetuspainiketta."
"DOTA_Tutorial_SkipButton"	"Ohita opastus"
"DOTA_ConfirmSkip"	"Ohita Dota 2:n esittely?"
"DOTA_ConfirmSkipDesc"	"Haluatko varmasti ohittaa johdatuksen Dota 2:een?"
"DOTA_Tutorial_Start_Quest"	"ALOITA TEHTÄVÄ"
"DOTA_Tutorial_Quest0_Title"	"TEHTÄVÄ 1"
"DOTA_Tutorial_Quest0_TitleDesc"	"KAUKOTAISTELIJA"
"DOTA_Tutorial_Quest0DetailsDesc"	"Tehtävän suorittamiseen\nkuluu noin 10 minuuttia."
"DOTA_Tutorial_QuestDetailsLearn"	"Aiheet:"
"DOTA_Tutorial_Quest0DetailsLesson"	"Sankarin liikkuminen\nSankarin tasot\nKykyjen käyttäminen\nEsineet\nTaistelun perusteet\nTappavat osumat"
"DOTA_Tutorial_Quest1_Title"	"TEHTÄVÄ 2"
"DOTA_Tutorial_Quest1DetailsDesc"	"Tehtävän suorittamiseen\nkuluu noin 10 minuuttia."
"DOTA_Tutorial_Quest2_Title"	"TEHTÄVÄ 3"
"DOTA_Tutorial_Quest2DetailsDesc"	"Tehtävän suorittamiseen\nkuluu noin 10-15 minuuttia."
"DOTA_Tutorial_Quest2DetailsLesson"	"Taistelu linjalla\nTornien puolustaminen ja puskeminen\nAloitusesineet"
"DOTA_Challenges_Title"	"Opi"
"DOTA_ChallengeGroup_0_Title"	"Mekaniikat"
"DOTA_ChallengeGroup_1_Title"	"Ohjatut bottipelit"
"DOTA_ChallengeGroup_1_Desc"	"Aloita tästä!"
"DOTA_ChallengeGroup_2_Title"	"Bottipelit"
"DOTA_ChallengeGroup_More"	"Lisää tulossa"
"DOTA_ChallengeGroup_Locked"	"Lukittu"
"DOTA_LearnMechanics_Title"	"Mekaniikat"
"DOTA_LearnMechanics_SubTitle"	"Nämä johdannot opettavat sinulle Dotan perusasiat. Emme kuitenkaan suosittele, että aloittaisit pelaamalla näitä. Kokeile sen sijaan aloittaa ohjattu bottipeli, ja palaa näihin jos koet tarvitsevasi apua."
"DOTA_Mechanics_0_Title"	"Mekaniikat 1"
"DOTA_Mechanics_0_Desc"	"Sankarin liikkuminen\nSankarin tasot\nKykyjen käyttäminen\nEsineet\nTaistelun perusteet\nTappavat osumat"
"DOTA_Mechanics_1_Title"	"Mekaniikat 2"
"DOTA_Mechanics_1_Desc"	"Kaukotaistelu\nAluevaikutukset\nKartta\nTornit\nKuriirit ja säilö\nTeleporttaus"
"DOTA_LearnGuidedBotMatches_Title"	"Ohjatut bottipelit"
"DOTA_LearnGuidedBotMatches_SubTitle"	"Opi pelaamaan Dotaa tekoälyn ohjaamien sankareiden parissa. Opastamme sinut täyspitkän ottelun kaikkien vaiheiden läpi askel askeleelta, samalla kun kehität sankaristasi pysäyttämättömän pedon."
"DOTA_GuidedBotMatches_0_Title"	"Luna"
"DOTA_GuidedBotMatches_0_Desc"	"Lyhyen kantaman hyökkäys\nSuuri hyökkäysvahinko\nNopea liikkumaan\nKohtalaisen haavoittuvainen\nPiirre: ketteryys"
"DOTA_GuidedBotMatches_1_Title"	"Sven"
"DOTA_GuidedBotMatches_1_Desc"	"Lähitaistelija\nRäjähdysmäinen hyökkäysvahinko\nKestävä\nKärsii hidastuksia vastaan\nPiirre: voima"
"DOTA_GuidedBotMatches_2_Title"	"Lina"
"DOTA_GuidedBotMatches_2_Desc"	"Pitkän kantaman hyökkäys\nTuhoisat loitsut\nLyhyet latausajat\nErittäin haavoittuvainen\nPiirre: älykkyys"
"DOTA_LearnBotMatches_Title"	"Bottipelit"
"DOTA_LearnBotMatches_SubTitle"	"Kun olet pelannut ohjattuja bottipelejä, kokeile harjoittelua tekoälyä vastaan. Bottipelit ovat stressitön tapa jatkaa oppimista, ja monet pelaajat jatkavatkin harjoittelua bottipelien avulla pitkän aikaa."
"DOTA_BotMatches_0_Title"	"Helpot botit"
"DOTA_BotMatches_0_Desc"	"Tutustu uuteen sankariin."
"DOTA_BotMatches_1_Title"	"Keskitason botit"
"DOTA_BotMatches_1_Desc"	"Nauti olostasi."
"DOTA_BotMatches_2_Title"	"Vaikeat botit"
"DOTA_BotMatches_2_Desc"	"Haasta itseäsi."
"DOTA_BotMatches_3_Title"	"Epäreilut botit"
"DOTA_BotMatches_3_Desc"	"Satuta itseäsi."
"FileOpenDialog_Open"	"Avaa"
"FileOpenDialog_Save"	"Tallenna"
"FileOpenDialog_Select"	"Valitse"
"FileOpenDialog_FileType_Folder"	"Tiedostokansio"
"DOTA_FindMatch"	"Etsi peli"
"DOTA_FindingMatch"	"Etsitään peliä ( {s:find_match_time} )"
"DOTA_FindMatchTime"	"{s:find_match_time}"
"DOTA_Searching"	"Etsitään"
"DOTA_StartSoloBotMatch"	"Aloita bottipeli"
"DOTA_Create_Lobby"	"Perusta aula"
"DOTA_Join_Lobby"	"Liity aulaan"
"DOTA_LobbyStartGame"	"Aloita peli"
"DOTA_ReturnToLobby"	"Palaa aulaan"
"DOTA_FindMatchStatus"	"{s:searching_matchtype} / {s:searching_gamemodes} / {s:searching_region}"
"DOTA_FindGameModesMany"	"Pelimuodot:"
"DOTA_FindRegionsMany"	"Alueet:"
"DOTA_GameMode_AllPick"	"Vapaa valinta"
"DOTA_GameMode_SingleDraft"	"Piirrevalinta"
"DOTA_GameMode_CaptainsMode"	"Kapteenitila"
"DOTA_GameMode_RandomDraft"	"Joukkovalinta"
"DOTA_GameMode_AbilityDraft"	"Kykyvalinta"
"DOTA_GameMode_LeastPlayed"	"Vähiten pelatut"
"DOTA_GameMode_AllRandom"	"Satunnaisvalinta"
"DOTA_GameMode_LimitedHeroes"	"Rajatut sankarit"
"DOTA_GameMode_CaptainsDraft"	"Kapteenin valinta"
"DOTA_GameMode_AllRandomDeathMatch"	"Satunnainen surmamatsi"
"DOTA_ImmediatePurchase_Cancelled_Title"	"Peruutettu"
"DOTA_ConfirmPurchaseTitle"	"Vahvista ostos"
"DOTA_ConfirmPurchaseText"	"Haluatko ostaa tämän esineen?"
"DOTA_PartnerRecharge_Close"	"Takaisin ostokseen"
"StoreCheckout_Error_Title"	"Virhe"
"StoreCheckout_NoItems"	"Ostoskärrysi on tyhjä!"
"StoreCheckout_TooManyItems"	"Ostoskärryssäsi on liian monta esinettä!"
"StoreCheckout_Loading"	"Menossa kassalle..."
"StoreCheckout_Unavailable"	"Maksaminen ei onnistu tällä hetkellä."
"StoreCheckout_Cancelling"	"Perutaan..."
"StoreCheckout_Fail"	"Pelin sisäinen kauppa on tällä hetkellä suljettu."
"StoreCheckout_InvalidParam"	"Ohjelmoija mokasi! Virheellinen parametri lähetettiin pelikoordinaattorille. Yritä ostoksen tekemistä uudelleen."
"StoreCheckout_InternalError"	"Maksutapahtumasi alustuksessa tai päivittämisessä näyttää tapahtuneen virhe. Odota hetki ja yritä uudelleen tai ota yhteyttä tukeen."
"StoreCheckout_ContactSupport"	"Maksutapahtumassasi tapahtui virhe. Ota yhteyttä tukeen."
"StoreCheckout_NotApproved"	"Pelikoordinaattori ei pysytynyt varmentamaan maksutapahtumaasi Steamin kautta. Yritä ostoksen tekemistä myöhemmin."
"StoreCheckout_NotLoggedin"	"Sinun tulee olla kirjautunut Steamiin suorittaaksesi ostoksen loppuun."
"StoreCheckout_WrongCurrency"	"Maksutapahtuman valuutta ei vastaa lompakkosi valuuttaa."
"StoreCheckout_NoAccount"	"Steam-tilisi ei ole tällä hetkellä käytettävissä. Yritä suorittaa ostos myöhemmin."
"StoreCheckout_InsufficientFunds"	"Varasi eivät riitä tämän ostoksen tekemiseen."
"StoreCheckout_TimedOut"	"Maksutapahtuma aikakatkaistiin. Yritä ostoksen tekemistä uudelleen."
"StoreCheckout_SteamAccountDisabled"	"Steam-tilisi on pois käytöstä, eikä sillä voi tehdä ostoksia."
"StoreCheckout_SteamAccountNoPurchase"	"Steam-lompakon maksutapahtumat tällä tilillä on poistettu käytöstä."
"StoreCheckout_OldPriceSheet"	"Paikallinen tuoteluettelosi on vanhentunut. Pyydetään uutta."
"StoreCheckout_TransactionNotFound"	"Pelikoordinaattori ei löytänyt tämän maksutapahtuman tunnusta. Yritä ostoksen tekemistä myöhemmin."
"StoreCheckout_TransactionCompleted"	"Maksutapahtuma valmis!\\\nNauti saaliistasi!"
"StoreCheckout_CompleteButUnfinalized"	"Onnistumisen varmentaminen epäonnistui. Jos varmennus onnistuu, esineesi toimitetaan sinulle myöhemmin."
"StoreCheckout_NotEnoughRoom"	"Asevarastossasi ei ole riittävästi tilaa näin monen esineen ostamiseen."
"StoreCheckout_ContactSupport_Dialog_Title"	"Varoitus"
"StoreCheckout_ContactSupport_Dialog_Btn"	"Ota yhteyttä"
"StoreCheckout_LimitedQuantityItemsUnavailable"	"Esine, jota yrität ostaa, on loppuunmyyty tai se ei ole tällä hetkellä saatavilla."
"StoreCheckout_Nexon_InsufficientFunds"	"Sinulla ei ole tarpeeksi varoja tämän ostoksen tekemiseen."
"StoreCheckout_Nexon_FundsLocked"	"Nexonin käteislukko käytössä."
"npc_dota_hero_witch_doctor_hype"	"Witch Doctor on aina sitä, mitä hänen tiiminsä tarvitsee. Hän voi parantaa liittolaistensa haavat, tainnuttaa ja kirota vihollisensa, tai tuhota viholliset pelkästään tanssimalla ultimate-kykynsä turvin. Ei ole montaa, joka voittaa Witch Doctorin monipuolisuudessa."
"DOTA_AbilityTooltip_Name"	"{s:name}"
"DOTA_AbilityTooltip_Level"	"Taso {s:level}"
"DOTA_AbilityTooltip_TargetType"	"KOHDE: {s:targettype}"
"DOTA_AbilityTooltip_CastType"	"KYKY: {s:casttype}"
"DOTA_AbilityTooltip_DamageType"	"VAHINKOTYYPPI: {s:damagetype}"
"DOTA_AbilityTooltip_SpellImmunityType"	"LOITSUIMMUNITEETTI: {s:spellimmunity}"
"DOTA_AbilityTooltip_Description"	"{s:description}"
"DOTA_AbilityTooltip_ScepterDescription"	"{s:scepterdescription}"
"DOTA_AbilityTooltip_ExtraDescription"	"{s:extradescription}"
"DOTA_AbilityTooltip_Attributes"	"{s:attributes}"
"DOTA_AbilityTooltip_Cooldown"	"{s:cooldown}"
"DOTA_AbilityTooltip_ManaCost"	"{s:manacost}"
"DOTA_AbilityTooltip_Lore"	"{s:lore}"
"DOTA_AbilityTooltip_UpgradeLevel"	"Seuraava päivitys sankarin tasolla {d:upgradelevel}"
"DOTA_AbilityTooltip_BuildHeader"	"Kykyopas"
"DOTA_AbilityTooltip_BuildComment"	"{s:buildcomment}"
"DOTA_PersonaTooltip_Title"	"{g:dota_persona:account_id}"
"DOTA_PersonaTooltip_TitlePro"	"{g:dota_persona_pro:account_id}"
"DOTA_PendingInvites"	"Ryhmäkutsut"
"DOTA_PendingInvitesTooltip_None"	"Ei odottavia kutsuja"
"DOTA_PendingInvitesTooltip_1"	"1 odottava kutsu"
"DOTA_PendingInvitesTooltip_N"	"{d:pending_invite_count} odottavaa kutsua"
"DOTA_PendingInvitesTooltip_NonLeader"	"Näytä kutsut."
"DOTA_PendingInvitesCancelAll"	"Peruuta kaikki kutsut"
"DOTA_PendingInvitesNotPartyLeader"	"Vain ryhmän johtaja voi hallinnoida kutsuja"
"DOTA_ChatTab_NotInChannelMessage"	"Kukaan ei kuule sinua."
"DOTA_ChatTab_ToggleGlobal"	"Näytä tämän kanavan viestit kaikissa välilehdissä."
"DOTA_ChatTab_Close"	"Sulje tämä välilehti."
"DOTA_ChatTab_Leave"	"Poistu tältä kanavalta."
"DOTA_JoinChatChannel_Title"	"Liity kanavalle"
"DOTA_JoinChatChannel_Description"	"Perusta keskustelukanava tai liity kanavalle."
"DOTA_JoinChatChannel_AddToCurrentTab"	"Lisää nykyiseen välilehteen '{s:current_tab_name}'"
"DOTA_JoinChatChannel_CreateNewTab"	"Luo uusi välilehti:"
"DOTA_Chat_ChannelName"	"{s:channel_name}"
"DOTA_Chat_ChannelMemberCount_Singular"	"1 jäsen"
"DOTA_Chat_ChannelMemberCount_Plural"	"{d:channel_member_count} jäsentä"
"DOTA_EditChatTab_Description"	"Valitse, mitkä viestit näytetään tässä välilehdessä."
"DOTA_EditChatTab_AddNewChannel"	"Lisää uusi kanava..."
"DOTA_EditChatTab_TabName"	"Välilehden nimi:"
"DOTA_EditChatTab_Target"	"{s:target}"
"DOTA_Chat_TimestampFormat"	"{t:t:timestamp}"
"DOTA_Chat_Autocomplete_Title"	"{s:autocomplete_title}"
"DOTA_Chat_Autocomplete_NoMatches"	"Ei osumia"
"DOTA_Chat_Autocomplete_WhisperFriends"	"Kuiskaa kaverille"
"DOTA_Chat_Autocomplete_InviteFriends"	"Kutsu kaveri"
"DOTA_Chat_Autocomplete_Channels"	"Kanavat"
"DOTA_Chat_Autocomplete_Commands"	"Komennot"
"DOTA_Chat_Autocomplete_CommandName"	"/{s:command_name}"
"DOTA_Chat_Autocomplete_CommandDescription"	"{s:command_description}"
"dota_suggest_invite_format"	"Kutsu {s:invite_persona} ryhmään."
"dota_suggest_invite_format_leader"	"Kutsu {s:invite_persona} ryhmään. ( <a href=\"event:DOTAInviteToParty({s:invite_persona_steamid})\" class=\"InviteButton\">Lähetä kutsu</a> )"
"dota_suggest_invite_format_lobby"	"Kutsu {s:invite_persona} aulaan."
"dota_suggest_invite_format_lobby_leader"	"Kutsu {s:invite_persona} aulaan. ( <a href=\"event:DOTAInviteToLobby({s:invite_persona_steamid})\" class=\"InviteButton\">Lähetä kutsu</a> )"
"DOTA_ChatMessage_Default"	"<span class=\"{s:target_class}\"><span class=\"ChatTarget\">(<a href=\"{s:target_link}\">{s:target}</a>)</span> <span class=\"ChatPersona\">[{s:persona}]</span>: {s:message}</span>"
"DOTA_ChatMessage_WhisperTo"	"<span class=\"{s:target_class}\">@<span class=\"ChatPersona\">[{s:persona}]</span>: {s:message}</span>"
"DOTA_ChatMessage_WhisperFrom"	"<span class=\"{s:target_class}\"><span class=\"ChatPersona\">[{s:persona}]</span>: {s:message}</span>"
"DOTA_ChatMessage_System"	"<span class=\"{s:target_class}\"><span class=\"ChatTarget\">({s:target})</span>: {s:message}</span>"
"DOTA_ChatTarget_Format_Default"	"{s:target}"
"DOTA_ChatTarget_Format_Whisper"	"{s:persona}"
"DOTA_ChatTarget_Party"	"Ryhmä"
"DOTA_ChatTarget_Lobby"	"Aula"
"DOTA_ChatTarget_Team"	"Tiimi"
"DOTA_ChatTarget_Guild"	"Kilta"
"DOTA_ChatTarget_Fantasy"	"Fantasia"
"DOTA_ChatTarget_Console"	"Konsoli"
"DOTA_ChatTarget_Whisper"	"Kuiskaus"
"DOTA_ChatTarget_Invalid"	"Ei kanavaa"
"DOTA_ChatTarget_GameAll"	"Kaikki"
"DOTA_ChatTarget_GameAllies"	"Tiimi"
"DOTA_ChatTarget_GameCoaching"	"Valmennus"
"DOTA_ChatTarget_GameSpectator"	"Katsojat"
"DOTA_ChatTargetMenu_Title"	"{s:target}"
"DOTA_ChatTargetMenu_ToggleEnabled"	"{s:toggle_enabled}"
"DOTA_ChatTargetMenu_NotActive"	"(Ei käytössä)"
"DOTA_Chat_Placeholder"	"Keskustele kirjoittamalla tähän. '/' mahdollistaa komennot."
"DOTA_Chat_MissedMessages"	"{s:missed_message_count}"
"DOTA_ChatCommand_Party"	"p"
"DOTA_ChatCommand_Party_Name"	"Ryhmä"
"DOTA_ChatCommand_Party_Description"	"Puhu nykyisen ryhmän kesken."
"DOTA_ChatCommand_Lobby"	"l"
"DOTA_ChatCommand_Lobby_Name"	"Aula"
"DOTA_ChatCommand_Lobby_Description"	"Keskustele tämänhetkisen aulan kanssa."
"DOTA_ChatCommand_Channel"	"c"
"DOTA_ChatCommand_Channel_Name"	"Kanava"
"DOTA_ChatCommand_Channel_Description"	"Keskustele valitulla keskustelukanavalla."
"DOTA_ChatCommand_Whisper"	"w"
"DOTA_ChatCommand_Whisper_Name"	"Kuiskaa"
"DOTA_ChatCommand_Whisper_Description"	"Kuiski yksityisesti kaverin kanssa."
"DOTA_ChatCommand_Reply"	"r"
"DOTA_ChatCommand_Reply_Name"	"Vastaa"
"DOTA_ChatCommand_Reply_Description"	"Vastaa yksityisesti kaverin kuiskaukseen."
"DOTA_ChatCommand_Help"	"?"
"DOTA_ChatCommand_Help_Name"	"Ohje"
"DOTA_ChatCommand_Help_Description"	"Näytä keskustelukomentojen ohjeet."
"DOTA_ChatCommand_InviteToParty"	"partyinvite"
"DOTA_ChatCommand_InviteToParty_Name"	"Kutsu ryhmään"
"DOTA_ChatCommand_InviteToParty_Description"	"Kutsu kaveri nykyiseen ryhmääsi."
"DOTA_ChatCommand_LeaveParty"	"leaveparty"
"DOTA_ChatCommand_LeaveParty_Name"	"Lähde ryhmästä"
"DOTA_ChatCommand_LeaveParty_Description"	"Poistu nykyisestä ryhmästä."
"DOTA_ChatCommand_JoinChannel"	"joinchannel"
"DOTA_ChatCommand_JoinChannel_Name"	"Liity kanavalle"
"DOTA_ChatCommand_JoinChannel_Description"	"Liity keskustelukanavalle tai luo uusi."
"DOTA_ChatCommand_LeaveChannel"	"leavechannel"
"DOTA_ChatCommand_LeaveChannel_Name"	"Lähde kanavalta"
"DOTA_ChatCommand_LeaveChannel_Description"	"Poistu tietyltä keskustelukanavalta."
"DOTA_ChatCommand_GameAll"	"all"
"DOTA_ChatCommand_GameAll_Name"	"Kaikki"
"DOTA_ChatCommand_GameAll_Description"	"Kirjoita kaikille pelissä oleville."
"DOTA_ChatCommand_GameAllies"	"allies"
"DOTA_ChatCommand_GameAllies_Name"	"Liittolaiset"
"DOTA_ChatCommand_GameAllies_Description"	"Keskustele liittolaisten kesken."
"DOTA_ChatCommand_GameCoaching"	"coach"
"DOTA_ChatCommand_GameCoaching_Name"	"Valmentaja"
"DOTA_ChatCommand_GameCoaching_Description"	"Keskustele valmentajan ja valmennettavan kesken."
"DOTA_ChatCommand_GameSpectator"	"spectator"
"DOTA_ChatCommand_GameSpectator_Name"	"Katsoja"
"DOTA_ChatCommand_GameSpectator_Description"	"Keskustele muiden katsojien kanssa."
"DOTA_ChatCommand_Clear"	"clear"
"DOTA_ChatCommand_Clear_Name"	"Tyhjennä"
"DOTA_ChatCommand_Clear_Description"	"Poista kaikki tämän välilehden viestit."
"DOTA_Chat_UnknownCommandMessage"	"Tuntematon komento '{s:chat_command}'"
"DOTA_ChatHelp_Targets"	"Kohteet"
"DOTA_ChatHelp_Commands"	"Komennot"
"DOTA_ChatHelp_NameFormat"	"{s:command_name}:"
"DOTA_ChatHelp_CommandFormat"	"/{s:command}"
"DOTA_Chat_JoinedParty"	"Liityit ryhmään: {s:party_members}"
"DOTA_Chat_LeftParty"	"Ryhmä lakkautettiin."
"DOTA_Chat_MemberJoinedParty"	"Pelaaja liittyi ryhmään: {s:party_members}"
"DOTA_Chat_MemberLeftParty"	"Pelaaja lähti ryhmästä: {s:party_members}"
"DOTA_Chat_InvitedToJoinParty"	"Kutsuttiin: {s:party_members}"
"DOTA_Chat_RequestedToJoinParty"	"Haluaa liittyä: {s:party_members}"
"DOTA_Chat_PartyMemberSeparator"	", "
"DOTA_Feature_Under_Construction_Title"	"Työn alla"
"DOTA_PartyJoinRequest_Title"	"Liittymispyyntö"
"DOTA_PartyJoinRequest_Description"	"{g:dota_persona:b:inviter} haluaisi liittyä ryhmääsi."
"DOTA_PartyMergeRequest_Title"	"Yhdistämispyyntö"
"DOTA_PartyMergeRequest_Description"	"{g:dota_persona:b:inviter} haluaisi, että hänen ryhmänsä liittyisi sinun ryhmääsi."
"DOTA_PartyMergeRequestLowPriWarning"	"Huom: tämän pyynnön hyväksyminen tuo mukanaan ryhmälle alhaisen prioriteetin statuksen."
"DOTA_PartyInvite_Title"	"Ryhmäkutsu"
"DOTA_Invite_IOfN"	"{d:received_invite_index} / {d:received_invite_count}"
"DOTA_PartyInvite_Description"	"{g:dota_persona:b:inviter} on kutsunut sinut ryhmäänsä."
"DOTA_PartyInvite_LowPriority_Title"	"Alhaisen prioriteetin ryhmäkutsu"
"DOTA_PartyInvite_LowPriority_Description"	"{g:dota_persona:b:inviter} on kutsunut sinut alhaisen prioriteetin ryhmäänsä."
"DOTA_PartyInvite_BlockPartyLeader"	"Estä kaikki viestintä pelaajalta {g:dota_persona:b:inviter}"
"DOTA_LobbyInvite_BlockInviter"	"Estä kaikki viestintä tältä pelaajalta"
"DOTA_PartyInvite_BlockNonFriendInvites"	"Estä kutsut kaikilta, jotka eivät ole kavereitasi"
"DOTA_PartyInvite_BlockNonFriendInvitesDescription"	"Tätä voi muuttaa asetusvalikon Profiili-osiossa"
"DOTA_PartyInvite_Expired"	"Pyyntö on peruttu tai ei kelpaa enää."
"DOTA_PartyInvite_Coach"	"Valmentaja:"
"DOTA_PartyVisTooltip_TitleOpen"	"Etsii peliseuraa"
"DOTA_PartyVisTooltip_TitleNotOpen"	"Ei etsi peliseuraa"
"DOTA_PartyVisTooltip_SoloNotOpen"	"Vaihda tilaa klikkaamalla."
"DOTA_PartyVisTooltip_SoloOpen"	"Kaverit voivat pyytää liittymistä ryhmääsi.<br/>Vaihda tilaa klikkamalla."
"DOTA_PartyVisTooltip_LeaderOpen"	"Liittymispyynnöt ryhmäläisten kavereilta hyväksytään automaattisesti.<br/>Poista avoin ryhmä -tila käytöstä klikkaamalla."
"DOTA_PartyVisTooltip_LeaderOpenManualAccept"	"Ryhmäläisten kaverit voivat pyytää liittymistä<br/>Poista avoin ryhmä -tila käytöstä klikkaamalla."
"DOTA_PartyVisTooltip_NonLeaderNotOpen"	"Ryhmäläisten kaverit voivat pyytää liittymistä.<br/>Vain ryhmän johtaja voi hyväksyä pyynnöt.<br/>Ota avoin ryhmä -tila käyttön klikkaamalla. Tämä lisää ryhmän näkyvyyttä kavereille."
"DOTA_TogglePartyOpenMic_Tooltip"	"Avoin mikrofoni ryhmässä"
"DOTA_PartySettings"	"Ryhmän asetukset"
"DOTA_PartySettings_OpenParty"	"Salli liittymispyynnöt ryhmään"
"DOTA_PartySettings_BroadcastToFriends"	"Anna kavereiden nähdä, että olen ryhmässä"
"DOTA_PartySettings_OpenState_NotOpenLeader"	"Liittymispyynnöt tähän ryhmään eivät ole mahdollisia."
"DOTA_PartySettings_OpenState_OpenButHiddenFromFriends"	"Liittymispyynnöt tähän ryhmään ovat mahdollisia. Et mainosta tätä ryhmää kavereillesi, mutta se saattaa olla näkyvissä muiden jäsenten kavereille."
"DOTA_PartySettings_OpenState_Open"	"Liittymispyynnöt tähän ryhmään ovat mahdollisia. Ryhmä näkyy kavereillesi, ja mahdollisesti muiden jäsenten kavereille."
"DOTA_LobbyInvite_Title"	"Aulakutsu"
"DOTA_LobbyInvite_Description"	"{g:dota_persona:inviter} on kutsunut sinut aulaan."
"DOTA_PartyJoinedLobby_Title"	"Liityit aulaan"
"DOTA_PartyJoinedLobby_Generic"	"{s:party_leader} siirsi sinut aulaan."
"DOTA_PartyJoinedLobby_Custom"	"{s:party_leader} siirsi sinut pelin {s:custom_game} aulaan"
"DOTA_PartyLeader"	"Ryhmän johtaja"
"DOTA_LobbyKicked_Header"	"Erotettu aulasta"
"DOTA_LobbyKicked_Message"	"Peliaulan johtaja erotti sinut aulasta."
"DOTA_PlayerContextMenu_ViewProfile"	"Näytä profiili"
"DOTA_PlayerContextMenu_ChatWithPlayer"	"Lähetä viesti"
"DOTA_PlayerContextMenu_InviteToParty"	"Kutsu ryhmään"
"DOTA_PlayerContextMenu_SuggestInviteToParty"	"Ehdota kutsumista ryhmään"
"DOTA_PlayerContextMenu_KickFromParty"	"Erota ryhmästä"
"DOTA_PlayerContextMenu_SetPartyLeader"	"Aseta ryhmän johtajaksi"
"DOTA_PlayerContextMenu_LeaveParty"	"Lähde ryhmästä"
"DOTA_PlayerContextMenu_CoachParty"	"Valmenna tätä ryhmää"
"DOTA_PlayerContextMenu_StopCoachingParty"	"Lopeta ryhmän valmennus"
"DOTA_PlayerContextMenu_AddFriend"	"Lisää kaveriksi"
"DOTA_PlayerContextMenu_RemoveFriend"	"Poista kavereista"
"DOTA_PlayerContextMenu_AcceptFriendRequest"	"Hyväksy kaveripyyntö"
"DOTA_PlayerContextMenu_IgnoreFriendRequest"	"Hylkää kaveripyyntö"
"DOTA_PlayerContextMenu_Spectate"	"Katso peliä"
"DOTA_PlayerContextMenu_InviteToLobby"	"Kutsu aulaan"
"DOTA_PlayerContextMenu_SuggestInviteToLobby"	"Ehdota kutsumista aulaan"
"DOTA_PlayerContextMenu_KickFromLobby"	"Poista aulasta"
"DOTA_PlayerContextMenu_KickFromLobbyTeam"	"Poista aulan tiimistä"
"DOTA_FeaturedHero_ViewGrid"	"Näytä ruudukko"
"DOTA_FeaturedHero_HeroName"	"{s:hero_name}"
"DOTA_FeaturedHero_ItemName"	"{g:dota_item_name:item_def}"
"DOTA_FeaturedHeroReason_NewHero"	"Äskettäin lisätty sankari"
"DOTA_FeaturedHeroReason_NewItem"	"Uusi {s:item_rarity} esine"
"DOTA_FeaturedHeroReason_FeaturedItem"	"Esitelty esine"
"DOTA_FeaturedHeroReason_PopularItem"	"Eniten myyty"
"DOTA_FeaturedHeroReason_SaleItem"	"Alennuksessa"
"DOTA_HeroSelectorCategory_Default"	"Kaikki sankarit"
"DOTA_HeroSelectorCategory_NewItems"	"Uudet esineet"
"DOTA_HeroSelectorCategory_Favorites"	"Suosikit"
"DOTA_HeroSelectorCategory_PrimaryAttribute_Strength"	"Voima"
"DOTA_HeroSelectorCategory_PrimaryAttribute_Agility"	"Ketteryys"
"DOTA_HeroSelectorCategory_PrimaryAttribute_Intelligence"	"Älykkyys"
"DOTA_HeroSelectorCategory_AttackRange_Melee"	"Lähi"
"DOTA_HeroSelectorCategory_AttackRange_Ranged"	"Kauko"
"DOTA_HeroSelector_SelectHero_Label"	"Valitse"
"DOTA_HeroSelector_ClearFilters"	"Tyhjennä suodattimet"
"DOTA_AllItemSet_Selector_Title"	"Kaikki"
"DOTA_ConfirmLANLobby_title"	"PAIKALLINEN AULA"
"DOTA_ConfirmLANLobby_desc"	"Paikallinen peli isännöidään sinun koneellasi. Järjestelmävaatimukset ovat normaalia korkeammat isännöijäkoneelle."
"DOTA_Lobby_Settings_Starting_Team_Random"	"SATUNNAINEN"
"DOTA_Lobby_Settings_Bot_Difficulty_Easy"	"HELPPO"
"DOTA_Lobby_Settings_Bot_Difficulty_Hard"	"VAIKEA"
"DOTA_Lobby_Settings_Bot_Difficulty_Unfair"	"EPÄREILU"
"DOTA_Lobby_Settings_Version"	"VERSIO"
"DOTA_Lobby_Settings_Version_Latest"	"VIIMEISIN"
"DOTA_Lobby_Settings_Version_Tournament"	"TURNAUS"
"DOTA_Lobby_Settings_Spectator_Section"	"KATSOJA"
"DOTA_Lobby_Settings_Dota_TV_Delay_2_Minutes"	"2 Minuuttia"
"DOTA_Lobby_Settings_Dota_TV_Delay_5_Minutes"	"5 Minuuttia"
"DOTA_Lobby_Settings_Dota_TV_Delay_10_Seconds"	"10 Sekuntia"
"dota_lobby_settings_hide_password"	"Piilota salasana"
"DOTA_Lobby_Settings_Visibility_Public"	"Julkinen"
"DOTA_Lobby_Settings_Visibility_Friends"	"Kaverit"
"DOTA_TeamUnsetHeader"	"TIIMIÄ EI ASETETTU"
"DOTA_LeagueUnsetHeader"	"LIIGAA EI ASETETTU"
"DOTA_LeagueUnsetMessage"	"Tätä aulaa ei ole merkitty kuuluvaksi mihinkään liigaan, vaikka pystyisit tekemään niin. Haluatko silti aloittaa pelin?"
"dota_lobby_broadcast_default_channel_name"	"Kanavan nimi"
"dota_lobby_broadcast_join"	"Liity"
"dota_lobby_broadcast_leave"	"Poistu"
"dota_lobby_broadcast_create"	"Perusta uusi kanava"
"dota_lobby_broadcast_default_channel_name_custom"	"{s:custom_title}"
"dota_popup_broadcast_channel_edit_country"	"Maa"
"dota_popup_broadcast_channel_edit_language"	"Kieli"
"DOTA_Lobby_Broadcaster_Channel_Other_Language"	"Muu kieli"
"lobby_slot_error_header"	"Paikkaa ei voitu vaihtaa"
"generic_gc_timeout"	"Viesti aikakatkaistiin."
"lobby_slot_denied"	"Sinulla ei ole lupaa ottaa tätä paikkaa."
"lobby_slot_cameramanalready"	"Selostajakanavalla voi olla vain yksi kameravastaava"
"lobby_slot_cameramanon"	"Sinä olet nyt kameravastaava"
"lobby_slot_cameramanoff"	"Et ole enää kameravastaava"
"lobby_slot_error"	"Aulapaikan vaihto epäonnistui."
"LobbySetting_GameMode"	"Pelimuoto"
"LobbySetting_GameMode_Value"	"{s:lobbysetting_gamemode}"
"LobbySetting_Bots"	"Botit"
"LobbySetting_Bots_Value"	"{s:lobbysetting_bots}"
"LobbySetting_Password"	"Salasana"
"LobbySetting_Password_Value"	"{s:lobbysetting_password}"
"LobbySetting_Server"	"Palvelin"
"LobbySetting_Server_Value"	"{s:lobbysetting_server}"
"LobbySetting_Cheats"	"Huijaukset"
"LobbySetting_Cheats_Value"	"{s:lobbysetting_cheats}"
"LobbySetting_Spectators"	"Katsojat"
"LobbySetting_Spectators_Value"	"{s:lobbysetting_spectators}"
"LobbySetting_Visibility"	"Näkyvyys"
"LobbySetting_Visibility_Value"	"{s:lobbysetting_visibility}"
"dota_lobby_lan_title"	"Paikallinen palvelin"
"dota_lobby_coaches_none"	"Valmentajat: ei ole"
"dota_lobby_coaches"	"Valmentajat:"
"DOTA_Custom_Game_Info"	"Tiedot"
"DOTA_Custom_Game_Lobby_Count"	"{d:lobby_count} aula"
"DOTA_Custom_Game_Lobby_Count_Plural"	"{d:lobby_count} aulaa"
"DOTA_Custom_Game_View_Lobbies"	"Näytä aulat"
"DOTA_Custom_Game_Find_Lobby"	"Etsi aula"
"DOTA_Custom_Game_Create_Lobby"	"Perusta aula"
"DOTA_Custom_Game_Game_Page"	"Pelin sivu"
"DOTA_Custom_Game_Workshop_Page"	"Workshop-sivu"
"DOTA_Custom_Game_Download_Queued"	"Lataus jonossa"
"DOTA_Custom_Game_Downloading"	"Ladataan..."
"DOTA_Custom_Game_Downloading_Percent"	"Ladataan - {d:lobby_download_percent}%"
"DOTA_Custom_Game_Needs_Update"	"Vaatii päivityksen"
"DOTA_Custom_Game_Play"	"Pelaa {s:game_mode_name}"
"DOTA_Custom_Game_Uninstall"	"Poista asennus"
"DOTA_Custom_Game_Install"	"Asenna"
"DOTA_Custom_Game_Installed"	"Asennettu"
"DOTA_Custom_Game_Not_Installed"	"Ei asennettu"
"DOTA_Custom_Game_Connect"	"Liity aulaan"
"DOTA_Custom_Game_FileSize"	"{d:file_size} Mt"
"DOTA_Custom_Game_Name"	"{s:game_mode_name}"
"DOTA_Custom_Game_Subscription"	"{s:subscriptions_count} tilaus"
"DOTA_Custom_Game_Subscriptions"	"{s:subscriptions_count} tilausta"
"DOTA_Custom_Game_Rating"	"Arvostelut"
"DOTA_Custom_Game_Release_Date"	"Julkaistu"
"DOTA_Custom_Game_Playing_Now"	"{s:player_count} pelaamassa"
"DOTA_Custom_Game_Ratings_Count"	"({d:ratings_count})"
"DOTA_Custom_Game_Description"	"{s:game_description}"
"DOTA_Custom_Game_Last_Updated"	"Viimeksi päivitetty {s:last_updated_date}"
"DOTA_Custom_Game_Update_Note_Title"	"{s:timestamp}"
"DOTA_Custom_Game_Screenshots"	"Kuvankaappaukset"
"DOTA_Custom_Game_Map_Label"	"Kartta"
"DOTA_Custom_Game_Map_Any"	"Mikä tahansa"
"DOTA_Custom_Game_Invite_Friend"	"Kutsu kaveri"
"DOTA_Custom_Game_Most_Popular"	"Suosituimmat"
"DOTA_Custom_Game_Favorite_Games"	"Näytä vain suosikit"
"DOTA_Custom_Game_Vote_Box_Title"	"Workshop-äänestys"
"DOTA_Custom_Game_Vote_Start"	"Aloita äänestäminen"
"DOTA_Custom_Game_VoteThanks"	"Kiitos äänestämisestä!"
"DOTA_Custom_Game_Vote_PrevLabel"	"Edellinen peli"
"DOTA_Custom_Game_Vote_NextLabel"	"Seuraava peli"
"DOTA_Custom_Game_Vote_ControlsLabel"	"Workshop-äänestys"
"DOTA_Custom_Game_Vote_Up"	"Hyvä peli"
"DOTA_Custom_Game_Vote_Down"	"Tarvitsee korjailua"
"DOTA_Custom_Game_Suggested_Title"	"Suositellut pelit"
"DOTA_Custom_Game_Suggested_Info"	"Tähän on listattu sekä nousevia että positiivisia arvosteluja saavia pelejä.<br><br>Valikoima vaihtuu 30 minuutin välein, ja samat 15 peliä näytetään kaikille pelaajille samaan aikaan."
"DOTA_Custom_Lobby_Create_Button"	"Perusta oma aula"
"DOTA_Custom_Lobby_Settings_Title"	"Perusta aula"
"DOTA_Custom_Lobby_Settings_Mode"	"Pelimuoto"
"DOTA_Custom_Lobby_Settings_Map"	"Kartta"
"DOTA_Custom_Lobby_LobbyName"	"Valinnainen kuvaus"
"DOTA_Custom_Lobby_Public"	"Julkinen"
"DOTA_Custom_Lobby_Join_Failed_Title"	"Liittyminen epäonnistui"
"DOTA_Custom_Lobby_Join_Failed_Reason"	"{s:join_error}"
"DOTA_Custom_Lobby_Create_Private_Button"	"Perusta yksityinen aula"
"DOTA_Custom_Lobby_Find_Private_Button"	"Etsi yksityinen aula"
"DOTA_Custom_Lobby_Find_Private_Title"	"Etsi yksityinen aula"
"DOTA_Custom_Lobby_Find_Private_Desc"	"Etsi yksityinen aula kirjoittamalla sen salasana:"
"DOTA_Custom_Lobby_List_Game_Header"	"Peli"
"DOTA_Custom_Lobby_List_Name_Header"	"Kuvaus"
"DOTA_Custom_Lobby_List_Players_Header"	"Pelaajia"
"DOTA_Custom_Lobby_List_Map_Header"	"Kartta"
"DOTA_Custom_Lobby_List_Region_Header"	"Alue"
"DOTA_Custom_Lobby_List_Connection_Header"	"Yhteys"
"DOTA_Custom_Lobby_List_Game"	"{s:lobby_game}"
"DOTA_Custom_Lobby_List_Lobby_Name"	"{s:lobby_name}"
"DOTA_Custom_Lobby_List_Players"	"{s:lobby_players} / {s:lobby_max_players}"
"DOTA_Custom_Lobby_List_Map"	"{s:lobby_map}"
"DOTA_Custom_Lobby_List_Region"	"{s:lobby_region}"
"DOTA_Custom_Lobby_List_Connection"	"..."
"DOTA_Custom_Lobby_List_Status"	"{s:lobby_status}"
"DOTA_Custom_Lobby_List_Connect"	"{s:connect_button_text}"
"DOTA_Custom_Lobby_Game_Name"	"{s:game_name}"
"DOTA_Custom_Lobby_Map_Name"	"Kartta: {s:map_name}"
"DOTA_Custom_Lobby_Player_Count"	"Pelaajia: {d:player_count} / {d:max_player_count}"
"DOTA_Custom_Lobby_Player_Count_Short"	"{d:player_count} / {d:max_player_count}"
"DOTA_Custom_Join_Chat"	"Liity keskusteluun"
"DOTA_Custom_Join_Chat_Member_Count"	"({d:ChatMemberCount})"
"DOTA_TabName_ModsSubscribed"	"Kokoelma"
"DOTA_WatchReplays_SavedForLater"	"MYÖHEMPÄÄ KATSOMISTA VARTEN"
"DOTA_Watch_Pending"	"Odotetaan pelin katselua..."
"DOTA_Watch_GameServerNotFound"	"Tätä peliä isännöivää palvelinta ei löytynyt."
"DOTA_Watch_Unavailable"	"Tätä peliä ei voi katsella tällä hetkellä."
"DOTA_Watch_LobbyNotFound"	"Aulaa ei löydetty."
"dota_matchmaking_language_primary_invalid"	"{s:environment_language} ei ole Dota 2:n virallinen pelinhakukieli."
"dota_matchmaking_language_select_secondary"	"Jos haluat, voit valita toissijaisen kielen:"
"dota_matchmaking_language_select_primary"	"Valitse pelihaun kieli:"
"dota_matchmaking_language_no_selection"	"Ei valintaa"
"dota_matchmaking_language_english"	"englanti"
"dota_matchmaking_language_russian"	"venäjä"
"dota_matchmaking_language_chinese"	"Kiina (perint.)"
"dota_matchmaking_language_schinese"	"Kiina (yks.)"
"dota_matchmaking_language_korean"	"korea"
"dota_matchmaking_language_koreana"	"korea"
"dota_matchmaking_language_spanish"	"espanja"
"dota_matchmaking_language_portuguese"	"portugali"
"GameUI_Language_English"	"Englanti"
"GameUI_Language_German"	"Saksa"
"GameUI_Language_French"	"Ranska"
"GameUI_Language_Italian"	"Italia"
"GameUI_Language_Korean"	"Korea"
"GameUI_Language_Spanish"	"Espanja"
"GameUI_Language_Simplified_Chinese"	"Yksinkertaistettu kiina"
"GameUI_Language_Traditional_Chinese"	"Perinteinen kiina"
"GameUI_Language_Russian"	"Venäjä"
"GameUI_Language_Thai"	"Thai"
"GameUI_Language_Japanese"	"Japani"
"GameUI_Language_Portuguese"	"Portugali"
"GameUI_Language_Polish"	"Puola"
"GameUI_Language_Danish"	"Tanska"
"GameUI_Language_Dutch"	"Hollanti"
"GameUI_Language_Finnish"	"Suomi"
"GameUI_Language_Norwegian"	"Norja"
"GameUI_Language_Swedish"	"Ruotsi"
"GameUI_Language_Hungarian"	"Unkari"
"GameUI_Language_Czech"	"Tšekki"
"GameUI_Language_Romanian"	"Romania"
"GameUI_Language_Turkish"	"Turkki"
"GameUI_Language_Brazilian"	"Brasilianportugali"
"GameUI_Language_Bulgarian"	"Bulgaria"
"GameUI_Language_Greek"	"Kreikka"
"GameUI_Language_Ukrainian"	"Ukraina"
"client_version_out_of_date_title"	"Päivitys vaaditaan"
"client_version_out_of_date"	"Pelisi on vanhentunut. Sulje ja käynnistä Dota 2 uudelleen päivittääksesi viimeisimpään versioon."
"limited_heroes_abandon_header"	"Rajatut sankarit"
"limited_heroes_abandon_explanation"	"Rajatut sankarit -pelin hylkäämisestä ei rangaista, koska botti ottaa sankarisi haltuunsa. Kaikissa muissa pelimuodoissa pelin hylkäämällä voit joutua alhaisen prioriteetin hakujonoon."
"dota_abandon_dialog_confirm"	"Haluatko varmasti hylätä tämän pelin?"
"dota_abandon_dialog_yes"	"Kyllä, hylkää peli."
"dota_leave_dialog_confirm"	"Haluatko varmasti poistua tästä pelistä?"
"dota_leave_dialog_yes"	"Kyllä, lähde pelistä."
"dota_accept_match_title"	"Pelisi on valmis"
"dota_accept_match_accept"	"Hyväksy"
"dota_accept_match_accept_button"	"{s:accept}"
"dota_accept_match_decline"	"Kieltäydy"
"dota_accept_match_subtitle"	"{s:subtitle}"
"dota_match_connected"	"Yhteydessä peliin"
"dota_match_local_game"	"Yhdistetty paikalliseen peliin"
"dota_match_connecting"	"Yhdistetään peliin..."
"dota_match_in_progress"	"Peli käynnissä"
"dota_match_finished"	"Peli loppunut"
"matchmaking_waiting_for_players"	"Odotetaan muita pelaajia"
"matchmaking_player_declined"	"Pelaaja kieltäytyi ottelusta"
"dota_match_wait_for_host"	"Odotetaan isäntää"
"dota_match_find_server"	"Etsitään palvelinta"
"dota_ready_up_count"	"{s:ready_up_ready} / {s:ready_up_lobby_members}"
"dota_play_1v1_desc"	"Harjoittele yksilösuoritustasi keskilinjalla yhtä muuta pelaajaa vastaan. Harjoitus päättyy, kun toinen pelaajista kuolee kahdesti tai menettää tornin."
"dota_play"	"Pelaa Dotaa"
"dota_play_searching"	"Etsitään peliä"
"dota_play_lobby_find_server"	"Etsitään palvelinta"
"dota_play_find_match_label"	"{s:find_match_label}"
"dota_reconnect"	"Yhdistä takaisin"
"dota_abandon_game"	"Hylkää"
"dota_safe_leave_game"	"Poistu pelistä"
"dota_disconnect"	"Katkaise yhteys"
"dota_leaver_consequences"	"{s:leaver_consequences}"
"dota_leaver_consequence_header_failure_to_reconnect"	"Jos et liity takaisin peliin, tulee siitä seuraavat seuraamukset:"
"dota_leaver_consequence_LetDownTeammates"	"Jätät tiimikaverisi huonoon asemaan."
"dota_leaver_consequence_SmallMatchmakingCooldown"	"Et voi hakea uutta peliä vähään aikaan."
"dota_leaver_consequence_CreditWithAbandon"	"Sinulle merkitään pelin hylkääminen."
"dota_leaver_consequence_ForcedLossForLeaver"	"Sinulle merkitään pelin häviäminen."
"dota_leaver_consequence_ForcedLossForLeaversParty"	"Ryhmäsi jokaiselle jäsenelle merkitään pelin häviäminen."
"dota_leaver_consequence_ForcedLossForLeaversTeam"	"Joukkueellesi, %s1, merkitään tappio."
"dota_leaver_consequence_MMRLossForLeaver"	"Ranking-pistemääräsi (MMR) laskee."
"dota_leaver_consequence_MMRLossForLeaversParty"	"Ryhmäsi jokaisen jäsenen ranking-pistemäärä (MMR) laskee."
"dota_leaver_consequence_MMRLossForLeaversTeam"	"Joukkueesi, %s1, ranking-pisteet laskevat."
"dota_leaver_consequence_MatchDiscardedForOtherPlayers"	"Peliä ei tilastoida muille pelaajille."
"dota_leaver_consequence_NotDecrementLowPriGamesRemaining"	"Sinun ei katsota pelanneen tätä peliä loppuun."
"dota_matchmaking_region_offline"	"Huoltokatko"
"DOTA_VAC_Verification_Header"	"Valven huijauksenesto (VAC)"
"DOTA_VAC_Verification_Header_Solo"	"Pelinhakuun ei voitu liittyä, sillä VAC-järjestelmän toiminta on estetty laitteellasi. Varmista, ettei käytössäsi ole VAC-järjestelmän toimintaa häiritseviä ohjelmia, ja että Steam on asennettu oikein."
"DOTA_VAC_Verification_Header_Party"	"Pelinhakuun ei voitu liittyä, sillä VAC-järjestelmän toiminta on estetty yhden tai useamman ryhmänjäsenen laitteella. Varmista, ettei heidän käytössään ole VAC-järjestelmän toimintaa häiritseviä ohjelmia, ja että he ovat asentaneet Steamin oikein."
"DOTA_VAC_Verification_Button1"	"Lisätietoja"
"DOTA_VAC_Verification_Button2"	"Sulje"
"dota_play_no_language_selected"	"VALITSE KIELI"
"dota_ready_fail"	"VALMISTAUTUMINEN EPÄONNISTUI"
"dota_ready_fail_desc"	"Pelisi oli valmiina, mutta et vastannut ja sinut poistettiin pelihausta."
"dota_all_chat_label"	"[KAIKKI]"
"dota_chatwheel_label_Ok"	"Selvä"
"dota_chatwheel_label_Care"	"Varo"
"dota_chatwheel_label_GetBack"	"Perääntykää"
"dota_chatwheel_label_NeedWards"	"Wardiapu"
"dota_chatwheel_label_Stun"	"Tainnutus"
"dota_chatwheel_label_Help"	"Apua"
"dota_chatwheel_label_Push"	"Rynnäkkö"
"dota_chatwheel_label_GoodJob"	"Hyvin tehty"
"dota_chatwheel_label_Missing"	"Puuttuu"
"dota_chatwheel_label_Missing_Top"	"Ylä puuttuu"
"dota_chatwheel_label_Missing_Mid"	"Keski puuttuu"
"dota_chatwheel_label_Missing_Bottom"	"Ala puuttuu"
"dota_chatwheel_label_Go"	"Mene!"
"dota_chatwheel_label_Initiate"	"Aloita!"
"dota_chatwheel_label_Follow"	"Seuratkaa"
"dota_chatwheel_label_Group_Up"	"Kokoonnutaan"
"dota_chatwheel_label_Spread_Out"	"Hajaannutaan"
"dota_chatwheel_label_Split_Farm"	"Kerätään kultaa"
"dota_chatwheel_label_Attack"	"Hyökätään!"
"dota_chatwheel_label_BRB"	"Palaan pian"
"dota_chatwheel_label_Dive"	"Syöksy!"
"dota_chatwheel_label_OMW"	"Tulossa"
"dota_chatwheel_label_Get_Ready"	"Valmiina"
"dota_chatwheel_label_Bait"	"Ansa"
"dota_chatwheel_label_Heal"	"Paranna"
"dota_chatwheel_label_Mana"	"Mana"
"dota_chatwheel_label_OOM"	"Mana loppu"
"dota_chatwheel_label_Skill_Cooldown"	"Latausaika"
"dota_chatwheel_label_Ulti_Ready"	"Ulti valmis"
"dota_chatwheel_label_Enemy_Returned"	"Palasi"
"dota_chatwheel_label_All_Missing"	"Kaikki puuttuu"
"dota_chatwheel_label_Enemy_Incoming"	"Vihollinen!"
"dota_chatwheel_label_Invis_Enemy"	"Näkymätön vihu"
"dota_chatwheel_label_Enemy_Had_Rune"	"Saivat riimun"
"dota_chatwheel_label_Split_Push"	"Hajaannutaan"
"dota_chatwheel_label_Coming_To_Gank"	"Tulen väijyttämään"
"dota_chatwheel_label_Request_Gank"	"Väijyttäkää"
"dota_chatwheel_label_Fight_Under_Tower"	"Tornin alla"
"dota_chatwheel_label_Deny_Tower"	"Evää torni"
"dota_chatwheel_label_Buy_Courier"	"Osta kuriiri"
"dota_chatwheel_label_Upgrade_Courier"	"Päivitä kuriiri"
"dota_chatwheel_label_Need_Detection"	"Tarvitsemme paljastimia"
"dota_chatwheel_label_They_Have_Detection"	"Vihollinen näkee"
"dota_chatwheel_label_Buy_TP"	"Osta TP"
"dota_chatwheel_label_Reuse_Courier"	"Käytä kuriiria"
"dota_chatwheel_label_Deward"	"Poista wardit"
"dota_chatwheel_label_Building_Mek"	"Teen Mekansmin"
"dota_chatwheel_label_Building_Pipe"	"Teen Pipen"
"dota_chatwheel_label_Stack_And_Pull"	"Kasaa ja vedä"
"dota_chatwheel_label_Pull"	"Vedä"
"dota_chatwheel_label_Pulling"	"Vedän kätyreitä"
"dota_chatwheel_label_Stack"	"Kasaa"
"dota_chatwheel_label_Jungling"	"Metsästän"
"dota_chatwheel_label_Roshan"	"Roshan"
"dota_chatwheel_label_Affirmative"	"Selvä"
"dota_chatwheel_label_Wait"	"Odottakaa"
"dota_chatwheel_label_Pause"	"Pysäytys"
"dota_chatwheel_label_Current_Time"	"Pelikello"
"dota_chatwheel_label_Check_Runes"	"Tarkista riimut"
"dota_chatwheel_label_Smoke_Gank"	"Smoke-ylläri!"
"dota_chatwheel_label_GLHF"	"Onnea peliin"
"dota_chatwheel_label_Nice"	"Hienoa"
"dota_chatwheel_label_Thanks"	"Kiitos"
"dota_chatwheel_label_Sorry"	"Anteeksi"
"dota_chatwheel_label_No_Give_Up"	"Älä luovuta"
"dota_chatwheel_label_Just_Happened"	"Nyt kävi näin"
"dota_chatwheel_label_Game_Is_Hard"	"Aina ei voita"
"dota_chatwheel_label_New_Meta"	"Uusi meta"
"dota_chatwheel_label_My_Bad"	"Mun moka"
"dota_chatwheel_label_Regret"	"Katumus"
"dota_chatwheel_label_Relax"	"Rauhoitu"
"dota_chatwheel_label_GG"	"GG"
"dota_chatwheel_label_GGWP"	"GGWP"
"dota_chatwheel_label_All_GG"	"(Kaikki) GG"
"dota_chatwheel_label_All_GGWP"	"(Kaikki) GGWP"
"dota_chatwheel_label_What_To_Buy"	"Mitä ostaisin?"
"dota_chatwheel_label_Im_Retreating"	"Vetäydyn"
"dota_chatwheel_label_Space_Created"	"Tilaa tehty"
"dota_chatwheel_label_Whoops"	"Hups"
"dota_chatwheel_label_Tower_then_Back"	"Torni ja pois"
"dota_chatwheel_label_Barracks_then_Back"	"Parakit ja pois"
"dota_chatwheel_label_Ward_Bottom_Rune"	"Wardaa alariimu"
"dota_chatwheel_label_Ward_Top_Rune"	"Wardaa yläriimu"
"dota_chatwheel_label_Zeus_Ult"	"Zeus Ult"
"dota_chatwheel_header_positioning"	"Sijoittuminen"
"dota_chatwheel_header_status"	"Tila"
"dota_chatwheel_header_enemy"	"Vihollinen"
"dota_chatwheel_header_lane"	"Alkupeli"
"dota_chatwheel_header_items"	"Esineet"
"dota_chatwheel_header_neutrals"	"Neutraalit"
"dota_chatwheel_header_misc"	"Sekalaiset"
"dota_chatwheel_header_flavor"	"Jutustelu"
"dota_chatwheel_message_Ok"	"Selvä. "
"dota_chatwheel_message_Care"	"Varokaa!"
"dota_chatwheel_message_GetBack"	"Perääntykää!"
"dota_chatwheel_message_NeedWards"	"Ostakaa wardeja."
"dota_chatwheel_message_Stun"	"Tainnuta!"
"dota_chatwheel_message_Help"	"Auttakaa!"
"dota_chatwheel_message_Push"	"Pusketaan"
"dota_chatwheel_message_GoodJob"	"Hienosti pelattu!"
"dota_chatwheel_message_Missing"	"Puuttuu!"
"dota_chatwheel_message_Missing_Top"	"Ylhäältä puuttuu!"
"dota_chatwheel_message_Missing_Mid"	"Keskeltä puuttuu!"
"dota_chatwheel_message_Missing_Bottom"	"Alhaalta puuttuu!"
"dota_chatwheel_message_Go"	"Mene!"
"dota_chatwheel_message_Initiate"	"Aloita taistelu!"
"dota_chatwheel_message_Follow"	"Seuratkaa minua"
"dota_chatwheel_message_Group_Up"	"Kokoonnutaan"
"dota_chatwheel_message_Spread_Out"	"Hajaannutaan"
"dota_chatwheel_message_Split_Farm"	"Hajaannutaan keräämään kultaa"
"dota_chatwheel_message_Attack"	"Hyökätään nyt!"
"dota_chatwheel_message_BRB"	"Palaan pian"
"dota_chatwheel_message_Dive"	"Syöksy perään!"
"dota_chatwheel_message_OMW"	"Olen tulossa"
"dota_chatwheel_message_Get_Ready"	"Valmistautukaa"
"dota_chatwheel_message_Bait"	"Syötti"
"dota_chatwheel_message_Heal"	"Paranna"
"dota_chatwheel_message_Mana"	"Anna manaa"
"dota_chatwheel_message_OOM"	"Mana lopussa"
"dota_chatwheel_message_Skill_Cooldown"	"Kyvyt ovat latautumassa."
"dota_chatwheel_message_Ulti_Ready"	"Ultimate valmiina"
"dota_chatwheel_message_Enemy_Returned"	"Vihollinen palasi paikalleen"
"dota_chatwheel_message_All_Missing"	"Kaikki vihollissankarit kateissa!"
"dota_chatwheel_message_Enemy_Incoming"	"Vihollinen tulossa!"
"dota_chatwheel_message_Invis_Enemy"	"Näkymätön vihollinen lähistöllä!"
"dota_chatwheel_message_Enemy_Had_Rune"	"Vihollisella on riimu"
"dota_chatwheel_message_Split_Push"	"Pusketaan eri suunnista"
"dota_chatwheel_message_Coming_To_Gank"	"Tulen väijyttämään"
"dota_chatwheel_message_Request_Gank"	"Tulkaa väijyttämään"
"dota_chatwheel_message_Fight_Under_Tower"	"Tapellaan tornin alla"
"dota_chatwheel_message_Deny_Tower"	"Evätkää torni!"
"dota_chatwheel_message_Buy_Courier"	"Osta kuriiri"
"dota_chatwheel_message_Upgrade_Courier"	"Voisiko joku päivittää kuriirin?"
"dota_chatwheel_message_Need_Detection"	"Tarvitsemme paljastimia"
"dota_chatwheel_message_They_Have_Detection"	"Vihollisella on wardeja tai jotain"
"dota_chatwheel_message_Buy_TP"	"Ostakaa Teleport Scroll"
"dota_chatwheel_message_Reuse_Courier"	"Käytä kuriiria uudelleen"
"dota_chatwheel_message_Deward"	"Poistakaa vihollisen wardit"
"dota_chatwheel_message_Building_Mek"	"Valmistan Mekansmin"
"dota_chatwheel_message_Building_Pipe"	"Valmistan Pipen"
"dota_chatwheel_message_Stack_And_Pull"	"Kasaa ja vedä neutraaleja"
"dota_chatwheel_message_Pull"	"Vedä kätyreitä"
"dota_chatwheel_message_Pulling"	"Vedän kätyreitä"
"dota_chatwheel_message_Stack"	"Kasaa neutraaleja"
"dota_chatwheel_message_Jungling"	"Viidakkoon"
"dota_chatwheel_message_Roshan"	"Roshan"
"dota_chatwheel_message_Affirmative"	"Selvä"
"dota_chatwheel_message_Wait"	"Odottakaa"
"dota_chatwheel_message_Pause"	"Pysäyttäkää peli!"
"dota_chatwheel_message_Current_Time"	"Pelikello"
"dota_chatwheel_message_Check_Runes"	"Tarkistakaa riimut"
"dota_chatwheel_message_Smoke_Gank"	"Väijytetään smoken avulla!"
"dota_chatwheel_message_GLHF"	"Onnea matkaan, pidetään hauskaa"
"dota_chatwheel_message_Nice"	"Hienoa"
"dota_chatwheel_message_Thanks"	"Kiitos!"
"dota_chatwheel_message_Sorry"	"Anteeksi"
"dota_chatwheel_message_No_Give_Up"	"Älkää luovuttako!"
"dota_chatwheel_message_Just_Happened"	"Nyt kävi näin"
"dota_chatwheel_message_Game_Is_Hard"	"Aina ei voi voittaa"
"dota_chatwheel_message_New_Meta"	"Uusi meta"
"dota_chatwheel_message_My_Bad"	"Mun moka"
"dota_chatwheel_message_Regret"	"Kadun päätöstäni jo nyt"
"dota_chatwheel_message_Relax"	"Ei hätiä mitiä"
"dota_chatwheel_message_MissingHero"	"%s1 puuttuu!"
"dota_chatwheel_message_ReturnedHero"	"%s1 palasi paikalleen!"
"dota_chatwheel_message_GG"	"Hyvä peli"
"dota_chatwheel_message_GGWP"	"Hyvä peli, hienosti pelattu"
"dota_chatwheel_message_All_GG"	"Hyvä peli"
"dota_chatwheel_message_All_GGWP"	"(GG) Hyvä peli, hyvin pelattu"
"dota_chatwheel_message_What_To_Buy"	"Mitä ostaisin?"
"dota_chatwheel_message_Im_Retreating"	"Vetäydyn"
"dota_chatwheel_message_Space_Created"	"Tilaa tehty"
"dota_chatwheel_message_Whoops"	"Hups"
"dota_chatwheel_message_Tower_then_Back"	"Tuhoa torni ja vetäydy sitten"
"dota_chatwheel_message_Barracks_then_Back"	"Tuhoa parakit ja vetäydy sitten"
"dota_chatwheel_message_Ward_Bottom_Rune"	"Wardi alariimulle"
"dota_chatwheel_message_Ward_Top_Rune"	"Wardi yläriimulle"
"dota_chatwheel_message_Zeus_Ult"	"Zeus, Ultimate nyt!"
"dota_settings_hotkeys"	"Pikanäppäimet"
"dota_settings_options"	"Asetukset"
"dota_settings_audio"	"Ääni"
"dota_settings_voice"	"Puhe"
"dota_settings_voice_level"	"Nykyinen äänitystaso"
"dota_settings_volume"	"Voimakkuus"
"dota_settings_resetkeys"	"Nollaa pikanäppäimet..."
"dota_settings_abilities"	"Kyvyt"
"dota_settings_abilities_neutrals"	"Neutraalit"
"dota_settings_abilities_primary1"	"1"
"dota_settings_abilities_primary2"	"2"
"dota_settings_abilities_primary3"	"3"
"dota_settings_abilities_secondary1"	"4"
"dota_settings_abilities_secondary2"	"5"
"dota_settings_abilities_neutral1"	"1"
"dota_settings_abilities_neutral2"	"2"
"dota_settings_abilities_neutral3"	"3"
"dota_settings_abilities_neutral4"	"4"
"dota_settings_abilities_courier1"	"1"
"dota_settings_abilities_courier2"	"2"
"dota_settings_abilities_courier3"	"3"
"dota_settings_abilities_courier4"	"4"
"dota_settings_abilities_courier5"	"5"
"dota_settings_abilities_courier6"	"6"
"dota_settings_abilities_ultimate"	"U"
"dota_settings_abilitylearn"	"Opi kyky"
"dota_settings_upgradestats"	"Kehitä piirteitä"
"dota_settings_unitactions"	"Yksikkökomennot"
"dota_settings_attack"	"Hyökkäysliike / Pakota hyökkäys"
"dota_settings_move"	"Liiku"
"dota_settings_stop"	"Pysähdy"
"dota_settings_holdposition"	"Pysy paikallaan"
"dota_settings_selecthero"	"Valitse sankari"
"dota_settings_selectall"	"Valitse kaikki yksiköt"
"dota_settings_selectallothers"	"Valitse kaikki muut yksiköt"
"dota_settings_selectcourier"	"Valitse kuriiri"
"dota_settings_courierdeliver"	"Kuriiri: tuo esineet"
"dota_settings_courierhaste"	"Kuriirin pyrähdys"
"dota_settings_items"	"Esineet"
"dota_settings_openshop"	"Avaa kauppa"
"dota_settings_purchasequickbuy"	"Osta pikaostos"
"dota_settings_purchasesticky"	"Osta suosikkiesine"
"dota_settings_grabstashitems"	"Ota esineet säilöstä"
"dota_settings_cameraactions"	"Kameran toiminnot"
"dota_settings_cameraup"	"Kamera eteenpäin"
"dota_settings_cameradown"	"Kamera taaksepäin"
"dota_settings_cameraleft"	"Kamera vasemmalle"
"dota_settings_cameraright"	"Kamera oikealle"
"dota_settings_cameragrip"	"Kameraote"
"dota_settings_recentevent"	"Näytä pingaus"
"dota_settings_inspectheroinworld"	"Esittelykamera"
"dota_settings_phrases"	"Lausahdukset"
"dota_settings_chatwheel_page"	"Chattirulla"
"dota_settings_chatteam"	"Kirjoita tiimille"
"dota_settings_chatglobal"	"Kirjoita kaikille"
"dota_settings_chatwheel_show"	"Chattirulla"
"dota_settings_playeractions"	"Pelaajan toiminnot"
"dota_settings_activateglyph"	"Aktivoi Glyphi"
"dota_settings_scoreboardtoggle"	"Pistetaulu"
"dota_settings_screenshot"	"Kuvankaappaus"
"dota_settings_console"	"Konsoli"
"dota_settings_controlgroups"	"Komentoryhmät"
"dota_settings_controlgroupcycle"	"Vaihda valittua yksikköä"
"dota_settings_group1"	"Ryhmä 1"
"dota_settings_group2"	"Ryhmä 2"
"dota_settings_group3"	"Ryhmä 3"
"dota_settings_group4"	"Ryhmä 4"
"dota_settings_group5"	"Ryhmä 5"
"dota_settings_group6"	"Ryhmä 6"
"dota_settings_group7"	"Ryhmä 7"
"dota_settings_group8"	"Ryhmä 8"
"dota_settings_group9"	"Ryhmä 9"
"dota_settings_group10"	"Ryhmä 10"
"dota_settings_spectatorcameraup"	"Katsojakamera eteen"
"dota_settings_spectatorcameradown"	"Katsojakamera taakse"
"dota_settings_spectatorcameraleft"	"Katsojakamera vasemmalle"
"dota_settings_spectatorcameraright"	"Katsojakamera oikealle"
"dota_settings_spectatorcameragrip"	"Katsojakameran ote"
"dota_settings_spectatorscoreboard"	"Katsojien pistetaulu"
"dota_settings_coaching"	"Valmennus"
"dota_settings_spectatorcoach_viewtoggle"	"Käytä opastettavan näkökulmaa"
"dota_settings_cancel"	"Peruuta"
"dota_settings_apply"	"Käytä"
"dota_settings_autoattack"	"Automaattihyökkäys"
"dota_settings_minimap"	"Kartta"
"dota_settings_cameradecel"	"Kameran hidastuvuus"
"dota_settings_cameraspeed"	"Kameran nopeus"
"dota_settings_camerareversegrip"	"Käänteinen kameraote"
"dota_settings_profile"	"Profiili"
"dota_settings_network"	"Verkko"
"dota_settings_networkquality"	"Verkon laatu"
"dota_settings_networkquality_low"	"Matala"
"dota_settings_networkquality_high"	"Korkea"
"dota_settings_usenativeresolution"	"Käytä näyttöni nykyistä näyttötarkkuutta"
"dota_settings_customresolution"	"Käytä lisäasetuksia"
"dota_settings_resolution"	"Resoluutio"
"dota_settings_aspectratio"	"Kuvasuhde"
"dota_settings_aspectratio43"	"4:3"
"dota_settings_aspectratio169"	"16:9"
"dota_settings_aspectratio1610"	"16:10"
"dota_settings_resolution_size"	"Koko"
"dota_settings_resolution_display_mode"	"Näyttötila"
"dota_settings_fullscreen"	"Kokoruutu"
"dota_settings_window"	"Ikkunassa"
"dota_settings_borderless"	"Reunaton ikkuna"
"dota_settings_videodefaults"	"Palauta oletusasetukset"
"dota_settings_basicvideosettings"	"Käytä perusasetuksia"
"dota_settings_advancedvideosettings"	"Käytä lisäasetuksia"
"dota_settings_antialiasing"	"Reunanpehmennys"
"dota_settings_specular"	"Heijastukset"
"dota_settings_bloom"	"Hohdot ja kiillot"
"dota_settings_waterquality"	"Korkealaatuinen vesi"
"dota_settings_fog"	"Tunnelmasumu"
"dota_settings_animateportrait"	"Animoitu hahmokuva"
"dota_settings_additivelight"	"Lisävalon läpäisy"
"dota_settings_worldlight"	"Maailman valaistus"
"dota_settings_ambientocclusion"	"Ympäristön varjostus"
"dota_settings_ambientcreatures"	"Metsäneläimet"
"dota_settings_normal_maps"	"Normaalikartat"
"dota_settings_vsync"	"Pystysynkronointi"
"dota_settings_shadowquality_low"	"Matala"
"dota_settings_shadowquality_med"	"Keskitaso"
"dota_settings_shadowquality_high"	"Korkea"
"dota_settings_texturequality"	"Tekstuurien laatu"
"dota_settings_texturequality_low"	"Matala"
"dota_settings_texturequality_med"	"Keskitaso"
"dota_settings_texturequality_high"	"Korkea"
"dota_settings_mastervolume"	"Päävoimakkuus"
"dota_settings_gamevolume"	"Peliäänet"
"dota_settings_musicvolume"	"Musiikki"
"dota_settings_voicevolume"	"Puhe"
"dota_settings_gamevoicevolume"	"Yksikköjen puhe"
"dota_settings_openmicthreshold"	"Avoimen mikrofonin äänikynnys"
"dota_settings_audiodefaults"	"Äänen oletusasetukset"
"dota_settings_defaultaudio"	"Oletus"
"dota_settings_sounddevice"	"Äänilaite:"
"dota_settings_speakerconfig"	"Kaiutinasetukset:"
"dota_settings_headphones"	"Kuulokkeet"
"dota_settings_2speakers"	"2 kaiutinta"
"dota_settings_4speakers"	"4 kaiutinta"
"dota_settings_5speakers"	"5.1-kaiuttimet"
"dota_settings_7speakers"	"7.1-kaiuttimet"
"dota_settings_captions"	"Käytä tekstityksiä"
"dota_settings_playsoundinbackground"	"Toista äänet ohjelman ollessa taustalla"
"dota_settings_chatsounds"	"Viestin merkkiääni"
"dota_settings_mutecobroadcasters"	"Mykistä kanssaselostajat"
"dota_settings_highqualityaudio"	"Korkealaatuinen ääni"
"dota_settings_unitspeech_off"	"Pois"
"dota_settings_unitspeech_events"	"Tapahtumat"
"dota_settings_unitspeech_all"	"Kaikki"
"OS_Default_Device"	"Oletuslaite"
"DOTA_Keybind_ARROW"	"Nuoli (oletus)"
"DOTA_Keybind_LOL"	"League of Legends"
"DOTA_Hotkeys_Tooltip_LearnAbility"	"Valitse opittava kyky, jos kykypisteitä on käytettävissä."
"DOTA_Hotkeys_Tooltip_LearnStats"	"Nosta jokaista piirrettäsi kahdella pisteellä, kun kykypisteitä on käytettävissä."
"DOTA_Hotkeys_Tooltip_HeroAttack"	"Liiku kohteeseen, mutta hyökkää vastaantuleviin vihollisiin tai mahdollisesti evää liittolaisyksikkö."
"DOTA_Hotkeys_Tooltip_HeroMove"	"Liiku kohteeseen tai seuraa yksikköä hyökkäämättä siihen."
"DOTA_Hotkeys_Tooltip_HeroStop"	"Keskeytä tämänhetkinen toiminto."
"DOTA_Hotkeys_Tooltip_HeroHold"	"Keskeytä tämänhetkinen toiminto ja pysy paikallasi."
"DOTA_Hotkeys_Tooltip_HeroSelect"	"Valitse sankarisi."
"DOTA_Hotkeys_Tooltip_SelectAll"	"Valitse kaikki hallitsemasi yksiköt."
"DOTA_Hotkeys_Tooltip_SelectAllOthers"	"Valitse kaikki muut hallitsemasi yksiköt. (Sankariasi ei valita.)"
"DOTA_Hotkeys_Tooltip_CourierSelect"	"Valitse kuriiri."
"DOTA_Hotkeys_Tooltip_CourierDeliver"	"Komenna kuriiria tuomaan säilösi esineet sinulle."
"DOTA_Hotkeys_Tooltip_CourierHaste"	"Käytä kuriirin pyrähdys, jos mahdollista."
"DOTA_Hotkeys_Tooltip_UseActionItem"	"Käytä toimintaesinettä."
"DOTA_Hotkeys_Tooltip_HeroTaunt"	"Käytä sankarin pilkkaa. Saatavilla erillisinä esineinä."
"DOTA_Hotkeys_Tooltip_ShopToggle"	"Avaa kauppapaneeli."
"DOTA_Hotkeys_Tooltip_PurchaseQuickbuy"	"Osta seuraava esine pikaostoksistasi, jos sinulla on varaa siihen."
"DOTA_Hotkeys_Tooltip_PurchaseSticky"	"Osta suosikkiesineesi, jos rahasi riittävät siihen."
"DOTA_Hotkeys_Tooltip_GrabStashItems"	"Siirrä kaikki esineet säilöstäsi sankarillesi."
"DOTA_Hotkeys_Tooltip_RecentEvent"	"Liikuta kamera viimeisimpään tapahtumaan."
"DOTA_Hotkeys_Tooltip_InspectHeroInWorld"	"Katso yksikköä lähikuvakulmasta."
"DOTA_Hotkeys_Tooltip_ChatTeam"	"Lähetä viesti jokaiselle tiimikaverillesi."
"DOTA_Hotkeys_Tooltip_ChatGlobal"	"Lähetä viesti kaikille pelaajille nykyisessä pelissä. (VAIHTO + Kirjoita tiimille -näppäin)"
"DOTA_Hotkeys_Tooltip_ChatWheel"	"Avaa chattirulla kommunikoidaksesi pikaisesti yleisiä lausahduksia käyttäen."
"DOTA_Hotkeys_Tooltip_CameraGrip"	"Liikuta kameraa pitämällä tätä pohjassa ja vetämällä maata hiirellä. Hiiren keskipainike toteuttaa saman."
"DOTA_Hotkeys_Tooltip_ActivateGlyph"	"Aktivoi Glyph of Fortificationin, joka tekee tiimisi rakennuksista vahingoittumattomia 5 sekunniksi."
"DOTA_Hotkeys_Tooltip_ScoreboardToggle"	"Avaa pistetaulu."
"DOTA_Hotkeys_Tooltip_Pause"	"Keskeytä tai jatka peliä."
"DOTA_Hotkeys_Tooltip_ScreenshotSettings"	"Ota kuvakaappaus tämänhetkisestä pelinäkymästä."
"DOTA_Hotkeys_Tooltip_Console"	"Avaa konsoli. (Vain kokeneille käyttäjille)"
"DOTA_Hotkeys_Tooltip_ControlGroupCycle"	"Vaihda seuraavaan yksikköön valitussa ryhmässä."
"DOTA_Hotkeys_Tooltip_Group"	"Valitse määrätty yksikköryhmä. Voit määritellä uuden yksikköryhmän valitsemalla haluamasi yksiköt, pitämällä Ctrl pohjassa ja painamalla yhtä seuraavista painikkeista."
"DOTA_Hotkeys_Tooltip_Legacy"	"Käytä Dota 1:n pikanäppäimiä. Kykyjen pikanäppäimet vaihtelevat sankareiden kesken."
"DOTA_Hotkeys_Tooltip_Quickcast"	"Pikakäytön avulla kyky alkaa näppäintä painettaessa välittömästi kursorin osoittamassa paikassa."
"DOTA_Hotkeys_Tooltip_Autocast"	"Käytä kykyä automaattisesti, kun se on valmiina. Toimii vain tietyillä kyvyillä."
"DOTA_Hotkeys_Tooltip_Cast"	"Pikanäppäimet sankarikykyjen käyttämiseen."
"DOTA_Hotkeys_Tooltip_ItemCast"	"Pikanäppäimet tavaraluettelosi esineiden käyttämiseen."
"DOTA_Hotkeys_Tooltip_ItemQuickcast"	"Pikakäytön avulla esineen toiminta alkaa näppäintä painettaessa välittömästi kursorin osoittamassa paikassa."
"DOTA_Settings_Tooltip_Autoattack"	"Liikkuu automaattisesti kohti lähellä olevia vihollisia ja hyökkää niihin."
"DOTA_Settings_Tooltip_AutoattackAfterSpell"	"Kun pois päältä, sankari jää loitsun jälkeen seisomaan paikalleen odottamaan seuraavaa käskyä."
"DOTA_Settings_Tooltip_AutoPurchase"	"Ostaa seuraavan esineen suositeltujen esineiden listalta kun siihen on varaa."
"DOTA_Settings_Tooltip_AutoSelectSummons"	"Kun sankari kutsuu uusia yksikköjä, ne lisätään automaattisesti samaan komentoryhmään."
"DOTA_Settings_Tooltip_DoubleTap"	"Kyvyn tai esineen kaksoisklikkaaminen (tai pikanäppäimen kaksoisnäpäytys) kohdistaa sen itseesi, jos mahdollista."
"DOTA_Settings_Tooltip_UnifiedOrders"	"Controlia pohjassa pitämällä antamasi komennot annetaan kaikille hallinnassasi oleville yksiköille."
"DOTA_Settings_Tooltip_TeleportStop"	"Liikkuminen tai loitsiminen eivät keskeytä teleporttausta. Koskee vain esineitä Teleport Scroll ja Boots of Travel."
"DOTA_Settings_Tooltip_BroadcasterStats"	"Peliä katsellessa näytä selostajan pudotusvalikosta valitsemat tilastot."
"DOTA_Settings_Tooltip_Deceleration"	"Nopeus, jolla kamera pysähtyy siirtämisen jälkeen. Suuri luku tarkoittaa nopeampaa pysähtymistä."
"DOTA_Settings_Tooltip_Screenshake"	"Jotkut kyvyt ja tainnutukset tärisyttävät kameraa."
"DOTA_Settings_Tooltip_CameraRespawn"	"Kohdistaa kameran sankariisi sen syntyessä uudelleen."
"DOTA_Settings_Tooltip_HideProfile"	"Dota 2 -profiiliasi ei voi nähdä kukaan. Steam-profiiliasi ei voi tarkastella pelin kautta."
"DOTA_Settings_Tooltip_ShareMatchData"	"Antaa kolmansille osapuolille luvan käyttää julkisten peliesi tietoja."
"DOTA_Settings_Tooltip_NetworkQuality"	"Jos verkkoyhteytesi on huono, 'MATALA' saattaa parantaa pelattavuuttasi."
"DOTA_Settings_Tooltip_MinimapSimple"	"Kartan kuvakkeet väritetään tiimin, ei pelajien mukaan."
"DOTA_Settings_Tooltip_MinimapDrawHeroes"	"Altin pohjassa pitäminen näyttää kartalla sankarin nimen sijasta kuvakkeen."
"DOTA_Settings_Tooltip_MinimapNamesIcon"	"Näyttää kartalla aina sankarin kuvakkeen tai nimen. Altin pohjassa pitäminen käyttää merkintöjä X ja O."
"DOTA_Settings_Tooltip_ShopHotkeys"	"Kun kauppa on auki, kaupan pikanäppäimet syrjäyttävät kaikki muihin toimintoihin määrätyt näppäimet."
"DOTA_create_bot_practice_desc"	"Pelaa tekoälyä vastaan. Voit täyttää tiimisi tyhjät paikat boteilla tai etsiä ihmisiä pelihaun kautta."
"DOTA_Lobby_BotDifficulty_passive"	"Passiivinen"
"DOTA_Lobby_BotDifficulty_easy"	"Lälly"
"DOTA_Lobby_BotDifficulty_medium"	"Normaali"
"DOTA_Lobby_BotDifficulty_hard"	"Vaikea"
"DOTA_Lobby_BotDifficulty_unfair"	"Epäreilu"
"dota_lobby_title_default"	"Aula"
"dota_lobby_row_join"	"Liity"
"dota_lobby_row_leave"	"Poistu"
"returning_top_of_queue"	"Palataan pelihakuun suurella prioriteetillä"
"GC_nosteam"	"Ei yhteyttä Steamiin"
"GC_Wait_Time"	"Arvioitu odotusaika: %s1"
"GC_Wait_Time_Unknown"	"Tuntematon"
"join_error_already_in_game"	"Harjoitteluaulaan ei voitu liittyä, sillä olet jo pelissä."
"join_error_invalid_lobby"	"Valitsemaasi aulaa ei ole enää olemassa."
"join_error_incorrect_password"	"Väärä salasana."
"join_error_access_denied"	"Pääsy estetty."
"join_error_in_team_party"	"Harjoitusaulaan ei voitu liittyä. Sinun tulee lakkauttaa tiimisi ryhmä ennen harjoituspeleihin liittymistä."
"DOTA_Feed_Timestamp_HourAgo"	"{i:value} tunti sitten"
"dota_lobby_type_practice"	"Harjoituspeli"
"dota_lobby_type_coop_bot"	"Yhteistyöbotti"
"dota_lobby_type_competitive"	"Ranking-ottelu"
"dota_lobby_type_casual_1v1"	"1vs1-ottelu"
"DOTA_Lobby_No_Players_Title"	"EI PELAAJIA TIIMISSÄ"
"dota_match_result_none"	"???"
"dota_social_feed_loading"	"Ladataan..."
"DOTA_LoadingPlayerUnknown"	"-"
"DOTA_LoadingPlayerLoading"	"Lataa..."
"DOTA_LoadingPlayerFullyConnected"	"Valmis"
"LoadingScreenTimer"	"{t:d:countdown_timer_seconds}"
"HeroSelectionTimer"	"{i:timer_seconds}"
"LoadingScreenPlayersInfo"	"Valmiina: {i:players_loaded}/{i:players_total}"
"custom_end_screen_victory_message"	"{s:winning_team_name} voittaa!"
"custom_end_screen_legend_player"	"Pelaaja"
"custom_end_screen_legend_level"	"Taso"
"custom_end_screen_legend_hero"	"Sankari"
"custom_end_screen_legend_items"	"Esineet"
"custom_end_screen_legend_gold"	"Kulta"
"custom_scoreboard_hero_name_and_desc"	"Tason {i:hero_level} {s:hero_name}"
"CustomEndScreenClose"	"Sulje"
"DOTA_Armory_Category_Heroes"	"Sankarit"
"DOTA_Armory_Category_Couriers"	"Kuriirit"
"DOTA_Armory_Category_Pets"	"Lemmikit"
"DOTA_Armory_Category_Wards"	"Wardit"
"DOTA_Armory_Category_Emoticons"	"Hymiöt"
"DOTA_Armory_Category_Audio"	"Ääni"
"DOTA_Armory_Category_Music"	"Musiikki"
"DOTA_Armory_ContextMenu_Equip"	"Varusta"
"dota_page_match_details_header_game_mode"	"Pelimuoto"
"dota_page_match_details_comment_placeholder"	"Kirjoita kommentti..."
"dota_page_match_details_replay_existence_disk_found_highlights"	"Katso kohokohdat"
"dota_profile_content_tab_activity_feed"	"Tapahtumasyöte"
"dota_profile_content_tab_recent_games"	"Viimeaikaiset pelit"
"dota_profile_recent_game_result_abandon"	"Hylätty"
"dota_profile_recent_game_icon_source1"	"S1"
"dota_profile_hero_with_index"	"{d:hero_index} {s:hero_name}"
"dota_profile_hero"	"{s:hero_name}"
"DOTA_tooltip_econ_item_gem_type"	"{s:gem_type}"
"custom_game_team_select_timer"	"{i:countdown_timer_seconds}"
"custom_game_team_select_join"	"Liity"
"CouldntFindCompendium"	"Turnauskirjan testitiedostoa ei löytynyt: {s:s1}"
"DOTA_GlobalItems_Audio"	"Ääni"
"DOTA_GlobalItems_Announcers"	"Kuuluttajapaketit"
"dota_lobby_settings_edit"	"Muokkaa"
"dota_lobby_browser_header_game_mode"	"Pelimuoto"
"dota_lobby_browser_region"	"Alue"
"DOTA_Credits"	"Kiitokset"
"DOTA_ActorCredits_1_Name"	"Dee Bradley Baker"
"DOTA_ActorCredits_1_Heroes"	"Techies"
"DOTA_ActorCredits_2_Name"	"Dennis Bateman"
"DOTA_ActorCredits_2_Heroes"	"Invoker"
"DOTA_ActorCredits_3_Name"	"Tom Chantler"
"DOTA_ActorCredits_4_Name"	"Merle Dandridge"
"DOTA_ActorCredits_5_Name"	"Barry Dennen"
"DOTA_ActorCredits_6_Name"	"Dave Fennoy"
"DOTA_ActorCredits_7_Name"	"Jim French"
"DOTA_ActorCredits_7_Heroes"	"Elder Titan"
"DOTA_ActorCredits_8_Name"	"Michael Gregory"
"DOTA_ActorCredits_9_Name"	"Gin Hammond"
"DOTA_ActorCredits_10_Name"	"John Patrick Lowrie"
"DOTA_ActorCredits_11_Name"	"Ellen McLain"
"DOTA_ActorCredits_12_Name"	"Bruce Miles"
"DOTA_ActorCredits_13_Name"	"Linda K. Morris"
"DOTA_ActorCredits_13_Extra"	"Kuuluttaja"
"DOTA_ActorCredits_14_Name"	"Sam A. Mowry"
"DOTA_ActorCredits_14_Extra"	"Salakaupan pitäjä"
"DOTA_ActorCredits_15_Name"	"Eric Newsome"
"DOTA_ActorCredits_16_Name"	"Nolan North"
"DOTA_ActorCredits_17_Name"	"Dempsey Pappion"
"DOTA_ActorCredits_18_Name"	"TJ Ramini"
"DOTA_ActorCredits_19_Name"	"Harry S. Robins"
"DOTA_ActorCredits_19_Heroes"	"Tinker"
"DOTA_ActorCredits_20_Name"	"Gary Schwartz"
"DOTA_ActorCredits_21_Name"	"David Scully"
"DOTA_ActorCredits_22_Name"	"Mike Shapiro"
"DOTA_ActorCredits_22_Heroes"	"Oracle"
"DOTA_ActorCredits_23_Name"	"David Sobolov"
"DOTA_ActorCredits_23_Heroes"	"Terrorblade"
"DOTA_ActorCredits_24_Name"	"Jon St. John"
"DOTA_ActorCredits_25_Name"	"Fred Tatasciore"
"DOTA_ActorCredits_25_Extra"	"Warlockin Golem"
"DOTA_ActorCredits_26_Name"	"Jen Taylor"
"DOTA_ActorCredits_27_Name"	"Tony Todd"
"DOTA_ActorCredits_28_Name"	" "
"DOTA_ActorCredits_28_Heroes"	" "
"DOTA_PlayerContextMenu_Trade"	"Kutsu vaihtamaan"
"DOTA_WatchLive_Fullscreen"	"KOKORUUTU"
"DOTA_Chat_ChannelMemberCount"	"{d:channel_member_count}"
"DOTA_GiftWrap_Success"	"Lahjasi on toimitettu."
"DOTA_Previous"	"Edellinen"
"DOTA_Next"	"Seuraava"
"DOTA_Friends_Add_Friend_Tooltip"	"Lisää kaveri"
"DOTA_Treasure_Open"	"Avaa"
"DOTA_OpenTreasureTooltip_UnitName"	"{s:unit_name}"
}
